ܐܦܪܝܩܐ	非洲
ܝܦܢ	日本
ܐܡܪܝܩܐ ܬܝܡܢܝܬܐ	南美洲
ܢܘܪܒܝܓ	挪威
ܩܘܛܢܝܘܬܐ ܕܐܝܪܠܢܕ	爱尔兰共和国
ܡܓܪ	匈牙利
ܐܣܦܢܝܐ	西班牙
ܐܘܚܕܢܐ ܡܚܝܕܐ	美国
ܒܠܓܝܩܐ	比利时
ܠܘܟܣܡܒܘܪܓ	卢森堡
ܬܒܝܠ	宇宙
ܐܪܥܐ	地球
ܡܘܬܐ	死亡
ܒܪ ܐܢܫܐ	人
ܓܘܪܓ ܘܐܫܝܢܓܛܘܢ	乔治·华盛顿
ܦܝܢܠܢܕ	芬兰
ܣܘܝܕ	瑞典
ܕܐܢܡܐܪܩ	丹麦
ܦܘܠܢܕ	波兰
ܠܬܘܢܝܐ	立陶宛
ܐܝܛܠܝܐ	意大利
ܣܘܝܣܪܐ	瑞士
ܢܡܣܐ	奥地利
ܝܘܢ	希腊
ܛܘܪܩܝܐ	土耳其
ܦܘܪܛܘܓܠ	葡萄牙
ܐܘܪܘܦܐ (ܝܒܫܬܐ)	欧洲
ܐܣܝܐ (ܝܒܫܬܐ)	亚洲
ܐܡܪܝܩܐ ܓܪܒܝܝܬܐ	北美洲
ܐܢܛܐܪܩܛܝܩܐ	南极洲
ܘܝܩܝܦܕܝܐ	维基百科
ܗܘܠܢܕܐ	荷兰
ܢܝܘ ܝܘܪܩ (ܡܕܝܢܬܐ)	纽约
ܘܐܫܢܓܛܘܢ (ܐܪܫܟܝܬܐ)	华盛顿哥伦比亚特区
ܒܪܠܝܢ	柏林
ܚܫܘܒܐ (ܡܐܟܢܐ)	電子計算機
ܒܪܢ	伯尔尼
ܬܣܝܪܝܟ	苏黎世
ܐܢܛܪܢܛ	互联网
ܒܪܐܩ ܐܘܒܐܡܐ	贝拉克·奥巴马
ܠܘܢܕܘܢ	伦敦
ܐܠܟܣܢܕܪܝܐ	亚历山大港
ܚܙܘܪܐ	苹果
ܦܐܪܝܣ	巴黎
ܡܟܣܝܩܘ	墨西哥
ܐܘܩܝܢܘܣ ܐܛܠܢܛܝܐ	大西洋
ܐܘܩܝܢܘܣ ܫܝܢܝܐ	太平洋
ܒܘܣܛܘܢ	波士顿
ܬܪܝܢܒܫܒܐ	星期一
ܟܢܘܢ ܒ	1月
ܫܒܛ	2月
ܐܕܪ	3月
ܟܘܫ	埃塞俄比亚
ܢܝܣܢ	4月
ܐܝܪ	5月
ܚܙܝܪܢ	6月
ܬܡܘܙ	7月
ܐܒ	8月
ܐܝܠܘܠ	9月
ܬܫܪܝܢ ܐ	10月
ܬܫܪܝܢ ܒ	11月
ܟܢܘܢ ܐ	12月
ܬܠܬܒܫܒܐ	星期二
ܐܪܒܥܒܫܒܐ	星期三
ܚܡܫܒܫܒܐ	星期四
ܥܪܘܒܬܐ	星期五
ܫܒܬܐ (ܙܒܢܐ)	星期六
ܚܕܒܫܒܐ	星期日
ܐܪܝܐ	狮
ܦܪܢܣܐ	法国
ܟܠܒܐ	犬
ܡܠܟܘܬܐ ܡܚܝܕܬܐ	英国
ܩܛܐ	猫
ܩܘܛܢܝܘܬܐ ܥܡܡܝܬܐ ܕܨܝܢ	中华人民共和国
ܠܫܢܐ ܦܪܢܣܝܐ	法语
ܒܪܐܙܝܠ	巴西
ܪܘܣܝܐ	俄罗斯
ܝܡܐ	海
ܝܡܐ ܐܘܟܡܐ	黑海
Π	Π
ܐܠܒܐܡܐ	亚拉巴马州
ܣܐܘ ܦܐܘܠܘ	聖保羅 (巴西)
ܩܝܒܩ (ܗܘܦܪܟܝܐ)	魁北克
ܓܪܡܢ	德国
ܒܠܐܪܘܣ	白俄罗斯
ܠܫܢܐ ܓܪܡܢܝܐ	德语
ܐܠܗܐ	神 (一神教)
ܐܣܛܘܢܝܐ	爱沙尼亚
ܛܝܣܬܐ	固定翼飛機
ܩܪܒܐ	战争
1 (ܡܢܝܢܐ)	1
2 (ܡܢܝܢܐ)	2
3 (ܡܢܝܢܐ)	3
4 (ܡܢܝܢܐ)	4
5 (ܡܢܝܢܐ)	5
ܠܐܛܒܝܐ	拉脫維亞
ܐܘܩܪܐܝܢܐ	乌克兰
ܬܫܝܟ	捷克
ܣܠܘܒܩܝܐ	斯洛伐克
ܣܠܘܒܢܝܐ	斯洛文尼亚
ܡܘܠܕܘܒܐ	摩尔多瓦
ܪܘܡܢܝܐ	羅馬尼亞
ܒܘܠܓܐܪܝܐ	保加利亚
ܪܗܘܡܐ (ܡܕܝܢܬܐ)	罗马
ܩܘܛܢܝܘܬܐ ܕܡܩܕܘܢܝܐ	馬其頓共和國
ܐܠܒܢܝܐ	阿尔巴尼亚
ܩܪܘܐܛܝܐ	克罗地亚
ܒܘܣܢܐ ܘܗܪܬܣܓܘܒܝܢܐ	波斯尼亚和黑塞哥维那
ܐܙܪܒܝܓܐܢ	阿塞拜疆
ܐܢܕܘܪܐ	安道尔
ܩܘܦܪܘܣ	賽普勒斯
ܓܘܪܓܝܐ (ܐܬܪܐ)	格鲁吉亚
ܩܙܩܣܛܐܢ	哈萨克斯坦
ܡܝܠܛܐ	马耳他
ܡܘܢܐܩܘ	摩纳哥
ܛܘܪܐ ܐܘܟܡܐ	蒙特內哥羅
ܡܕܝܢܬܐ ܕܘܛܝܩܢ	梵蒂冈
ܣܢ ܡܪܝܢܘ	圣马力诺
ܒܪܘܟܣܠ	布鲁塞尔-首都大区
ܠܘܕܒܝܓ ܒܐܢ ܒܝܛܗܘܒܢ	路德维希·范·贝多芬
ܠܫܢܐ ܛܘܪܩܝܐ	土耳其语
ܓܙܐܐܪ	阿尔及利亚
ܐܘܙܒܩܣܛܐܢ	乌兹别克斯坦
ܘܐܪܣܘ	华沙
ܚܡܪܐ (ܫܬܝܐ)	葡萄酒
ܡܝܐ	水
ܦܪܣ ܚܙܘܐ	电视
ܬܫܝܠܝ	智利
ܐܠ ܓܪܝܩܘ	格雷考
ܝܫܘܥ	耶稣
ܠܫܢܐ (ܡܡܠܠܐ)	語言
ܫܘܠܛܢ ܛܪܘܢܘܬܐ	獨裁政體
ܡܡܠܠܘܬ ܟܘܟܒܐ	天文學
ܡܪܝܡ (ܐܡܗ ܕܝܫܘܥ)	馬利亞 (耶穌的母親)
ܠܝܟܛܢܫܛܝܢ	列支敦斯登
ܐܕܘܠܦ ܗܝܛܠܪ	阿道夫·希特勒
ܠܝܢܘܟܣ	Linux
ܠܫܢܐ ܠܐܛܝܢܝܐ	拉丁语
ܒܚܪܝܢ	巴林
ܐܪܡܢܝܐ	亞美尼亞
ܣܪܒܝܐ	塞尔维亚
ܣܗܪܐ	月球
ܐܝܣܛܢܒܘܠ (ܡܕܝܢܬܐ)	伊斯坦堡
ܐܘܣܛܪܠܝܐ (ܐܬܪܐ)	澳大利亚
ܦܝܣܝܟ	物理学
ܩܘܪܐܢ	古兰经
ܐܣܠܐܡ	伊斯兰教
ܟܡܬܪܐ	梨
ܠܟ ܒܐܘܢܣܐ	莱赫·瓦文萨
ܫܠܡܐ (ܫܝܢܐ)	和平
ܚܘܝܕܐ ܐܘܪܘܦܝܐ	欧洲联盟
ܐܢܬܬܐ	女性
ܛܝܙܐ	肛门
ܗܒܒܐ	花
ܝܘܠܦܢ ܨܪܘܝܘܬܐ	解剖学
ܡܕܝܢܬܐ	城市
ܢܐܦܠܝܘܢ ܒܘܢܐܦܪܛ	拿破仑一世
ܟܘܟܒܐ	恒星
ܫܡܫܐ	太阳
ܩܪܝܬܐ	村
ܝܡܐ ܕܡܕܢܚܐ	波罗的海
ܫܢܐ	牙齒
ܘܝܩܝܡܝܕܝܐ ܩܘܡܡܘܢܣ	维基共享资源
ܟܬܒܐ (ܣܦܪܐ)	图书
ܝܘܡܐ	日
ܠܠܝܐ	晚上
ܫܢܬܐ (ܙܒܢܐ)	年
ܕܪܐ	世纪
ܐܘܣܠܘ	奥斯陆
ܠܫܒܘܢܐ	里斯本
ܦܠܝܛܐ	行星
ܙܡܪܘܬܐ	音乐
ܡܘܣܩܒܐ	莫斯科
ܠܫܢܐ ܐܝܛܠܝܐ	意大利语
ܬܫܐܕ	乍得
ܬܝܡܢܐ	北
ܢܝܘ ܙܝܠܢܕ	新西兰
ܓܪܒܝܐ	南
ܗܢܕܘ	印度
ܦܪܙܠܐ	铁
ܡܥܪܒܐ	西
ܡܕܢܚܐ	東
ܒܢܙܘܝܠܐ	委內瑞拉
ܛܠܦܣܢܐ	國際象棋
ܡܝܢ	缅因州
ܣܘܣܝܐ	马
ܐܡܣܛܪܕܐܡ	阿姆斯特丹
ܙܝܢܐ	武器
ܚܝܘܬܐ	动物
ܩܘܠܘܡܒܝܐ	哥伦比亚
ܢܝܘ ܗܐܡܦܫܪ	新罕布什尔州
ܠܝܘܢܪܕܘ ܕܗ ܒܢܬܫܝ	列奥纳多·达·芬奇
ܡܐܣܐܬܫܘܣܬܣ	麻薩諸塞州
ܐܘܛܪܝܟܛ (ܗܘܦܪܟܝܐ)	乌得勒支省
ܟܘܢܝܬܝܟܬ	康乃狄克州
ܐܝܪܐܢ	伊朗
ܥܝܪܐܩ	伊拉克
ܐܠܐܣܟܐ	阿拉斯加州
ܐܝܣܪܐܝܠ	以色列
ܐܘܛܪܝܟܛ (ܡܕܝܢܬܐ)	乌得勒支
ܝܡܢ	也门
ܠܫܢܐ ܦܘܠܢܕܝܐ	波兰语
ܝܘܪܕܢܢ	约旦
ܩܝܪܓܝܙܣܛܐܢ	吉尔吉斯斯坦
ܐܪܝܙܘܢܐ	亞利桑那州
ܟܘܘܝܬ (ܐܬܪܐ)	科威特
ܠܒܢܢ	黎巴嫩
ܐܘܪܝܓܘܢ	俄勒冈州
ܐܡܪܝܩܐ	美洲
ܝܘܬܐ	犹他州
ܥܘܡܐܢ	阿曼
ܦܐܩܣܛܐܢ	巴基斯坦
ܩܛܪ	卡塔尔
ܣܥܘܕܝܐ	沙特阿拉伯
ܝܘܣܦ ܣܛܐܠܝܢ	斯大林
ܣܘܪܝܐ	叙利亚
ܛܐܓܝܩܣܛܐܢ	塔吉克斯坦
ܦܪܣ ܩܠܐ	无线电
ܛܘܪܩܡܢܣܛܐܢ	土库曼斯坦
ܐܡܝܪܘܬܐ ܥܪܒܝܬܐ ܡܚܝܕܬܐ	阿拉伯联合酋长国
ܐܦܓܐܢܣܛܐܢ	阿富汗
ܕܗܒܐ	金
ܡܠܝ	马里共和国
ܦܝܠܝܦܝܢܝܐ	菲律宾
ܩܘܛܢܝܘܬܐ ܕܐܦܪܝܩܐ ܡܨܥܝܬܐ	中非共和國
ܐܝܣܚܩ ܢܝܘܛܢ	艾萨克·牛顿
ܫܥܘܬܐ (ܓܘܢܐ)	黄色
ܬܘܢܣ (ܐܬܪܐ)	突尼西亞
ܬܝܡܢܐ ܕܣܘܕܐܢ	南蘇丹
ܩܘܛܢܝܘܬܐ ܕܩܘܢܓܘ	刚果共和国
ܩܘܛܢܝܘܬܐ ܕܩܘܢܓܘ ܕܝܡܘܩܪܛܝܬܐ	刚果民主共和国
ܦܐܦܐ ܝܘܚܢܢ ܦܘܠܘܣ ܬܪܝܢܐ	若望·保祿二世
ܛܒܝܠܝܣܝ	第比利斯
ܩܐܡܪܘܢ	喀麦隆
ܠܘܒܐ	利比亚
ܡܘܪܝܛܢܝܐ	毛里塔尼亚
ܡܓܪܒ	摩洛哥
ܢܝܓܪ	尼日尔
ܣܘܕܐܢ	苏丹共和国
ܩܫܬܐ ܕܡܪܢ	彩虹
ܗܐܡܒܘܪܓ	汉堡
ܝܡܬܐ ܕܐܘܢܛܪܝܘ	安大略湖
ܝܡܬܐ ܕܣܘܦܝܪܝܘܪ	苏必利尔湖
ܓܐܘܓܪܦܝܐ	地理学
ܠܒܐ	心臟
ܡܘܚܐ	脑
ܓܠܕܐ	皮膚
ܓܘܢܐ	颜色
ܦܪܐܓ	布拉格
ܙܪܩܐ	藍色
ܟܣܦܐ (ܣܐܡܐ)	銀
ܡܫܝܓܢ	密歇根州
ܝܡܬܐ ܕܡܝܫܝܓܢ	密歇根湖
ܐܠܝܢܘܝ	伊利诺伊州
ܢܘܪܬ ܕܐܟܘܬܐ	北达科他州
ܣܐܘܬ ܕܐܟܘܬܐ	南达科他州
ܡܘܢܬܐܢܐ	蒙大拿州
ܘܐܝܘܡܝܢܓ	怀俄明州
ܐܘܪܫܠܡ	耶路撒冷
ܐܝܕܐܗܘ	爱达荷州
ܢܝܒܐܕܐ	内华达州
ܐܘܩܝܢܘܣ ܗܢܕܘܝܐ	印度洋
ܟܘܠܘܪܐܕܘ	科羅拉多州
ܫܝܩܓܘ	芝加哥
ܣܬܘܐ	冬季
ܬܕܐܐ	春季
ܩܝܛܐ	夏季
ܬܫܪܝܬܐ	秋季
ܨܕܐܡ ܚܘܣܝܢ	萨达姆·侯赛因
ܠܫܢܐ ܐܣܦܢܝܐ	西班牙语
ܓܘܓܝ	蜘蛛
ܐܒܐ (ܦܐܪܐ)	果实
ܩܘܦܐ	猴
ܒܪܓܝܢܝܐ	弗吉尼亚州
ܝܡܬܐ ܕܝܘܪܘܢ	休伦湖
ܢܝܘ ܝܘܪܩ (ܐܘܚܕܢܐ ܡܚܝܕܐ)	纽约州
ܪܘܕ ܐܝܠܐܢܕ	羅德島州
ܪܚܫܐ	昆虫
ܡܐܪܝܠܐܢܕ	马里兰州
ܕܝܠܐܘܝܪ	特拉华州
ܐܘܗܐܝܘ	俄亥俄州
ܦܢܣܝܠܒܐܢܝܐ	宾夕法尼亚州
ܐܝܛܙܢ	于特森
ܐܓܘܣܛܘܣ ܩܣܪ	奥古斯都
ܢܝܘ ܓܝܪܣܝ	新泽西州
ܐܢܕܝܐܢܐ	印第安纳州
ܪܕܝܬܐ	汽车
ܓܘܪܓܝܐ (ܐܘܚܕܢܐ ܡܚܝܕܐ)	喬治亞州
ܣܩܠܝܐ	西西里岛
ܣܢ (ܢܗܪܐ)	塞纳河
ܛܘܩܝܘ	東京都
ܦܪܕܝܢܢܕ ܡܓܝܠܢ	斐迪南·麥哲倫
ܢܝܘ ܡܝܟܣܝܟܘ	新墨西哥州
ܐܬܢܘܣ	雅典
ܡܢܝܣܘܬܐ	明尼蘇達州
ܒܓܕܐܕ (ܡܕܝܢܬܐ)	巴格达
ܘܝܣܟܘܢܣܢ	威斯康辛州
ܐܝܐܘܐ	艾奥瓦州
ܢܝܒܪܐܣܟܐ	內布拉斯加州
ܟܐܢܣܐܣ	堪薩斯州
ܡܝܙܘܪܝ	密蘇里州
ܐܪܟܢܣܐܣ	阿肯色州
ܠܫܢܐ ܕܐܘܪܕܘ	乌尔都语
ܐܘܟܠܐܗܘܡܐ	奧克拉荷馬州
ܝܡܐ ܕܓܪܒܝܐ	北海 (大西洋)
ܒܝܝܢܐ	維也納
ܩܘܦܢܗܐܓܢ	哥本哈根
ܣܛܘܩܗܘܠܡ	斯德哥尔摩
ܗܠܣܢܩܝ	赫尔辛基
ܕܒܠܢ	都柏林
ܒܪܛܝܣܠܐܒܐ	布拉迪斯拉发
ܟܬܒܐ ܩܕܝܫܐ	聖經
ܥܕܬܐ ܫܪܝܪܬܐ ܕܝܫܘܥ	真耶稣教会
ܠܫܢܐ ܐܢܓܠܝܐ	英语
ܩܘܢܣܦܣܝܘܢ (ܬܫܝܠܝ)	康塞普西翁 (智利)
ܐܘܢܛܐܪܝܘ	安大略
ܡܐܢܝܛܘܒܐ	曼尼托巴
ܐܠܒܪܛܐ	艾伯塔
ܢܘܒܐ ܣܩܘܛܝܐ	新斯科舍
ܩܘܢܣܩܘܒܘܠܐ	孔斯科沃拉
ܢܝܘ ܒܪܘܢܙܘܝܩ	新不倫瑞克
ܩܘܠܘܡܒܝܐ ܒܪܝܛܝܬܐ	不列颠哥伦比亚
ܓܙܪܬܐ ܕܐܡܝܪܐ ܐܕܘܐܪܕ	愛德華王子島
ܣܐܣܩܐܬܫܘܐܢ	薩斯喀徹溫
2012	2012年
2011	2011年
2010	2010年
2009	2009年
ܢܝܘܦܐܘܢܕܠܢܕ ܘܠܐܒܪܐܕܘܪ	紐芬蘭與拉布拉多
2008	2008年
ܐܘܚܕܢܐ ܓܪܒܝܝܐ-ܡܥܪܒܝܐ	西北地区 (加拿大)
ܝܘܩܘܢ	育空
2005	2005年
2006	2006年
ܢܘܢܐܒܘܛ	努納武特
2007	2007年
ܡܐܟܘܠܬܐ	食物
ܚܘܝܐ	蛇
ܩܘܪܘܦ	库鲁夫
ܟܝܡܝܐ	化學
1968	1968年
ܩܛܠܥܡܐ ܝܗܘܕܝܐ	納粹大屠殺
ܡܕܪܝܕ (ܡܕܝܢܬܐ)	马德里
ܗܘܦܪܟܝܣ ܘܐܘܚܕܢܐ ܕܩܢܕܐ	加拿大行政区划
ܣܢܛܝܐܓܘ ܕܐ ܬܫܝܠܝ	圣地亚哥-德智利
ܚܐܪܘܬܐ	自由
ܣܝܕܢܝ	悉尼
ܝܪܘܩܐ	綠色
ܡܠܒܘܪܢ	墨尔本
ܣܘܡܩܐ	红色
ܢܘܪܐ (ܕܠܩܐ)	火
ܢܝܠܘܣ	尼罗河
ܓܙܐܐܪ (ܡܕܝܢܬܐ)	阿爾及爾
ܬܘܢܣ (ܡܕܝܢܬܐ)	突尼斯市
ܛܗܪܐܢ	德黑兰
ܐܢܩܪܐ	安卡拉
ܢܝܐܡܝ	尼亞美
ܒܡܩܘ	巴馬科
ܕܪܡܣܘܩ	大马士革
ܥܡܐܢ	安曼
ܒܝܪܘܬ	贝鲁特
ܒܝܬ ܨܘܒܐ	大學
ܒܝܬܐ (ܒܢܝܢܐ)	住宅
ܐܘܣܛܪܠܝܐ (ܝܒܫܬܐ)	澳大利亞洲
ܢܗܪܐ	河流
ܪܝܫܐ ܕܣܒܪܐ ܛܒܐ	好望角
ܫܘܚܡܠܐ	投资
ܩܘܪܝܛܝܒܐ	庫里奇巴
ܥܒܐ	森林
ܩܘܢܦܘܫܝܘܣ	孔子
ܩܢܐ	巢
ܐܘܪܘ	欧元
ܝܡܐ ܚܘܪܐ ܡܨܥܝܐ	地中海
ܓܘܪܓܝܐ	喬治亞 (消歧義)
ܡܫܝܚܝܘܬܐ	基督教
ܩܠܒܐ:ܐܘܝܐ	Template:Support
ܪܘܙܐ	稻
ܝܒܫܬܐ	洲
ܛܝܪܐ	鸟
ܐܪܫܟܝܬܐ	首都
ܠܫܢܐ ܦܘܪܛܘܓܠܝܐ	葡萄牙語
ܝܪܚܐ	月
ܡܘܨܛܦܐ ܟܡܐܠ ܐܛܐܛܘܪܩ	穆斯塔法·凯末尔·阿塔蒂尔克
ܐܠܡܐܙܢ	艾爾瑪善鎮
ܠܫܢܐ ܝܦܢܝܐ	日语
ܦܐܬܐ ܪܝܫܝܬܐ	Wikipedia:首页
ܦܪܢܣܝܣܩܘ ܓܘܝܐ	弗朗西斯科·戈雅
ܝܡܐ ܐܚܪܝܐ	裏海
ܝܡܬܐ ܕܐܝܪܝ	伊利湖
ܣܠܒܐܕܘܪ ܕܐܠܝ	萨尔瓦多·达利
ܒܢܣܢܬ ܦܢ ܟܘܟ	文森特·梵高
ܦܪܝܕܐ ܩܐܠܘ	芙烈達·卡蘿
ܗܢܪܝ ܡܐܛܝܣ	亨利·马蒂斯
ܡܝܟܠܐܢܓܠܘ	米开朗基罗
ܦܒܠܘ ܦܝܩܐܣܘ	巴勃羅·畢卡索
ܪܡܒܪܢܛ	伦勃朗
ܐܢܕܝ ܘܘܪܗܘܠ	安迪·沃荷
ܢܝܢܘܐ (ܡܕܝܢܬܐ)	尼尼微
ܒܒܠ	巴比伦
ܐܝܪܝܚܘ	杰里科
ܩܛܠܘܢܝܐ	加泰罗尼亚
ܡܕܪܝܕ (ܗܘܦܪܟܝܐ)	马德里自治区
ܒܝܬ ܠܚܡ	伯利恆
ܣܕܪܐ:Candidates for speedy deletion	Category:快速删除候选
ܪܫܡܠܘܬܐ	资本主义
ܐܘܡܬܐ	民族
ܩܪܬܐܓܘ	迦太基
ܣܕܪܐ:ܐܣܛܪܘܢܘܡܝܐ	Category:天文学
ܨܚܪܐܐ	撒哈拉沙漠
ܫܐܕܐ	魔鬼
ܒܝܬ ܟܬܒܐ	图书馆
ܫܘܠܛܢܘܬܐ (ܫܘܬܐܣܐ)	政府
ܬܫܝܢ ܫܝ ܗܘܐܢܓ	秦始皇
ܡܕܢܚܐ ܡܨܥܝܬܐ	中东
ܡܠܟܘܬܐ	君主制
ܩܘܛܢܝܘܬܐ	共和制
ܐܬܪܐ	國 (政治)
ܓܒܐ	政党
ܝܗܘܕܝܐ	犹太人
ܝܡܡܬܐ ܪܘܪܒܬܐ	五大湖
ܐܘܩܝܢܘܣ ܬܝܡܢܝܐ	南冰洋
ܐܕܢܐ (ܝܘܠܦܢ ܨܪܘܝܘܬܐ)	耳
ܢܚܝܪܐ	鼻
ܥܝܢܐ (ܝܘܠܦܢ ܨܪܘܝܘܬܐ)	眼
ܥܘܩܒܪܬܐ	肌肉
ܙܡܝܪܬܐ	歌曲
ܓܡܠܐ	骆驼
ܫܘܫܡܢܐ	蚂蚁
ܕܒܫܬܐ	蜂族
ܠܫܢܐ ܗܘܠܢܕܝܐ	荷蘭語
ܐܡܐ (ܒܝܬܝܘܬܐ)	母親
ܐܒܐ (ܒܝܬܝܘܬܐ)	父親
1847	1847年
ܨܦܪܐ (ܙܒܢܐ)	早晨
ܪܡܫܐ	傍晚
ܩܛܝܢܬܐ	分 (时间单位)
ܠܫܢܐ ܪܘܣܝܐ	俄语
ܩܢܘܢܐ	法律
ܠܫܢܐ ܨܝܢܝܐ	汉语
ܕܡܐ	血液
ܬܓܪܘܡܬܐ	骨骼系統
ܪܐܬܐ	肺
ܠܫܢܐ ܪܘܡܢܝܐ	羅馬尼亞語
ܡܛܪܐ	雨
ܢܠܣܘܢ ܡܐܢܕܝܠܐ	纳尔逊·曼德拉
ܐܒܢܐ	岩石
ܥܢܢܐ	云
ܩܢܘܢܐ ܕܠܥܙܐ	语法
ܠܫܢܐ ܓܘܪܓܝܐ	格鲁吉亚语
ܝܘܠܦܢ ܡܡܫܚܘܬܐ	经济学
ܙܘܙܐ	通貨
ܡܕܐܬܐ	稅
ܐܠܦܒܝܬ ܥܪܒܝܐ	阿拉伯字母
ܐܠܦܒܝܬ ܝܘܢܝܐ	希腊字母
ܐܠܦܒܝܬ ܠܐܛܝܢܝܐ	拉丁字母
ܣܕܪܐ:ܦܪܢܣܐ	Category:法国
ܟܢܫܐ	社会
ܓܒܪܐ	男性
ܙܘܘܓܐ	婚姻
ܙܕܩܐ ܕܒܪܢܫܐ	人权
ܩܪܒܐ ܓܘܝܐ	内战
ܓܪܡܐ ܕܣܢܘܢܝܬܐ	胸骨
ܬܪܝܢܐ	果汁
ܚܠܒܐ (ܕܝܘܒܐ)	乳
ܛܘܪܐ	山
ܡܕܒܪܐ	荒漠
ܠܫܢܐ ܐܠܒܢܝܐ	阿尔巴尼亚语
ܠܫܢܐ ܐܪܡܢܝܐ	亚美尼亚语
ܝܘܗܐܢ ܓܘܛܢܒܪܓ	约翰内斯·古腾堡
ܠܫܢܐ ܣܘܝܕܝܐ	瑞典語
ܢܝܩܘܠܐ ܛܣܠܐ	尼古拉·特斯拉
ܡܘܫܐ	摩西
ܬܕܐ	乳房
ܢܘܗܪܐ (ܚܙܝܬܐ)	光
ܠܫܢܐ ܝܘܢܝܐ	希腊语
ܠܫܢܐ ܦܪܣܝܐ	波斯语
ܬܘܕܝܬܐ	宗教
ܐܒܪܗܡ	亞伯拉罕
ܣܦܪܐ ܕܒܪܝܬܐ	創世記
ܠܫܢܐ ܩܢܛܘܢܝܐ	广州话
ܠܫܢܐ ܡܢܕܪܝܢܝܐ	官话
ܦܘܠܘܣ ܫܠܝܚܐ	保罗 (使徒)
ܙܝܓܡܘܢܕ ܦܪܘܝܕ	西格蒙德·弗洛伊德
ܙܠܛܐ	沙律
ܝܗܘܕܝܘܬܐ	犹太教
ܠܫܢܐ ܥܒܪܝܐ	希伯来语
ܟܒܕܐ	肝臟
ܛܚܠܐ	脾脏
ܟܘܠܝܬܐ	腎
ܫܠܦܘܚܬܐ	膀胱
ܐܫܟܐ	睾丸
ܐܘܩܝܢܘܣ	洋
ܒܘܕܗܐ	释迦牟尼
ܡܘܚܡܕ	穆罕默德
ܟܪܣܐ	腹
ܚܒܠܐ ܟܘܒܝܐ	脊髓
ܘܪܝܕܐ	静脉
ܡܪܒܥܐ	子宫
ܠܫܢܐ (ܗܕܡܐ)	舌
ܓܝܕܐ	神经
ܨܘܪܐ (ܝܘܠܦܢ ܨܪܘܝܘܬܐ)	頸
ܦܘܡܐ	口腔
ܓܓܪܬܐ	喉頭
ܡܥܝܐ	腸臟
ܫܪܝܬܐ	关节
ܬܝܪܬܐ	腺
ܚܠܒܐ (ܝܘܠܦܢ ܨܪܘܝܘܬܐ)	橫膈膜
ܫܪܝܢܐ	动脉
A	A
B	B
ܢܘܛܦܬܐ	精液
G	G
U	U
Z	Z
F	F
J	J
ܐܠܦܒܝܬ	字母系統
T	T
C	C
R	R
D	D
Α	Α
Ω	Ω
I	I
Μ	Μ
E	E
H	H
ܗܐܪܠܡ (ܗܘܠܢܕܐ)	哈勒姆
K	K
L	L
M	M
N	N
O	O
Q	Q
S	S
V	V
W	W
X	X
Y	Y
ܐܢܫܟܕܐ	恩斯赫德
ܗܢܓܠܘ	亨厄洛
Φ	Φ
ܝܘܢܐ	鸠鸽科
ܐܝܠܢܐ	树
Λ	Λ
ܓܒܬܐ	乾酪
ܥܢܒܬܐ	葡萄
ܕܒܫܐ	蜂蜜
ܒܣܪܐ	肉类食物
ܫܟܪ	食糖
ܣܦܪܙܒܢܐ	報紙
ܙܥܘܩܐ	电话
ܡܪܕܘܬܐ	文化
ܡܥܝܐ ܥܒܝܐ	大肠
ܡܥܝܐ ܩܛܝܢܐ	小肠
ܣܘܪܓܕܐ ܝܘܠܝܝܐ	儒略曆
ܐܣܝܘܬܐ	医学
ܡܠܚܐ (ܐܨܪܐ)	食盐
ܣܕܪܐ:ܒܪܐܙܝܠ	Category:巴西
ܙܘܝܬܐ (ܡܚܪܘܬܐ)	角
ܬܘܩܦܐ	能量
ܣܦܝܢܬܐ	船
ܩܠܐ (ܨܘܬܐ)	声音
ܙܓܘܓܝܬܐ	玻璃
ܫܛܝܚܘܬܐ	面积
ܡܢܝܢܐ	数
ܪܦܦܐ	秒
ܣܥܪܬܐ	大麦
ܘܘܗܐܢ	武汉市
ܡܟܬܒܢܘܬܐ ܕܐܬܪܘܬܐ	世界政區索引
ܒܝܬ ܢܗܪܝܢ	美索不达米亚
ܕܒܐ	熊科
ܬܠܗܝܐ	癌症
ܚܛܬܐ	小麦
ܣܘܪܓܕܐ	历法
ܟܘܪܗܢܐ	疾病
ܣܘܪܓܕܐ ܓܪܝܓܘܪܝܐ	公历
ܟܦܣܐ	月經
ܥܡܐ ܩܪܕܘܝܐ	库尔德人
ܓܫܪܐ	橋
ܡܓܕܠܐ (ܒܢܝܢܐ)	塔式建築
ܐܡܪܝܩܐ ܠܐܛܝܢܝܬܐ	拉丁美洲
ܟܗܪܒܐ	電
ܡܙܝܥܢܐ ܕܩܝܕܐ ܓܘܝܐ	内燃机
ܣܝܦܐ (ܙܝܢܐ)	劍
ܫܡܥܘܢ ܩܢܢܝܐ	奮銳黨的西門
ܩܪܩܦܬܐ	颅骨
ܓܘܡܠܐ!	Joomla!
ܐܦܫܬܐ	葡萄乾
ܠܫܢܐ ܕܗܣܝܐܢܓ	湘语
ܠܫܢܐ ܥܪܒܝܐ	阿拉伯语
ܠܫܢܐ ܐܦܪܝܩܐܢܝܐ	南非語
Β	Β
Γ	Γ
Δ	Δ
Ε	Ε
Ζ	Ζ
Η	Η
Θ	Θ
Ι	Ι
Κ	Κ
Ν	Ν
Ξ	Ξ
Ο	Ο
Ρ	Ρ
Σ	Σ
Τ	Τ
Υ	Υ
Χ	Χ
Ψ	Ψ
ܐܬܐ	旗幟
ܟܪܦܬܐ	家具
ܟܘܪܣܝܐ	椅
ܣܦܬܐ	唇
ܥܩܠܐ	脚
1000000000 (ܡܢܝܢܐ)	1000000000
ܓܪܡܐ ܕܨܕܥܐ	颞骨
ܩܠܝܕܐ (ܓܪܡܐ)	锁骨
ܟܬܦܐ	肩
ܦܟܐ ܬܚܬܝܐ	下颌骨
ܩܠܒܐ:Link FA	Template:Link FA
ܥܠܡܐ (ܐܪܥܐ)	世界
ܘܝܩܝܦܕܝܐ:ܬܪܥܐ ܕܟܢܫܐ	Wikipedia:互助客栈
ܒܝܪܡܘܢܬ	佛蒙特州
ܩܘܣܛܢܛܝܢܘܦܘܠܝܣ	君士坦丁堡
ܒܝܬ ܟܪܝܗܐ	醫院
ܥܕܬܐ	教堂
ܕܝܬܝܩܝ ܚܕܬܐ	新約聖經
9 (ܡܢܝܢܐ)	9
1002	1002年
ܦܘܕܘܠܣܟ	波多利斯克
ܦܐܦܐ	教宗
5	5年
4	4年
ܢܝܒܐ	犬齒
3	3年
2	2年
ܒܝܬ ܥܬܩܐ ܕܠܘܒܪ	卢浮宫
ܓܒܐ ܕܚܐܪܘܬܐ ܕܦܘܐܪܛܘ ܪܝܩܘ	波多黎各獨立黨
6	6年
ܕܝܬܝܩܝ ܥܬܝܩܬܐ	旧约圣经
ܥܐܕܐ ܕܒܝܬ ܝܠܕܐ	圣诞节
ܠܫܢܐ ܪܘܡܐܢܣܝܐ	罗曼语族
ܡܬܠܬܐ	三角形
ܫܢܬܐ ܟܒܝܫܬܐ	闰年
ܡܘܥܡܪ ܐܠܩܕܐܦܝ	穆阿迈尔·卡扎菲
ܥܐܕܐ ܕܩܝܡܬܐ	復活節
ܢܝܘ ܝܘܪܩ	紐約 (消歧義)
ܢܦܛܐ	石油
ܣܐܘܢܐ	鞋
ܒܝܬ ܥܘܪܦܢܐ	銀行
ܟܪܡܐ	葡萄园
ܐܝܪܠܢܕ (ܓܙܪܬܐ)	爱尔兰岛
1	1年
ܠܘ ܫܘܢ	鲁迅
10	10年
20	20年
9	9年
7	7年
8	8年
7 (ܡܢܝܢܐ)	7
8 (ܡܢܝܢܐ)	8
12	12年
ܡܠܐܐ ܘܬܘܒܐ	潮汐
ܫܒܘܥܐ	星期
ܓܠܝܕܐ	冰
ܨܠܘܬܐ ܡܪܢܝܬܐ	主禱文
ܝܡܬܐ	湖泊
ܝܡܐ ܣܘܡܩܐ	红海
13	13年
ܩܛܘܬܐ (ܝܥܝܬܐ)	黄瓜
ܓܙܪܬܐ	島嶼
ܚܘܪܐ	白色
ܐܘܟܡܐ	黑色
6 (ܡܢܝܢܐ)	6
ܠܫܢܐ ܪܘܫܡܝܐ	官方语言
11	11年
15	15年
14	14年
17	17年
ܣܦܪ ܡܠܐ	詞典
18	18年
19	19年
16	16年
21	21年
ܦܠܣܛܝܢ	巴勒斯坦
10 (ܡܢܝܢܐ)	10
ܡܣܘܪܩܐ (ܡܐܢܐ)	梳篦
ܠܝܠܐ ܕܘܢܤ	利拉·唐斯
ܝܡܐ ܕܡܠܚܐ	死海
ܫܘܚܠܦܐ ܕܫܢܬܐ	季节
ܠܝܒܪܦܘܠ	利物浦
ܩܘܦܬܐ (ܛܝܪܐ)	貓頭鷹
ܫܥܬܐ	小时
ܢܐܘܝ ܕܘܪ ܟܪܘܠܣܟܝ	克鲁莱夫斯基新庄园
ܐܪܙܦܬܐ	槌
ܝܘܢܫܘܦܝܢ	延雪平
ܥܘܠܐ ܚܝܐ	胎兒
ܐܠܦܒܝܬ ܣܘܪܝܝܐ	敘利亞字母
ܐܠܦܒܝܬ ܐܪܡܝܐ	亞蘭字母
ܐܣܝܐ ܡܥܪܒܝܬܐ	西亚
ܙܡܪܐ	歌唱
ܫܓܠܐ	跳房子
ܩܠܦܬܐ ܕܒܣܡܐ	桂皮
ܡܙܬܐ	頭髮
ܠܫܢܐ ܐܪܡܝܐ	阿拉米语
ܨܦܪܐ (ܛܝܪܐ)	雀科
ܐܦܣܩܘܦܐ	主教
ܨܝܢ (ܐܪܥܐ)	中國
ܓܒܐ ܕܝܡܘܩܪܛܝܐ (ܐܘܚܕܢܐ ܡܚܝܕܐ)	民主党 (美国)
ܒܝܐܛܪܝܟܣ ܕܒܝܬ ܗܘܠܢܕܝܐ	贝娅特丽克丝 (荷兰)
ܡܠܟܘܬܐ ܕܗܘܠܢܕܐ	荷兰王国
ܐܒܪܝܠ ܠܐܒܝܢ	艾薇兒·拉維尼
ܪܝܫ ܩܘܛܢܝܘܬܐ	總統
ܐܚܐ (ܒܝܬܝܘܬܐ)	兄弟姊妹
ܐܪܒܝܐ	阿拉伯半岛
ܡܪܩܘܣ ܐܘܢܓܠܣܛܐ	聖馬爾谷
ܥܘܠܐ	胚胎
ܠܫܢܐ ܕܗܟܐ	客家语
ܫܘܫܡܢܝܬܐ (ܝܥܝܬܐ)	白豆蔻
ܠܫܢܐ ܕܓܐܢ	贛語
ܒܝܬ ܥܬܩܐ	博物馆
ܐܠܦܒܝܬ ܥܒܪܝܐ	希伯来字母
ܠܫܢܐ ܣܘܪܝܝܐ	敘利亞語
ܒܪܩܐ	闪电
ܐܝܕܐ	手
ܫܡܥܘܢ ܟܐܦܐ	彼得 (使徒)
ܬܠ ܐܒܝܒ	特拉维夫
ܒܐܠܦܐܪܐܝܣܘ	瓦尔帕莱索
ܛܘܪܝܐ	圖羅尤語
ܠܫܢܐ ܫܝܡܝܐ	闪米特语族
ܚܘܣܢܝ ܡܘܒܐܪܟ	穆罕默德·胡斯尼·穆巴拉克
ܘܐܟܐܩܐ	瓦哈卡州
ܚܐܘܬܐ	黄油
ܐܘܢܓܠܝܘܢ	福音书
ܠܫܢܐ ܕܘܘ	吴语
ܪܘܛܪܕܐܡ	鹿特丹
ܩܪܛܐ	克里特
ܐܘܪܚܐ	道路
ܩܘܪܨܐ ܚܠܝܨܐ	CD
ܦܪܬ	幼发拉底河
ܩܝܘܛܘ	京都市
ܥܣܪܐ ܦܘܩܕܢܐ	十誡
ܒܪܩܩܐ ܦܪܣܝܐ	波斯湾
ܚܠܐ (ܕܚܝܚܐ)	沙
ܘܪܕܐ	蔷薇属
ܓܙܪܬܐ ܝܒܫܢܝܬܐ	半岛
ܐܘܪܝܬܐ	妥拉
ܟܘܘܝܬ (ܡܕܝܢܬܐ)	科威特市
ܡܚܙܝܬܐ	鏡子
ܥܡܐ ܥܪܒܝܐ	阿拉伯人
ܟܘܬܐ	窗
ܠܫܢܐ ܝܘܢܝܐ ܥܬܝܩܐ	古希臘語
ܠܫܢܐ ܐܟܕܝܐ	阿卡德語
ܕܩܠܬ	底格里斯河
ܐܬܪܘܬܐ ܕܐܬܪܘܬܐ ܡܚܝܕܐ ܕܐܡܪܝܩܐ	美国州份
ܡܥܡܘܕܝܬܐ	洗禮
ܩܘܢܓܘ	刚果
ܐܝܢܛܪܠܝܢܓܘܐ	国际语
ܐܘܪܟܐ	长度
ܚܠܡܐ	夢
ܠܫܢܐ ܩܪܕܘܝܐ	庫爾德語
ܩܡܚܐ	麵粉
ܕܢ ܗܐܟ	海牙
ܠܫܢܐ ܦܘܢܝܩܝܐ	腓尼基语
ܣܝܢܝ (ܓܙܪܬܐ ܝܒܫܢܝܬܐ)	西奈半島
ܟܪܘܙܘܬܐ ܕܝܘܚܢܢ	約翰福音
ܬܪܥܐ (ܒܒܐ)	門 (建築部件)
ܪܝܗܐܢܐ	蕾哈娜
ܛܦܪܐ	指甲
ܐܦܐ	臉
ܨܨܐ (ܨܢܥܬܐ)	钉子
ܙܝܬܐ	橄欖 (木樨科)
ܬܠܝܬܝܘܬܐ	三位一體
ܓܠܠܐ	波
ܟܬܒܬܐ	寫作
ܪܘܚܐ ܕܩܘܕܫܐ	聖靈
100 (ܡܢܝܢܐ)	100
ܒܘܪܟܐ	膝
ܫܘܩܐ (ܬܐܓܪܘܬܐ)	市场
ܠܫܢܐ ܥܪܒܝܐ ܝܗܘܕܝܐ	猶太-阿拉伯語
ܒܠܛܝ	伯爾茲
1000000 (ܡܢܝܢܐ)	1000000
ܛܐܒܐ	新闻
ܐܫܬܐ (ܐܣܝܘܬܐ)	发热
ܩܫܬܐ ܓܪܒܝܝܬܐ ܕܐܪܥܐ	北半球
ܡܡܘܢܐ ܕܡܝܟܪܐ	微观经济学
ܠܝܕܣ	利兹
ܥܘܩܒܪܐ	小鼠属
ܦܘܪܬܩܠܐ	橙色
ܒܪܩܩܐ	海灣
ܒܝܬ ܩܒܘܪܐ	墳場
ܐܣܝܐ (ܫܕܬܐ)	医生
ܡܩܕܘܢܝܐ	馬其頓 (消歧義)
ܦܢܛܝܩܘܣܛܝ	五旬節
ܫܓܕܬܐ	扁桃
ܟܪܘܙܘܬܐ ܕܠܘܩܐ	路加福音
ܩܘܢܣܦܣܝܘܢ (ܗܘܦܪܟܝܐ)	康賽普西翁省 (智利)
ܢܗܪܐ ܕܝܘܪܕܢܢ	约旦河
ܣܦܪ ܝܡܐ	灘
ܐܢܛܐܠܝܐ (ܗܘܦܪܟܝܐ)	安塔利亚省
ܦܪܟܣܝܣ ܕܫܠܝܚܐ	使徒行传
ܥܪܘܒܬܐ ܕܚܫܐ	耶穌受難節
ܚܒܘܫܝܐ	監獄
ܐܕܢܐ (ܗܘܦܪܟܝܐ)	阿达纳省
ܝܘܚܢܢ ܡܥܡܕܢܐ	聖若翰洗者
ܨܠܝܒܐ	十字
ܚܙܒܐܠܠܗ	真主党
ܒܝܬ ܓܒܝܢܐ	前额
ܡܙܡܘܪܐ	詩篇
ܐܬܘܪ	亚述
ܒܢܝܢܐ	建筑物
ܚܠܒ (ܡܕܝܢܬܐ)	阿勒颇
ܩܫܬܐ ܬܝܡܢܝܬܐ ܕܐܪܥܐ	南半球
ܚܠܐ (ܚܡܪܐ)	醋
ܒܝܬ ܕܝܢܐ	法院
ܚܝܦܐ	海法
ܫܛܪܐ ܬܐܒܝܠܝܐ ܕܓܝܢܝܣ	吉尼斯世界纪录大全
ܟܘܕܢܝܐ	骡
ܒܪܩܩܐ ܕܥܕܢ	亚丁湾
ܓܠܝܢܐ ܕܝܘܚܢܢ	启示录
ܐܫܬܐ (ܝܘܠܦܢ ܨܪܘܝܘܬܐ)	臀
ܨܠܘܬܐ ܡܪܝܡܝܬܐ	聖母經
ܝܩܕܐ	燃料
ܝܨܝܠܐ	肘
ܟܗܢܐ	祭司
ܕܩܢܐ	鬍鬚
ܢܒܝܐ	先知
ܐܘܪܟܝܣܛܪܐ	管弦樂團
1000 (ܡܢܝܢܐ)	1000
ܣܘܦܝܐ ܪܘܛܐܪܘ	索菲亚·罗塔璐
ܬܫܢܝܬܐ	保險
ܛܘܟܣܐ	组织 (社会学)
ܣܦܪܓܠܐ	榲桲
ܐܢܕܪܐܘܣ ܫܠܝܚܐ	安得烈
ܬܪܥܣܪ ܫܠܝܚܐ	使徒 (基督教)
ܢܩܒܬܐ	雌性
ܕܪܥܐ (ܗܕܡܐ)	臂
ܡܬܝ ܡܟܣܐ	馬太
ܬܐܘܡܐ ܫܠܝܚܐ	多馬 (使徒)
ܦܝܠܝܦܘܣ ܫܠܝܚܐ	腓力 (使徒)
ܒܘܪܨܐ (ܗܘܦܪܟܝܐ)	布尔萨省
ܐܝܘܐܢܢܝܣ ܦܘܡܐ ܕܕܗܒܐ	约翰一世 (君士坦丁堡牧首)
ܒܢܝܡܝܢ ܢܬܢܝܗܘ	本雅明·内塔尼亚胡
ܐܪܬܒܝܢ (ܗܘܦܪܟܝܐ)	阿尔特温省
ܓܒܝܢܐ	眉毛
ܫܘܪܬܐ	肚脐
ܐܕܝܐܡܐܢ (ܗܘܦܪܟܝܐ)	阿德亚曼省
ܝܗܘܕܐ ܫܠܝܚܐ	猶達·達陡
ܒܪܬܘܠܡܝ ܫܠܝܚܐ	巴多罗买
ܝܥܩܘܒ ܒܪ ܙܒܕܝ	雅各 (西庇太的兒子)
ܝܘܚܢܢ ܫܠܝܚܐ	約翰 (使徒)
ܡܬܝܐ ܫܠܝܚܐ	馬提亞
ܝܥܩܘܒ ܒܪ ܚܠܦܝ	雅各 (亞勒腓的兒子)
ܕܟܪܐ	雄性
ܐܝܓܢܐܛܝܘܣ ܢܘܪܢܐ	伊格那丢
ܪܕܝܘܗܕ	电台司令
ܒܫܐܪ ܐܠܐܣܕ	巴沙尔·阿萨德
ܪܚܝܐ	研磨
ܨܘܡܐ	禁食
ܕܝܪܐ	僧院
ܠܡܐܢܐ	港口
ܡܠܚܐ (ܢܘܛܐ)	海員
ܐܦܝܘܢ (ܗܘܦܪܟܝܐ)	阿菲永卡拉希萨尔省
ܡܝܟܐܝܠ (ܡܠܐܟܐ)	米迦勒
ܒܝܠܓܝܟ (ܗܘܦܪܟܝܐ)	比莱吉克省
ܒܝܬ ܥܬܩܐ ܕܐܣܪܐܝܠ	以色列博物館
ܒܐܠܝܟܣܝܪ (ܗܘܦܪܟܝܐ)	巴勒克埃西尔省
ܒܝܬ ܝܠܕܐ	生日
ܬܘܠܥܐ	蠕虫
ܬܘܩܢ ܓܝܕܝܐ ܩܢܛܪܘܢܝܐ	中樞神經系統
ܛܘܪܐ ܕܓܠܝܕܐ	冰山
ܡܫܠܡܢܐ	穆斯林
ܢܢܥܐ	薄荷
ܩܠܒܐ:Commonscat	Template:Commons category
ܒܨܪܐ (ܡܕܝܢܬܐ)	巴士拉
ܐܓܪܬܐ ܕܠܘܬ ܪܗܘܡܝܐ	羅馬書
ܬܡܪܐ ܕܥܝܢܐ	眼睑
ܗܘܦܪܟܝܣ ܕܛܘܪܩܝܐ	土耳其行政区划
ܡܪܝ ܓܝܘܪܓܝܣ ܣܗܕܐ	圣乔治
ܐܣܘܬܐ ܕܠܐ ܬܚܘܡܐ	無國界醫生
ܐܪܙܐ (ܡܫܝܚܝܘܬܐ)	聖禮
ܐܓܪܬܐ ܕܠܘܬ ܦܝܠܝܦܣܝܐ	腓立比書
ܐܢܛܘܠܝܐ	安那托利亞
ܡܫܝܚܐ	彌賽亞
ܚܫܡܝܬܐ ܐܚܪܝܬܐ	最后的晚餐
ܩܢܘܢܐ ܕܗܝܡܢܘܬܐ	使徒信經
ܒܢܝ ܐܝܣܪܐܝܠ	以色列人
ܡܓܘܫܐ ܬܠܬܐ	東方三博士
ܝܘܚܢܢ ܕܪܡܣܘܩܝܐ	大馬士革的聖約翰
ܒܒܐ (ܬܪܥܐ)	門 (建築物)
ܣܕܪܐ:ܪܘܟܒ ܫܘܠܛܢܘܬܐ	Category:政体
ܠܫܢܐ ܕܡܝܢ	闽语
ܥܘܪܡܫܐ	污染
ܒܒܠ (ܗܘܦܪܟܝܐ)	巴比倫省
ܫܘܡܪܐ	炭黑
ܐܫܩܠܘܢ	亚实基伦
ܕܘܢܒܐ	尾
ܩܐܕܣܝܐ (ܗܘܦܪܟܝܐ)	卡迪西亞省
ܡܪܝܡ ܡܓܕܠܝܬܐ	抹大拉的馬利亞
ܡܪܪܬܐ	胆囊
ܥܕܬܐ ܟܠܕܝܬܐ ܩܬܘܠܝܩܝܬܐ	加色丁禮天主教會
ܥܕܬܐ ܡܪܘܢܝܬܐ	马龙尼礼教会
ܡܪܬܐ	胆汁
ܩܘܪܒܢܐ	聖餐禮
ܐܕܡ	亞當
ܐܘܘܫܐ	耳垢
ܕܡܥܬܐ	淚
ܥܡܬܐ (ܒܝܬܝܘܬܐ)	姑母
ܟܘܬܝܢܐ	襯衫
ܝܘܗܐܢ ܐܠܙܪ	喬治·艾爾塞
ܒܝܢܓܘܠ (ܗܘܦܪܟܝܐ)	宾格尔省
ܥܡܐ ܐܪܡܢܝܐ	亚美尼亚人
ܐܝܕܝܢ (ܗܘܦܪܟܝܐ)	艾登省
ܩܛܠܥܡܐ ܐܪܡܢܝܐ	亚美尼亚种族大屠杀
ܐܡܐܣܝܐ (ܗܘܦܪܟܝܐ)	阿马西亚省
ܦܪܝܙܘܢ ܒܪܝܟ	越狱 (电视剧)
ܐܓܪܝ (ܗܘܦܪܟܝܐ)	阿勒省
ܒܘܪܕܘܪ (ܗܘܦܪܟܝܐ)	布尔杜尔省
ܐܓܪܬܐ ܩܕܡܝܬܐ ܕܠܘܬ ܩܘܪܢܬܝܐ	哥林多前書
ܝܗܘܕܐ ܣܟܪܝܘܛܐ	加略人猶大
ܐܒܪܐ	羽毛
ܡܚܪܐ	工程师
ܚܪܛܘܡܢܐ	鹰嘴豆
ܐܬܪܘܬܐ ܕܫܐܡ	黎凡特
ܬܪܘܕܐ	匙
ܓܒܪܐܝܠ (ܡܠܐܟܐ)	加百列
ܓܪܡܦܝܠܐ	象牙
ܨܘܪ	泰尔
ܒܘܠܘ (ܗܘܦܪܟܝܐ)	博卢省
ܙܢܩܐ	頷
ܨܘܡܐ ܕܐܪܒܥܝܢ	大齋期
ܐܓܪܐ ܕܒܢܝܢܐ	屋顶
ܒܝܛܠܝܣ (ܗܘܦܪܟܝܐ)	比特利斯省
ܓܠܝܠܐ	加利利
ܪܥܡܐ	雷
ܡܘܨܠ	摩苏尔
ܟܪܬܐ	拇指
ܥܡܐ ܛܘܪܩܝܐ	土耳其人
ܦܐܦܐ ܫܢܘܕܐ ܬܠܝܬܝܐ	欣諾達三世
ܒܝܬ ܓܘܣܐ	地堡
ܒܝܥܬܐ	蛋
ܒܣܕܝܐ	枕頭
ܙܓܐ (ܢܩܘܫܐ)	鐘 (敲擊器)
ܫܒܬܐ (ܝܗܘܕܝܘܬܐ)	安息日
ܫܡܝܪܡ	沙米拉姆
ܫܝܓܪܐ	牙齦
ܝܗ	四字神名
ܡܫܝܚܝܐ	基督徒
ܟܪܘܙܘܬܐ ܕܡܪܩܘܣ	馬可福音
ܟܟܪܝܬܐ ܕܕܒܫܐ	蜂巢
ܐܓܪܬܐ ܕܠܘܬ ܩܘܪܢܬܝܐ ܕܬܪܬܝܢ	哥林多後書
ܫܥܘܬܐ (ܡܠܘܐܐ)	蜡
ܛܥܡܐ	味觉
ܓܢܬ ܫܒܪܐ	幼稚園
ܝܡܬܐ ܕܓܠܝܠܐ	加利利海
ܕܝܘܬܐ	墨水
ܡܪܝ ܝܘܣܦ	聖若瑟
ܠܘܩܐ ܐܘܢܓܠܣܛܐ	路加
ܐܓܪܬܐ ܕܠܘܬ ܥܒܪܝܐ	希伯來書
ܐܓܪܬܐ ܕܠܘܬ ܓܠܛܝܐ	加拉太書
Ϝ	Ϝ
Ϙ	Ϙ
ܥܛܡܐ	大腿
ܬܢܢܐ	煙
ܡܘܚܘܢܐ	小脑
ܐܓܪܬܐ ܕܠܘܬ ܩܘܠܣܝܐ	歌羅西書
ܐܓܪܬܐ ܕܝܥܩܘܒ	雅各書
ܐܓܪܬܐ ܩܕܡܝܬܐ ܕܝܘܚܢܢ	約翰一書
ܐܓܪܬܐ ܕܠܘܬ ܦܝܠܡܘܢ	腓利門書
ܐܓܪܬܐ ܕܠܘܬ ܬܣܠܘܢܝܩܝܐ ܕܬܪܬܝܢ	帖撒羅尼迦後書
ܐܓܪܬܐ ܩܕܡܝܬܐ ܕܠܘܬ ܬܣܠܘܢܝܩܝܐ	帖撒罗尼迦前书
ܐܓܪܬܐ ܩܕܡܝܬܐ ܕܦܛܪܘܣ	彼得前書
ܐܓܪܬܐ ܕܬܪܬܝܢ ܕܦܛܪܘܣ	彼得後書
ܐܓܪܬܐ ܩܕܡܝܬܐ ܕܠܘܬ ܛܝܡܬܐܘܣ	提摩太前書
Ϛ	Ϛ
ܡܪܕܝܢ (ܗܘܦܪܟܝܐ)	马尔丁省
ܚܡܨ (ܡܕܝܢܬܐ)	霍姆斯 (敘利亞)
Ͳ	Ͳ
ܘܐܟܐܩܐ ܕܝ ܟܘܐܪܝܣ	瓦哈卡市
ܐܓܪܬܐ ܕܬܪܬܝܢ ܕܝܘܚܢܢ	約翰二書
ܐܓܪܬܐ ܕܬܠܬ ܕܝܘܚܢܢ	約翰三書
ܐܓܪܬܐ ܕܝܗܘܕܐ	猶大書
ܐܓܪܬܐ ܕܠܘܬ ܛܝܡܬܐܘܣ ܕܬܪܬܝܢ	提摩太後書
ܐܓܪܬܐ ܕܠܘܬ ܛܛܘܣ	提多書
ܫܝܪܢܐܟ (ܡܕܝܢܬܐ)	舍爾納克
ܐܟܪܐ	農夫
ܓܘܣܢܐ	难民
Ϻ	Ϻ
ܩܠܝܕܐ (ܡܐܢܐ)	鑰匙
ܥܕܥܐܕܐ	节日
ܐܪܒܝܠ (ܡܕܝܢܬܐ)	阿尔贝拉
ܪܓܠܐ	腿
ܚܨܐ	背
ܐܠܝܐ ܢܒܝܐ	以利亞
ܙܚܘܪܝܬܐ (ܬܘܠܥܬܐ)	蚕
ܚܘܦܝܐ	食 (天文現象)
ܡܚܛܐ	針
ܥܠܡܐ ܥܪܒܝܐ	阿拉伯世界
ܦܓܘܕܬܐ	马辔
ܩܛܡܐ	灰分
ܢܘܗܕܪܐ (ܡܕܝܢܬܐ)	達霍克
ܨܒܥܐ ܕܪܓܠܐ	腳趾
ܢܓܪܘܬܐ	木匠
ܠܘܚܐ (ܚܫܘܒܬܐ)	平板電腦
ܪܒܝܬܐ	高利貸
ܡܟܝܪܘܬܐ	訂婚
ܫܘܪܡܐ	直肠
ܐܪܡܝܐ (ܢܒܝܐ)	耶利米
ܬܐܡܐ	雙胞胎
ܬܠܝܦܐ	睫毛
ܫܥܬܐ ܕܐܪܥܐ	地球一小时
ܦܪܡܝܬܐ	鈕扣
ܟܘܟܒܐ ܕܕܘܝܕ	大衛星
ܡܪܝ ܐܣܛܦܢܘܣ	聖斯德望
ܡܫܡܫܢܐ	执事
ܢܓܒ	內蓋夫 (以色列)
ܟܢܥܢ	迦南
ܢܘܨܦܐ	曙暮光
ܒܝܢܐ	红荆
ܬܓܪܝܬ	提克里特
ܚܠܐ (ܥܦܪܐ)	灰塵
ܬܪܥܐ ܕܕܡܐ	出血
ܥܪܒܐ ܕܫܡܫܐ	日落
ܐܡܝܫܐ	沼泽
ܡܨܥܝܬܐ (ܨܒܥܐ)	中指
ܣܒܐ (ܒܝܬܝܘܬܐ)	祖父母
ܩܘܪܨܠܐ	腳踝
ܒܪ ܐܝܕܐ	手套
ܢܫܒܐ ܕܥܝܢܐ	视网膜
ܬܘܩܢ ܓܝܕܝܐ ܡܚܕܘܪܝܐ	周围神经系统
ܛܝܢܐ	泥
ܓܓܘܠܬܐ	各各他
ܗܢܝܢܐ (ܡܡܫܚܘܬܐ)	利息
ܐܫܘܪ ܒܢܐܦܠ	亚述巴尼拔
ܓܕܫܐ	意外事故
ܦܛܪܝܪܟܐ	宗主教
ܚܟܐ	腭
ت	Taw
خ	خ
ܪܓܫܐ	感官
ܟܪܟ ܣܠܘܟ (ܡܕܝܢܬܐ)	基爾庫克
ܒܒܬܐ	瞳孔
ܩܒܪܐ	坟墓
ܠܒܘܢܬܐ	乳香
ܚܡܬ (ܡܕܝܢܬܐ)	哈马 (叙利亚)
ܝܫܛܐ	食道
ܟܝܣܐ ܕܐܫܟܐ	阴囊
ܕܒܪܐ	农村
ܚܪܘܫܬܐ	氣管
ܓܪܡܐ ܕܥܛܡܐ	股骨
ܒܪܐ (ܒܝܬܝܘܬܐ)	兒子
ܫܚܘܪܐ	木炭
ܐܘܟܡܐ ܕܥܝܢܐ	虹膜
ܫܦܠܘܗܝ ܕܢܝܠܘܣ	尼罗河三角洲
ܐܘܪܡܝܐ	乌尔米耶
Ϸ	Ϸ
ܓܙܪܬܐ ܐܝܘܠܝܬܐ	埃奥利群岛
ܓܒܐ ܕܒܥܬ	復興黨
ܦܩܪܐ	椎骨切迹
ܒܪ ܩܠܐ	回聲
ܟܝܡܪܐ	喀邁拉
ܠܘܓܡܐ	上颌骨
ܛܪܘܢܐ	獨裁者
ܬܝܒܘܬܐ	和好聖事
ܡܛܘܚܬܐ	示指
ܩܒܠܘܬܐ	接生員
ܐܪܙܝܪܐ	椋鸟科
ܣܦܪܐ (ܩܢܘܢܝܐ)	法学家
Ͱ	Ͱ
ܥܡܐ ܐܪܡܝܐ	阿拉米人
ܟܢܘܢܬܐ (ܫܪܝܬܐ)	腕
ܐܒܐ (ܐܠܗܐ)	聖父
ܐܢܒܐܪ (ܗܘܦܪܟܝܐ)	安巴尔省
ܡܪܕܝܢ (ܡܕܝܢܬܐ)	馬爾丁
ܣܪܛܢܐ	Cancer
ܡܘܪܘܢ	坚振圣事
ܚܠܡܬܐ	乳頭
ܢܘܠܐ ܕܓܘܓܝ	蜘蛛網
ܐܫܥܝܐ	以赛亚
ܒܪܬ ܙܘܓܐ (ܒܝܬܝܘܬܐ)	妻子
ܒܝܬ ܟܬܒܐ ܐܬܪܝܐ ܕܐܣܪܐܝܠ	以色列国家图书馆
ܥܪܫܐ	大臼齿
ܢܝܢܘܐ (ܗܘܦܪܟܝܐ)	尼尼微省
ܢܘܗܕܪܐ (ܗܘܦܪܟܝܐ)	代胡克省
ܘܐܣܛ (ܗܘܦܪܟܝܐ)	瓦西特省
ܨܠܐܚ ܐܠܕܝܢ (ܗܘܦܪܟܝܐ)	萨拉赫丁省
ܟܢܘܫܝܐ ܕܠܫܢܐ ܥܒܪܝܐ	希伯来语科学院
ܥܘܕ	烏德琴
ܒܓܕܐܕ (ܗܘܦܪܟܝܐ)	巴格達省
ܣܪܓܐ	鞍
ܒܨܪܐ (ܨܒܥܐ)	無名指
ܩܛܝܣܦܘܢ	泰西封
ܟܒܘܫܐ	恶梦
ܢܓܦ (ܗܘܦܪܟܝܐ)	納傑夫省
ܟܪܟ ܣܠܘܟ (ܗܘܦܪܟܝܐ)	基爾庫克省
ܕܢܚܐ ܕܫܡܫܐ	日出
ܬܐܪܬܐ	良心
ܒܨܪܐ (ܗܘܦܪܟܝܐ)	巴士拉省
ܡܫܚܐ ܕܟܪܝܗܐ	病人傅油聖事
ܦܠܫܬ	非利士人
ܐܠܥܐ (ܝܘܠܦܢ ܨܪܘܝܘܬܐ)	肋骨
ܥܕܬܐ ܐܝܓܘܦܛܝܬܐ	亞歷山大科普特正教會
ܐܢܛܝܘܟܝܐ	安条克
ܐܦܪܝܡ ܣܘܪܝܝܐ	聖厄弗冷
ܐܝܙܝܕܝܐ	雅兹迪
ܪܝܫܘܢ ܠܬܣܝܘܢ	里雄莱锡安
ܟܢܪܐ	里拉琴
ܥܕܬܐ ܕܡܕܢܚܐ ܕܐܬܘܪܝܐ	東方亞述教會
ܬܠܐ ܕܚܕ ܐܝܠܢ	籃球兄弟
ܡܘܪܐ	沒藥
ܦܕܪܠܝܐ	联邦主义
ܐܠܝܫܥ	以利沙
ܗܟܐܪܝ (ܡܕܝܢܬܐ)	哈卡里
ܣܢܚܪܝܒ	辛那赫里布
ܩܘܪܝܐܠܝܣܘܢ	垂憐經
ܟܢܘܫܝܐ ܕܐܣܪܐܝܠ ܕܝܘܠܦܢܐ ܘܐܢܫܝܬܐ	以色列科學與人文學院
ܣܘܟܢܐ	舵
ܟܣܬܐ	饲料
ܩܡܫܠܝ	卡米什利
ܡܘܬܢܐ (ܗܘܦܪܟܝܐ)	穆薩納省
ܒܪ ܙܘܓܐ (ܒܝܬܝܘܬܐ)	丈夫
ܡܝܫܢ (ܗܘܦܪܟܝܐ)	米桑省
ܣܘܠܝܡܐܢܝܐ (ܗܘܦܪܟܝܐ)	蘇萊曼尼亞省
ܐܪܒܝܠ (ܗܘܦܪܟܝܐ)	埃爾比勒省
ܚܠܒ (ܗܘܦܪܟܝܐ)	阿勒颇省
ܟܪܒܠܐܐ (ܗܘܦܪܟܝܐ)	卡爾巴拉省
ܦܪܨܘܦܐ	個人
ܕܝ ܩܐܪ (ܗܘܦܪܟܝܐ)	濟加爾省
ܐܢܕܪܢܝܩ ܡܐܪܓܐܪܝܐܢ	安德拉尼克·马尔加良
ܡܡܠܠܘܬ ܐܠܗܘܬܐ	基督教神學
ܓܘܙܐ	胡桃科
ܕܝܐܠܐ (ܗܘܦܪܟܝܐ)	迪亞拉省
ܟܒܒ	哈巴布
ܩܪܫܬܐ	天花板
ܚܨܪܐ	小指
ܐܡܬܐ (ܝܘܠܦܢ ܨܪܘܝܘܬܐ)	前臂
ܬܐܘܡܐ	托马斯
ܚܡܬ (ܗܘܦܪܟܝܐ)	哈馬省
ܟܢܘܢܬܐ ܕܐܝܕܐ	腕骨
ܐܝܣܪܐܝܠ (ܬܘܚܡܐ ܐܚܪܢܐ)	以色列 (消歧義)
ܡܠܐܟܐ	天使
ܫܢܬܐ ܦܫܝܛܬܐ	平年
ܡܣܘܪܩܐ ܕܐܝܕܐ	掌骨
ܡܠܟܘܬܐ ܕܒܝܬ ܥܣܪ ܥܝܢܐ	奥斯若恩
ܕܪܥܐ (ܡܕܝܢܬܐ)	德拉
ܨܕܥܐ	顳
ܣܘܣܝܐ ܐܝܣܠܢܕܝܐ	冰島馬
ܩܠܐ	音符
ܛܘܘܝܐ	炙烤
ܓܪܡܐ	骨骼
ܒܪܝܐܢܝ	印度香饭
ܠܒܠܒܬܐ	悬雍垂
و	Waw
ܒܪܬܐ (ܒܝܬܝܘܬܐ)	女兒
ܗܪܗܪܐ	海市蜃楼
ܚܣܟܗ (ܡܕܝܢܬܐ)	哈塞克
ܛܐܪܩ ܥܙܝܙ	塔里克·阿齐兹
ܡܣܘܪܩܐ ܕܪܓܠܐ	跖骨
ܥܪܩ	中东亚力酒
ܛܘܪ ܠܒܢܢ	黎巴嫩山
ܐܙܟ	伊迪爾
ܥܡܐ ܐܬܘܪܝܐ/ܣܘܪܝܝܐ	亚述人
ܛܘܪܐ ܕܣܝܢܝ	西奈山
ܦܘܪܬܥܢܐ	跳蚤
ܫܡܣܕܝܢ	謝姆丁利
ܟܪܘܙܘܬܐ ܕܡܬܝ	馬太福音
ܐܓܪܬܐ ܕܠܘܬ ܐܦܣܝܐ	以弗所書
10000 (ܡܢܝܢܐ)	10000
ܒܢܦܫܐ	雪青色
ܢܨܪܬ	拿撒勒
ܟܬܒܐ ܕܡܘܪܡܘܢ	摩爾門經
ܒܫܐܪܐ ܦܛܪܘܣ ܐܠܪܐܥܝ	貝沙拉·布特羅斯·拉伊
ܥܡܢܘܐܝܠ ܬܠܝܬܝܐ ܕܠܝ	埃馬努埃爾三世·德利
ܥܡܘܕܐ ܦܩܪܝܐ	脊椎
ܒܝܬ ܫܥܝܐ	體育場
ܓܘܕ ܫܪܠܘܛ	狂野夏洛特
ܒܪ ܨܘܪܐ	衣领
ܚܣܚܘܣܐ	软骨
ܐܝܣܛܢܒܘܠ (ܗܘܦܪܟܝܐ)	伊斯坦堡省
ܝܘܢܝܐ	希臘人
ܡܪܝ ܕܢܚܐ ܪܒܝܥܝܐ	登哈四世
ܬܐܓܘܪܬܐ	贸易
ܫܝܪܢܐܟ (ܗܘܦܪܟܝܐ)	舍尔纳克省
ܟܗܢܘܬܐ	聖秩聖事
ܚܒܘܪ	哈布爾河
ܗܕܡܐ ܓܘܝܐ	器官
ܚܡܬܐ (ܒܝܬܝܘܬܐ)	岳母
ܐܘܪܘܦܐ	欧罗巴 (消歧义)
ܡܕܝܕ	米迪亞特
ܥܕܬܐ ܣܘܪܝܝܬܐ ܩܬܘܠܝܩܝܬܐ	敘利亞禮天主教會
ܐܘܣܛܪܠܝܐ	澳大利亚 (消歧义)
ܡܦܩܬܐ ܦܫܝܛܬܐ	別西大譯本
ܐܪܚܘܬܐ	款待
ܫܪܓܐ ܕܢܦܛܐ	油灯
ܚܘܐ	夏娃
ܗܘܦܪܟܝܣ ܕܥܝܪܐܩ	伊拉克行政區劃
ܚܬܢܐ (ܒܝܬܝܘܬܐ)	新郎
ܒܝܬ ܟܬܒܐ ܕܐܫܘܪ ܒܢܐܦܠ	亞述巴尼拔圖書館
ܒܕܘܩܐ	童军
ܥܘܕܪܢܐ:ܚܒܝܫܬ̈ܐ	Help:目录
ܓܦܬܐ	攀緣植物
ܡܝܟܐܝܠ	迈克尔
ܐܝܓܢܐܛܝܘܣ ܙܟܝ ܩܕܡܝܐ ܥܝܘܐܨ	依納爵·扎卡一世·伊瓦斯
ܐܣܛܘܡܟܐ	胃
ܚܡܐ (ܒܝܬܝܘܬܐ)	岳父
ܓܢܬܐ	庭園
ܒܪܐ (ܐܠܗܐ)	聖子
ܐܠܩܘܫ	亞勒辜須
ܘܝܩܝܦܕܝܐ:ܐܝܙܓܕܘܬܐ	Wikipedia:大使館
ܫܠܝܬܐ	胎盤
ܒܝܬ ܛܘܣܐ	機場
ܒܝܬ ܫܡܪܝܐ	撒馬利亞
ܐܓܢܣ ܡܘ	杨诗曼
ܣܕܪܐ:ܓܪܡܢ	Category:德国
ܣܕܪܐ:ܐܝܛܠܝܐ	Category:意大利
ܣܕܪܐ:ܐܬܪܘܬܐ ܡܚܝܕܐ ܕܐܡܪܝܩܐ	Category:美国
ܣܕܪܐ:ܪܘܣܝܐ	Category:俄罗斯
ܣܕܪܐ:ܩܢܕܐ	Category:加拿大
ܣܕܪܐ:ܐܝܣܪܐܝܠ	Category:以色列
ܣܕܪܐ:ܛܘܪܩܝܐ	Category:土耳其
ܣܕܪܐ:ܡܨܪܝܢ	Category:埃及
ܣܕܪܐ:ܐܝܪܐܢ	Category:伊朗
ܥܐܕܐ	假日
ܣܕܪܐ:ܥܝܪܐܩ	Category:伊拉克
ܣܕܪܐ:ܗܘܠܢܕܐ	Category:荷兰
ܣܕܪܐ:ܦܘܠܢܕ	Category:波蘭
ܣܕܪܐ:ܛܝܪܐ	Category:鸟类
ܣܕܪܐ:ܝܥܝܬܐ	Category:植物
ܣܕܪܐ:ܬܘܕܝܬܐ	Category:宗教
ܣܕܪܐ:ܝܕܥܬܐ	Category:科学
ܩܘܠ ܬܘܪܗ	科尔托拉
ܓܪܫܘܢܝ	加许尼文
ܨܘܒܐ	努賽賓
ܕܪܥܐ (ܗܘܦܪܟܝܐ)	德拉省
ܣܕܪܐ ܕܦܛܪܝܪܟܐ ܕܥܕܬܐ ܕܡܕܢܚܐ	東方亞述教會牧首列表
ܩܠܒܐ:Box-footer	Template:Box-footer
ܡܪܝܡ (ܚܬܗ ܕܡܘܫܐ)	米利暗
ܣܕܪܐ:ܬܘܚܡܐ ܐܚܪܢܐ	Category:消歧义
ܣܕܪܐ:ܡܫܝܚܝܘܬܐ	Category:基督教
ܣܕܪܐ:ܐܣܠܐܡ	Category:伊斯兰教
ܣܕܪܐ:ܝܗܘܕܝܘܬܐ	Category:犹太教
ܙܚܘܪܝܬܐ (ܓܘܢܐ)	猩紅色
ܐܢܩܪܐ (ܗܘܦܪܟܝܐ)	安卡拉省
ܐܝܪܠܢܕ	愛爾蘭 (消歧義)
ܝܘܢܢ	約拿
ܐܨܪܐ	调味料
ܕܝܪܝܟ	馬利基耶
ܫܘܫܡܬܐ	芝麻
ܣܕܪܐ:ܘܝܩܝܦܕܝܐ	Category:分類
ܣܕܪܐ:ܝܒܫܬܐ	Category:大洲
ܝܙܦܬܐ	债务
ܦܨܝܕܐ	池塘
ܐܪܓܘܢܐ	紫色
ܢܘܪܢܝܐ	棱锥
ܘܝܩܝܦܕܝܐ:HotCat	Wikipedia:维基百科工具/HotCat
ܒܛܐ	鸭
ܗܝܟܠܐ ܕܫܠܝܡܘܢ	耶路撒冷聖殿
ܩܠܒܐ:ܓܕܫܐ ܗܫܝܐ	Template:Itn
ܣܕܪܐ:ܡܟܬܒܢܘܬܐ ܕܐܬܪܘܬܐ	Category:国家
ܘܝܩܝܦܕܝܐ:ܡܕܒܪܢܐ	Wikipedia:管理员
ܣܕܪܐ:ܫܕܬܐ	Category:職業
ܘܝܩܝܦܕܝܐ:ܒܘܬ̈ܐ	Wikipedia:机器人
ܣܕܪܐ:ܙܒܢܐ	Category:时间
ܣܕܪܐ:ܙܘܙܐ	Category:货币
ܣܕܪܐ:ܝܘܠܦܢ ܨܪܘܝܘܬܐ	Category:解剖学
ܣܕܪܐ:ܐܣܝܘܬܐ	Category:医学
ܡܨܪܝܢ	埃及
ܩܠܒܐ:Bot	Template:Bot
ܩܢܕܐ	加拿大
ܣܕܪܐ:ܝܘܢ	Category:希腊
ܣܕܪܐ:ܣܘܝܕ	Category:瑞典
ܩܠܒܐ:ܐܫܛܪܘܬܐ	Template:Documentation
ܣܕܪܐ:User languages	Category:用户语言
ܦܘܠܚܢܐ	企业
ܩܠܒܐ:Softredirect	Template:軟重定向
ܩܠܒܐ:Delete	Template:Delete
ܡܓܕܠܐ (ܩܪܝܬܐ)	马格达拉
ܣܕܪܐ:ܛܟܢܘܠܘܓܝܐ	Category:技术
ܣܕܪܐ:ܠܫܢܐ	Category:语言
ܣܕܪܐ:ܩܢܘܢܐ ܕܠܥܙܐ	Category:语法
ܘܝܩܝܦܕܝܐ:General disclaimer	Wikipedia:免责声明
ܣܕܪܐ:Noindexed pages	Category:不可索引页面
ܘܝܩܝܦܕܝܐ:ܕܘܒܪܐ	Wikipedia:格式手册
ܩܠܒܐ:Navbox	Template:Navbox
ܐܝܓܢܐܛܝܘܣ ܐܦܪܝܡ ܬܪܝܢܐ	依納爵·阿弗雷姆二世·卡里姆
ܣܕܪܐ:ܩܠܒܐ ܐܬܘܬܐ ܕܐܝܣܘ	Category:旗帜模板
ܩܠܒܐ:ܡܦܐܬܐ ܩܠܒܐ	Template:Navbar
ܩܠܒܐ:Clear	Template:Clear
ܘܝܩܝܦܕܝܐ:ܡܟܬܒܘܬܐ ܕܡܓܠܐ ܠܟܠ ܘܝܩܝܦܕܝܐ	Wikipedia:基礎條目
ܣܕܪܐ:ܐܠܝܩܛܪܘܢܝܘܬܐ	Category:電子學
ܣܕܪܐ:ܝܪܚܐ ܕܫܢܬܐ	Category:月份
ܩܠܒܐ:Babel	Template:Babel
ܩܠܒܐ:Commons	Template:Commons
ܩܠܒܐ:Reflist	Template:Reflist
ܩܠܒܐ:User ar-1	Template:User ar-1
ܩܠܒܐ:User az	Template:User az
ܩܠܒܐ:See also	Template:See also
ܩܠܒܐ:User de	Template:User de
ܩܠܒܐ:User es	Template:User es
ܩܠܒܐ:User en-3	Template:User en-3
ܩܠܒܐ:User en-1	Template:User en-1
ܩܠܒܐ:User en-2	Template:User en-2
ܩܠܒܐ:User en-4	Template:User en-4
ܩܠܒܐ:User en-0	Template:User en-0
ܩܠܒܐ:User en	Template:User en
ܩܠܒܐ:User fa	Template:User fa
ܩܠܒܐ:User fr-1	Template:User fr-1
ܩܠܒܐ:User he-2	Template:User he-2
ܩܠܒܐ:User he-1	Template:User he-1
ܩܠܒܐ:User sk	Template:User sk
ܩܠܒܐ:User tr	Template:User tr
ܩܠܒܐ:User ja	Template:User ja
ܩܠܒܐ:User fr	Template:User fr
ܩܠܒܐ:User he	Template:User he
ܣܕܪܐ:ܐܣܝܐ	Category:亚洲
ܣܕܪܐ:ܕܪܐ ܕܥܣܪܝܢ ܘܚܕ	Category:21世纪
ܩܠܒܐ:Mod	Template:Mod
ܩܠܒܐ:User sv	Template:User sv
ܩܠܒܐ:Infobox language/codelist	Template:SIL
ܩܠܒܐ:User it	Template:User it
ܣܕܪܐ:ܝܘܡܐ ܕܫܒܘܥܐ	Category:星期中的日子
ܣܕܪܐ:ܐܨܪܐ	Category:調味料
ܩܠܒܐ:ܝܗܘܝܬܐ Peru	Template:Country data Peru
ܩܠܒܐ:ܝܗܘܝܬܐ Paraguay	Template:Country data Paraguay
ܩܠܒܐ:Edit	Template:Edit
ܩܠܒܐ:ܝܗܘܝܬܐ French Guiana	Template:Country data Guyana
ܩܠܒܐ:ܝܗܘܝܬܐ Argentina	Template:Country data Argentina
ܩܠܒܐ:Navbox suite	Template:Navbox suite
ܩܠܒܐ:Category other	Template:Category other
ܩܠܒܐ:ܡܟܬܒܢܘܬܐ ܕܝܦܬܐ	Template:Collapsible list
ܩܠܒܐ:Sidebar	Template:Sidebar
ܩܠܒܐ:Ambox	Template:Ambox
ܩܠܒܐ:Navigation templates	Template:Navigational templates
ܩܠܒܐ:ܐܬܪܐ	Template:國家基礎資訊
ܩܠܒܐ:/box-header	Template:Box-header
ܣܕܪܐ:User en	Category:En 使用者
ܣܕܪܐ:User zh	Category:Zh 使用者
ܣܕܪܐ:User zh-N	Category:Zh 母语使用者
ܩܠܒܐ:ܨܢܕܘܩ ܪܡܙܐ2	Template:Infobox
ܩܠܒܐ:User zh	Template:User zh
ܩܠܒܐ:ܐܫܛܪܘܬܐ/ܨܢܕܘܩ ܫܪܝܬܐ	Template:Documentation/start box
ܩܠܒܐ:Documentation/end box2	Template:Documentation/end box2
ܩܠܒܐ:Documentation/start box2	Template:Documentation/start box2
ܩܠܒܐ:ܩܠܒܐ ܐܚܪܝܢܐ	Template:Template other
ܩܠܒܐ:ܐܠܦܒܝܬ ܠܐܛܝܢܝܐ	Template:Infobox Latin common
ܣܕܪܐ:ܦܐܦܐ	Category:教宗
ܩܠܒܐ:Pp-template	Template:Pp-template
ܩܠܒܐ:User nl-1	Template:User nl-1
ܩܠܒܐ:User nl-2	Template:User nl-2
ܣܕܪܐ:ܪܝܫܝ ܩܘܛܢܝܘܬܐ	Category:总统
ܩܠܒܐ:User ru	Template:User ru
ܩܠܒܐ:IPA	Template:IPA
ܣܕܪܐ:ܗܪܘܡܐ	Category:香料
ܣܕܪܐ:ܦܠܫܬ	Category:巴勒斯坦
ܣܕܪܐ:ܡܠܐܟܐ	Category:天使
ܣܕܪܐ:ܢܒܝܐ	Category:先知
ܩܠܒܐ:Rellink	Template:Rellink
ܩܠܒܐ:Category redirect	Template:分类重定向
ܩܠܒܐ:ܝܗܘܝܬܐ Venezuela	Template:Country data Venezuela
ܩܠܒܐ:ܨܢܕܘܩ ܡܕܒܪܢܐ	Template:Infobox Officeholder
ܩܠܒܐ:Sortname	Template:Sortname
ܩܠܒܐ:Border	Template:Border
ܩܠܒܐ:ܡܢܝܢܐ ܕܝܪܚܐ	Template:MONTHNUMBER
ܩܠܒܐ:ܪܕ	Template:Fmbox
ܩܠܒܐ:ܝܗܘܝܬܐ Chile	Template:Country data Chile
ܩܠܒܐ:GUA	Template:GTM
ܩܠܒܐ:User nl	Template:User nl
ܩܠܒܐ:Navbox years	Template:NavboxYears
ܩܠܒܐ:ܡܣܦܩ ܩܐܫ	Template:Purge
ܩܠܒܐ:ܨܢܕܘܩ ܐܡܢܐ	Template:Infobox Artist
ܩܠܒܐ:ܡܦܠܚܢܐ	Template:User
ܣܕܪܐ:ܬܘܢܣ	Category:突尼西亞
ܩܠܒܐ:Sec link auto	Template:Sec link auto
ܩܠܒܐ:Cmbox	Template:Cmbox
ܩܠܒܐ:Mbox	Template:Mbox
ܩܠܒܐ:Oppose	Template:Oppose
ܩܠܒܐ:COL	Template:COL
ܩܠܒܐ:PER	Template:PER
ܩܠܒܐ:ܨܢܕܘܩ ܡܕܥܐ ܕܝܒܫܬܐ	Template:Infobox Continent
ܩܠܒܐ:User ar-2	Template:User ar-2
ܩܠܒܐ:User ar-3	Template:User ar-3
ܩܠܒܐ:User ar	Template:User ar
ܩܠܒܐ:ܝܘܡܐ ܕܫܒܘܥܐ	Template:星期中的日子
ܣܕܪܐ:ܡܕܝܢܬܐ ܒܐܘܚܕܢܐ ܡܚܝܕܐ	Category:美國城市
ܩܠܒܐ:ܬ.ܐ.	Template:Disambig
ܩܠܒܐ:No	Template:未完成
ܣܕܪܐ:ܩܠܒܐ ܨܢܕܘܩܐ	Category:信息框模板
ܩܠܒܐ:Partial	Template:Partial
ܩܠܒܐ:ܩܘܕܝܟܘܣ ܕܣܕܪܐ	Template:CategoryTOC
ܩܠܒܐ:?	Template:?
ܩܠܒܐ:ܝܗܘܝܬܐ Colombia	Template:Country data Colombia
ܣܕܪܐ:User yue	Category:Zh-yue 使用者
ܣܕܪܐ:User az	Category:Az 使用者
ܣܕܪܐ:User sk	Category:Sk 使用者
ܣܕܪܐ:User fr	Category:Fr 使用者
ܣܕܪܐ:User ja	Category:Ja 使用者
ܣܕܪܐ:User la	Category:La 使用者
ܣܕܪܐ:User pt	Category:Pt 使用者
ܣܕܪܐ:User ro	Category:Ro 使用者
ܣܕܪܐ:User sv	Category:Sv 使用者
ܣܕܪܐ:User ko-N	Category:Ko 母語使用者
ܩܠܒܐ:User yue	Template:User zh-yue
ܩܠܒܐ:Cat main	Template:Catmore
ܣܕܪܐ:User ar	Category:Ar 使用者
ܣܕܪܐ:User arc	Category:Arc 使用者
ܣܕܪܐ:User da	Category:Da 使用者
ܣܕܪܐ:User sk-N	Category:Sk 母語使用者
ܣܕܪܐ:User de	Category:De 使用者
ܣܕܪܐ:User el	Category:El 使用者
ܣܕܪܐ:User en-N	Category:En 母语使用者
ܣܕܪܐ:User es	Category:Es 使用者
ܣܕܪܐ:User fa	Category:Fa 使用者
ܣܕܪܐ:User fi	Category:Fi 使用者
ܣܕܪܐ:User he	Category:He 使用者
ܩܠܒܐ:N/a	Template:N/A
ܣܕܪܐ:User hy	Category:Hy 使用者
ܣܕܪܐ:ܠܫܢܐ ܥܒܪܝܐ	Category:希伯來語
ܣܕܪܐ:ܡܕܝܢܬܐ ܒܐܝܣܪܐܝܠ	Category:以色列城市
ܣܕܪܐ:User it	Category:It 使用者
ܣܕܪܐ:User ko	Category:Ko 使用者
ܣܕܪܐ:ܒܬܫܪܝܢ ܐܚܪܝ	Category:11月
ܣܕܪܐ:ܝܡܡܐ	Category:海洋
ܩܠܒܐ:ܐܠܦܒܝܬ ܝܘܢܝܐ	Template:Greek alphabet sidebar
ܩܠܒܐ:No2	Template:No2
ܩܠܒܐ:Rh	Template:Rh
ܩܠܒܐ:ܡܢܝܢܐ ܕܡܡܪܐ ܦܪܝܫܐ	Template:FA number
ܩܠܒܐ:ܣܡܘܩܐ	Template:紅
ܣܕܪܐ:ܒܝܬܝܘܬܐ	Category:家世與傳承
ܩܠܒܐ:ܝܗܘܝܬܐ Brazil	Template:Country data Brazil
ܩܠܒܐ:Yes2	Template:Yes2
ܬܪܥܐ:ܬܘܕܝܬܐ	Portal:宗教
ܣܕܪܐ:ܪܝܫܝ ܩܘܛܢܝܘܬܐ ܥܠ ܐܬܪܐ	Category:各国总统
ܣܕܪܐ:User ru	Category:Ru 使用者
ܣܕܪܐ:User ru-3	Category:Ru-3 使用者
ܣܕܪܐ:User templates en	Category:英语巴别模板
ܣܕܪܐ:User tl	Category:Tl 使用者
ܣܕܪܐ:User tr	Category:Tr 使用者
ܣܕܪܐ:ܙܡܪܐ	Category:音乐家
ܩܠܒܐ:Lang	Template:Lang
ܣܕܪܐ:ܪܫܘܡܐ	Category:画家
ܩܠܒܐ:ܫܠܝܚܐ ܕܡܫܝܚܐ	Template:耶稣的十二使徒
ܩܠܒܐ:ܟܬܒܐ ܩܕܝܫܐ	Template:聖經相關
ܩܠܒܐ:Busy/Doc	Template:Busy
ܣܕܪܐ:ܐܡܢܐ ܥܠ ܐܕܫܐ	Category:各種職業
ܩܠܒܐ:CHI	Template:CHL
ܣܕܪܐ:ܡܕܝܢܬܐ ܒܐܢܓܠܢܕ	Category:英格蘭各郡聚居地
ܩܠܒܐ:Cat handler/numbered	Template:Category handler/numbered
ܣܕܪܐ:ܢܝܓܪ	Category:尼日
ܩܠܒܐ:Chinese calendar/cycle	Template:Chinese calendar/cycle
ܩܠܒܐ:Infobox language/family-color	Template:Infobox Language/family-color
ܩܠܒܐ:User ar-0	Template:User ar-0
ܣܕܪܐ:ܣܥܪܐ	Category:髮型
ܩܠܒܐ:User ar-4	Template:User ar-4
ܣܕܪܐ:ܢܗܪܘܬܐ	Category:河流
ܩܠܒܐ:User he-0	Template:User he-0
ܩܠܒܐ:User he-3	Template:User he-3
ܩܠܒܐ:User he-4	Template:User he-4
ܩܠܒܐ:User ko	Template:User ko
ܩܠܒܐ:User pt	Template:User pt
ܣܕܪܐ:User nl	Category:Nl 使用者
ܣܕܪܐ:User no	Category:No 使用者
ܣܕܪܐ:ܣܘܪܝܐ	Category:敘利亞
ܣܕܪܐ:ܕܪܐ ܩܕܡܝܐ	Category:1世纪
ܣܕܪܐ:ܓܙܪܬܐ ܝܒܫܢܝܬܐ	Category:半岛
ܣܕܪܐ:ܗܘܦܪܟܝܣ ܕܗܘܠܢܕܐ	Category:荷兰省份
ܣܕܪܐ:ܡܢܝܢܐ	Category:整数
ܣܕܪܐ:ܡܕܝܢܬܐ ܕܥܝܪܐܩ	Category:伊拉克城市
ܣܕܪܐ:ܥܝܢܐ (ܨܪܘܝܘܬܐ)	Category:眼睛
ܣܕܪܐ:ܓܘܪܓܝܐ	Category:喬治亞
ܣܕܪܐ:ܟܘܘܝܬ	Category:科威特
ܣܕܪܐ:ܠܒܢܢ	Category:黎巴嫩
ܣܕܪܐ:ܪܝܫܝ ܩܘܛܢܝܘܬܐ ܕܐܬܪܘܬܐ ܡܚܝܕܐ ܕܐܡܪܝܩܐ	Category:美国总统
ܣܕܪܐ:ܝܘܪܕܢܢ	Category:约旦
ܣܕܪܐ:ܦܐܪܐ	Category:水果
ܣܕܪܐ:ܝܘܠܦܢ ܟܘܪܗܢܐ	Category:病理学
ܣܕܪܐ:ܓܒܐ	Category:政党
ܣܕܪܐ:ܕܝܬܝܩܝ ܚܕܬܐ	Category:新约圣经
ܣܕܪܐ:ܕܝܬܝܩܝ ܥܬܝܩܬܐ	Category:旧约圣经
ܣܕܪܐ:ܐܘܩܝܢܘ	Category:远洋
ܣܕܪܐ:ܓܪܡܐ	Category:骨骼
ܣܕܪܐ:ܗܘܦܪܟܝܣ ܘܐܘܚܕܢܐ ܕܩܢܕܐ	Category:加拿大一級行政區
ܣܕܪܐ:ܚܝܘܬܐ	Category:动物
ܣܕܪܐ:ܛܘܪܐ	Category:山脉
ܣܕܪܐ:ܣܘܥܪܢܐ	Category:事件
ܣܕܪܐ:ܟܘܪܗܢܐ	Category:疾病
ܣܕܪܐ:User pl	Category:Pl 使用者
ܣܕܪܐ:ܩܣܪ	Category:皇帝
ܣܕܪܐ:ܡܕܒܪܐ	Category:沙漠
ܣܕܪܐ:ܝܡܡܬܐ	Category:湖泊
ܩܠܒܐ:ܨܢܕܘܩ ܡܚܡܝܬܐ ܡܨܥܝܐ	Template:Infobox media
ܩܠܒܐ:ܨܢܕܘܩ ܪܡܙܐ ܕܠܫܢܐ	Template:Infobox Language
ܣܕܪܐ:ܩܛܠܥܡܐ	Category:屠殺
ܨܝܢ	中國 (消歧義)
ܣܕܪܐ:ܠܫܢܐ ܘܠܥܙܐ ܨܝܢܝܐ	Category:汉语方言
ܛܪܘܝܐܢܝ	特洛疆尼
ܩܠܒܐ:Sister	Template:Sister
ܣܕܪܐ:ܢܒܝܐ ܕܕܝܬܝܩܝ ܥܬܝܩܬܐ	Category:希伯来圣经先知
ܣܕܪܐ:ܦܛܪܝܪܟܘ ܕܥܕܬܐ ܕܡܕܢܚܐ ܕܐܬܘܪܝܐ	Category:東方亞述教會牧首
ܩܠܒܐ:ܝܗܘܝܬܐ Falkland Islands	Template:Country data Falkland Islands
ܣܕܪܐ:ܦܛܪܝܪܟܘ	Category:牧首
ܣܕܪܐ:ܒܝܬ ܟܬܒܐ	Category:圖書館
ܣܕܪܐ:ܫܢܬܐ ܥܕܬܢܝܬܐ	Category:教會年曆
ܣܕܪܐ:ܐܪܙܐ	Category:聖事
ܣܕܪܐ:ܒܝܬ ܢܗܪܝܢ	Category:两河流域
ܣܕܪܐ:ܓܘܢܐ	Category:颜色
ܩܠܒܐ:ܝܗܘܝܬܐ South Georgia and the South Sandwich Islands	Template:Country data South Georgia and the South Sandwich Islands
ܣܕܪܐ:ܦܣܩܐ ܕܝܘܡܐ	Category:一天裡的時刻
ܣܕܪܐ:ܩܠܒܐ	Category:按功能分类的模板
ܕܒܘܪܐ (ܪܚܫܐ)	黄蜂
ܩܠܒܐ:ܣܘܪܓܕܐ ܚܘܫܒܢܐ	Template:Year in other calendars
ܣܕܪܐ:ܩܕܝܫܐ	Category:聖人
ܩܪܕܐ (ܪܚܫܐ)	蜱
ܩܠܒܐ:ܣܝܩܘܡ ܫܘܪܝܐ	Template:Start date
ܩܠܒܐ:User nl-4	Template:User nl-4
ܩܠܒܐ:User nl-3	Template:User nl-3
ܩܠܒܐ:Tim	Template:Tim
ܩܠܒܐ:ܠܫܢܐ ܨܝܢܝܐ	Template:汉语
ܩܠܒܐ:P1	Template:P1
ܢܘܓܗܐ	拂晓
ܩܠܒܐ:Documentation/core2	Template:Documentation/core2
ܘܝܩܝܦܕܝܐ:NavFrame	Help:摺疊顯示
ܩܠܒܐ:Infobox language/genetic	Template:Infobox language/genetic
ܩܠܒܐ:Chinese calendar/year/78	Template:Chinese calendar/year/78
ܕܝܠܢܝܐ:ܫܘܚܠܦ̈ܐ ܚܕ̈ܬܐ	Special:最近更改
ܩܠܒܐ:Chinese calendar/month/78/27	Template:Chinese calendar/month/78/27
ܩܠܒܐ:Documentation/core	Template:Documentation/core
