Afrika	非洲
Ġappun	日本
Norveġja	挪威
Ingilterra	英格兰
Skozja	蘇格蘭
Irlanda ta' Fuq	北爱尔兰
Repubblika tal-Irlanda	爱尔兰共和国
Ungerija	匈牙利
Spanja	西班牙
Stati Uniti	美国
Belġju	比利时
Lussemburgu	卢森堡
Art	地球
Mewt	死亡
Bniedem	人
Tim Berners-Lee	蒂姆·伯纳斯-李
Finlandja	芬兰
Żvezja	瑞典
Danimarka	丹麦
Polonja	波兰
Litwanja	立陶宛
Italja	意大利
Żvizzera	瑞士
Awstrija	奥地利
Greċja	希腊
Turkija	土耳其
Portugall	葡萄牙
Ewropa	欧洲
Asja	亚洲
Wikipedija	维基百科
Pajjiżi l-Baxxi	荷兰
Berlin	柏林
Kompjuter	電子計算機
Barack Obama	贝拉克·奥巴马
Urugwaj	乌拉圭
Londra	伦敦
Messiku	墨西哥
Oċean Atlantiku	大西洋
Oċean Paċifiku	太平洋
Jannar	1月
Frar	2月
Marzu	3月
Marte (pjaneta)	火星
Kenja	肯尼亚
Etjopja	埃塞俄比亚
Gana	加纳
April	4月
Mejju	5月
Ġunju	6月
Lulju	7月
Awwissu	8月
Settembru	9月
Ottubru	10月
Novembru	11月
Diċembru	12月
Iljun	狮
Franza	法国
Kelb	犬
Renju Unit	英国
Qattus	猫
Ċina	中华人民共和国
Wikizzjunarju	维基词典
Brażil	巴西
François Hollande	弗朗索瓦·奥朗德
Russja	俄罗斯
Wiki	Wiki
Fondazzjoni Wikimedia	维基媒体基金会
Jimmy Wales	吉米·威爾斯
Ġermanja	德国
Bjelorussja	白俄罗斯
Il Canto degli italiani	意大利人之歌
Iżlanda	冰岛
Estonja	爱沙尼亚
Saturnu (pjaneta)	土星
Latvja	拉脫維亞
Ukraina	乌克兰
Ċekja	捷克
Slovakkja	斯洛伐克
Slovenja	斯洛文尼亚
Vilnius	维尔纽斯
Moldova	摩尔多瓦
Rumanija	羅馬尼亞
Bulgarija	保加利亚
Ruma	罗马
Repubblika tal-Maċedonja	馬其頓共和國
Albanija	阿尔巴尼亚
Kroazja	克罗地亚
Bożnija u Ħerżegovina	波斯尼亚和黑塞哥维那
Ażerbajġan	阿塞拜疆
Andorra	安道尔
Ċipru	賽普勒斯
Ġeorġja	格鲁吉亚
Każakistan	哈萨克斯坦
Malta	马耳他
Monako	摩纳哥
Montenegro	蒙特內哥羅
Belt tal-Vatikan	梵蒂冈
San Marino	圣马力诺
Brussell	布鲁塞尔
Kuba	古巴
Beliże	伯利兹
Torri Eiffel	艾菲爾鐵塔
Barbados	巴巴多斯
Volkswagen	大众汽车
Indoneżja	印度尼西亚
Wolfgang Amadeus Mozart	沃尔夫冈·阿马德乌斯·莫扎特
Ludwig van Beethoven	路德维希·范·贝多芬
Afrika t'Isfel	南非
Alġerija	阿尔及利亚
Wikisors	维基文库
Varsavja	华沙
Festival tal-Eurovision	歐洲歌唱大賽
Injam	木材
Pornografija	色情
Ċili	智利
Ġesù	耶稣
Galileo Galilei	伽利略·伽利莱
Merkurju (pjaneta)	水星
Storja	历史
Venere (pjaneta)	金星
Imħabba	愛
Ġove (pjaneta)	木星
Triq ta' Sant'Anna	银河系
Uranu (pjaneta)	天王星
Nettunu (pjaneta)	海王星
Astronomija	天文學
Singapor	新加坡
Xjenza	科学
Liechtenstein	列支敦斯登
Sport	体育运动
Adolf Hitler	阿道夫·希特勒
Facebook	Facebook
L-Ewwel Gwerra Dinjija	第一次世界大战
It-Tieni Gwerra Dinjija	第二次世界大战
Wikotba	維基教科書
Wikikwota	维基语录
Wikiversità	维基学院
Skopje	斯科普里
Szczecin	什切青
Matematika	数学
Lingwa Latina	拉丁语
Baħrejn	巴林
Armenja	亞美尼亞
Serbja	塞尔维亚
Qamar	月球
Awstralja	澳大利亚
Arġentina	阿根廷
Perù	秘鲁
Bijoloġija	生物学
Kambodja	柬埔寨
Faxxa ta' Kuiper	柯伊伯带
Koran	古兰经
Dinosawru	恐龙
Iżlam	伊斯兰教
Ljubljana	卢布尔雅那
Unjoni Ewropea	欧洲联盟
Plovdiv	普罗夫迪夫
Mara	女性
Poeżija	诗歌
Lumija	柠檬
Émile Zola	埃米尔·左拉
Napuljun I ta' Franza	拿破仑一世
Vesuvju	維蘇威火山
Xemx	太阳
Sena dawl	光年
Oċeanja	大洋洲
Sistema Solari	太阳系
Idroġenu	氢
Wikimedia Commons	维基共享资源
Lejl	晚上
Oslo	奥斯陆
Katowice	卡托维兹
Toqba sewda	黑洞
Lionel Messi	利昂内尔·梅西
Karbonju	碳
Ażotu	氮
Ossiġenu	氧
Inter Milan	国际米兰足球俱乐部
Pjaneta	行星
Kleopatra VII	克娄巴特拉七世
Mużika	音乐
Moska	莫斯科
Lingwa Taljana	意大利语
Ċad	乍得
New Zealand	新西兰
Indja	印度
Tuvalu	圖瓦盧
Ħadid	铁
Tonga	東加
Samoa	萨摩亚
Gżejjer Solomon	所罗门群岛
Vanwatu	瓦努阿图
Molière	莫里哀
Papwa Gwinea l-Ġdida	巴布亚新几内亚
William Shakespeare	威廉·莎士比亚
Nawru	諾魯
Kiribati	基里巴斯
Fiġi	斐濟
Veneżwela	委內瑞拉
Genghis Khan	成吉思汗
Żiemel	马
Annimal	动物
Surinam	蘇利南
Paragwaj	巴拉圭
Gujana	圭亚那
Arti	艺术
Ekwador	厄瓜多尔
Kolombja	哥伦比亚
Buddiżmu	佛教
Bolivja	玻利維亞
Trinidad u Tobago	千里達及托巴哥
Saint Vincent u l-Grenadini	圣文森特和格林纳丁斯
Santa Luċija	圣卢西亚
Leonardo da Vinci	列奥纳多·达·芬奇
Saint Kitts u Nevis	聖克里斯多福與尼維斯
Ġamajka	牙买加
Grenada	格林纳达
Gwatemala	危地马拉
Baħamas	巴哈马
Antigwa u Barbuda	安提瓜和巴布达
Ħonduras	洪都拉斯
Dominika	多米尼克
Repubblika Dominikana	多明尼加
Ħaiti	海地
El Salvador	萨尔瓦多
Iran	伊朗
Iraq	伊拉克
Kosta Rika	哥斯达黎加
Iżrael	以色列
Panama	巴拿马
Jemen	也门
Lingwa pollakka	波兰语
Ġordan	约旦
Nikaragwa	尼加拉瓜
Libanu	黎巴嫩
Maldive	马尔代夫
Malażja	马来西亚
Burma	缅甸
Pakistan	巴基斯坦
Qatar	卡塔尔
Arabja Sawdija	沙特阿拉伯
Sri Lanka	斯里蘭卡
Josif Stalin	斯大林
YouTube	YouTube
Aristotli	亚里士多德
Emirati Għarab Magħquda	阿拉伯联合酋长国
Vjetnam	越南
Korea t'Isfel	大韩民国
Afganistan	阿富汗
Bangladexx	孟加拉国
Mali	马里共和国
Angola	安哥拉
Butan	不丹
Brunej	文莱
Tanżanija	坦桑尼亚
Repubblika Ċentru-Afrikana	中非共和國
Isaac Newton	艾萨克·牛顿
Isfar	黄色
Mekkanika kwantistika	量子力学
Togo	多哥
Tuneżija	突尼西亞
Żambja	赞比亚
Żimbabwe	辛巴威
Sudan t'Isfel	南蘇丹
Benin	贝宁
Botswana	波札那
Wikiħbarijiet	维基新闻
Burkina Faso	布吉納法索
Burundi	蒲隆地
Komoros	葛摩
Repubblika tal-Kongo	刚果共和国
Repubblika Demokratika tal-Kongo	刚果民主共和国
Ġibuti	吉布提
Bavarja	巴伐利亚
Ginea Ekwatorjali	赤道几内亚
Eritrea	厄立特里亚
Papa Ġwanni Pawlu II	若望·保祿二世
Gabon	加蓬
Mahatma Gandhi	圣雄甘地
Gambja	冈比亚
Ginea	几内亚
Ginea Bissaw	幾內亞比索
Kosta tal-Avorju	科特迪瓦
Kamerun	喀麦隆
Kap Verde	佛得角
Lesoto	莱索托
Liberja	利比里亚
Libja	利比亚
Madagaskar	马达加斯加
Malawi	马拉维
Mawritanja	毛里塔尼亚
Mawrizju	毛里求斯
Marokk	摩洛哥
Możambik	莫桑比克
Namibja	纳米比亚
Niġer	尼日尔
Niġerja	奈及利亞
Charles Darwin	查尔斯·达尔文
Uganda	乌干达
Rwanda	卢旺达
São Tomé u Príncipe	圣多美和普林西比
Senegal	塞内加尔
Seychelles	塞舌尔
Sierra Leone	塞拉利昂
Somalja	索马里
Sudan	苏丹共和国
Sważiland	斯威士兰
Amburgu	汉堡
Evoluzzjoni	演化
Ġnus Magħquda	联合国
Dante Alighieri	但丁·阿利吉耶里
Ġeografija	地理学
Qalb	心臟
Praga	布拉格
Ikħal	藍色
Limburgu (Belġju)	林堡省 (比利时)
Fjandri tal-Punent	西佛兰德省
Fjandri tal-Lvant	东佛兰德省
Antwerp (provinċja)	安特衛普省
Brabant Fjamming	弗拉芒-布拉班特省
Merkurju (mitoloġija)	墨丘利
Hector Berlioz	埃克托·柏辽兹
Giorgio Napolitano	乔治·纳波利塔诺
Francesco Cossiga	弗朗切斯科·科西加
Oċean Indjan	印度洋
Kosovo	科索沃
Frédéric Chopin	弗雷德里克·肖邦
Kategorija:Prinċipali	Category:頁面分類
Dortmund	多特蒙德
The Beatles	披頭四樂隊
Osama Bin Laden	奥萨马·本·拉登
Lingwa Spanjola	西班牙语
Montevideo	蒙得维的亚
Johann Sebastian Bach	约翰·塞巴斯蒂安·巴赫
Brimba	蜘蛛
Virġilju	维吉尔
Uetersen	于特森
Karozza	汽车
Żagreb	萨格勒布
Sqallija	西西里岛
Maurits Cornelis Escher	莫里茨·科内利斯·埃舍尔
Buenos Aires	布宜諾斯艾利斯
Belt tal-Messiku	墨西哥城
Tokjo	東京都
Barċellona	巴塞罗那
Ateni	雅典
AC Milan	AC米兰
Ħavana	哈瓦那
Édith Piaf	艾迪特·皮雅芙
Kopenħagen	哥本哈根
Stokkolma	斯德哥尔摩
Ħelsinki	赫尔辛基
Dublin	都柏林
Rejkjavik	雷克雅維克
Tallinn	塔林
Riga	里加
Bratislava	布拉迪斯拉发
Gdańsk	格但斯克
Lussemburgu (belt)	盧森堡市
Bibbja	聖經
Ho Chi Minh (belt)	胡志明市
Knisja Vera ta' Ġesù	真耶稣教会
Dong Hoi	同海市
Concepción (Ċili)	康塞普西翁 (智利)
Atalanta BC	亞特蘭大足球俱樂部
Bolonja	博洛尼亚
Bologna FC 1909	博洛尼亚足球俱乐部
Cagliari	卡利亚里
Kiev	基輔
Cagliari Calcio	卡利亚里足球俱乐部
Karim Benzema	卡里姆·本泽马
Patrice Evra	帕特里斯·埃夫拉
Końskowola	孔斯科沃拉
2014	2014年
2015	2015年
2007	2007年
ACF Fiorentina	佛罗伦萨足球俱乐部
Serp	蛇
1 ta' Jannar	1月1日
2 ta' Jannar	1月2日
Rivoluzzjoni Industrijali	工业革命
Imperu Ruman	羅馬帝國
Minsk	明斯克
Microsoft	微软
8 ta' Diċembru	12月8日
Kurów	库鲁夫
Kimika	化學
19 ta' Marzu	3月19日
Papa Benedittu XVI	本篤十六世
Papa Piju XII	庇護十二世
Watford FC	沃特福德足球俱乐部
Futbol	足球
L-Olokawst	納粹大屠殺
Madrid	马德里
Michael Jackson	迈克尔·杰克逊
5 ta' Settembru	9月5日
4 ta' Settembru	9月4日
Santiago (Ċili)	圣地亚哥-德智利
25 ta' Ottubru	10月15日
5 ta' Novembru	11月5日
22 ta' Novembru	11月22日
Aħdar	綠色
Aħmar	红色
Lourdes	盧爾德
Rabat (Marokk)	拉巴特
Kometa	彗星
Belgrad	贝尔格莱德
Kategorija:Mudelli	Category:維基百科模板
George Sand	乔治·桑
Nikosija	尼科西亚
Asterojde	小行星
Manama	麦纳麦
Eklissi solari	日食
Wikipedija:Paġna tal-provi	Wikipedia:沙盒
Nettunu (mitoloġija)	尼普顿
Alġebra	代数
Ajruport Dong Hoi	同海機場
Miley Cyrus	麥莉·希拉
Curitiba	庫里奇巴
Pangea	盤古大陸
Kategorija:1888	Category:1888年
Pika Alpina	高山鼠兔
Konfuċju	孔子
Corbin Bleu	柯賓·布魯
Kategorija:Matematika	Category:数学
Gżejjer Faroe	法罗群岛
Mudell:Dati pajjiż Iran	Template:Country data Iran
Ġove (mitoloġija)	朱庇特
Sherlock Holmes	歇洛克·福尔摩斯
Rinaxximent	文艺复兴
Kategorija:Twieldu fl-1888	Category:1888年出生
Ewro	欧元
Baħar Mediterran	地中海
Kristjaneżmu	基督教
Mudell:Favur	Template:Support
Għasfur	鸟
Belt kapitali	首都
Monzón	蒙宗
Mustafa Kemal Atatürk	穆斯塔法·凯末尔·阿塔蒂尔克
Mudell:Portal	Template:Portal
Huang Xianfan	黄现璠
Bill Gates	比尔·盖茨
Struttura .NET	.NET框架
Enċiklopedija	百科全书
Il-Paġna prinċipali	Wikipedia:首页
Baskitbol	篮球
Francisco Goya	弗朗西斯科·戈雅
Albrecht Dürer	阿尔布雷希特·丢勒
Frida Kahlo	芙烈達·卡蘿
Mikelanġlu	米开朗基罗
Miguel de Cervantes	米格尔·德·塞万提斯
Charles Dickens	查尔斯·狄更斯
Mekka	麥加
Che Guevara	切·格瓦拉
Mao Zedong	毛泽东
Johann Wolfgang von Goethe	约翰·沃尔夫冈·冯·歌德
Filosofija	哲学
Jimi Hendrix	吉米·亨德里克斯
Kategorija:Proposti għat-tħassir minnufih	Category:快速删除候选
Hebe Camargo	赫柏·卡马戈
Komuniżmu	共产主义
Saħara tal-Punent	西撒哈拉
Pajjiż	国家
Kartaġni	迦太基
Kategorija:Astronomija	Category:天文学
UTC−3:30	UTC-3:30
Søren Kierkegaard	索倫·奧貝·克爾凱郭爾
Bolzano	波尔查诺
Rivoluzzjoni Franċiża	法国大革命
Saħara	撒哈拉沙漠
Strażburgu	斯特拉斯堡
Lingwa Kroata	克罗地亚语
UTC+1	UTC+1
Omeru	荷马
UTC+2	UTC+2
UTC+3	UTC+3
Lena Meyer-Landrut	萊娜·邁爾-蘭德魯特
Seklu XVII	17世纪
Ateiżmu	无神论
Ekoloġija	生态学
FC Barcelona	巴塞罗那足球俱乐部
Marie Curie	玛丽·居里
Premju Nobel	诺贝尔奖
Alan Turing	艾伦·图灵
Ideoloġija	意識形態
Ada Lovelace	愛達·勒芙蕾絲
Franz Schubert	弗朗茨·舒伯特
Igor' Stravinskij	伊戈尔·费奥多罗维奇·斯特拉文斯基
Pëtr Il'ič Čajkovskij	彼得·伊里奇·柴可夫斯基
Giuseppe Verdi	朱塞佩·威尔第
Kristofru Kolombu	克里斯托弗·哥伦布
Nagħġa	綿羊
Mammiferu	哺乳动物
Naħla	蜂族
Speċi	物种
Tifel	儿童
Napuljun III	拿破仑三世
Vladimir Putin	弗拉基米尔·弗拉基米罗维奇·普京
Analisi matematika	数学分析
Commonwealth tan-Nazzjonijiet	英联邦
Organizzazzjoni Dinjija tas-Saħħa	世界卫生组织
Demm	血液
Pulmun	肺
Casablanca	卡萨布兰卡
Xjenza Naturali	自然科学
Santu Wistin	希波的奥古斯丁
Nelson Mandela	纳尔逊·曼德拉
Martin Luther King Jr.	马丁·路德·金
Ġeometrija	几何学
Atmosfera	大气层
Kategorija:Bulgarija	Category:保加利亚
Kategorija:Franza	Category:法国
Kategorija:Mużika	Category:音乐
Elf Lejla u Lejla	一千零一夜
Kategorija:Letteratura	Category:文学
Ilijade	伊利亚特
Alessandru Manju	亚历山大大帝
Edukazzjoni	教育
Hugo Chávez	烏戈·查維茲
Raġel	男性
Otto von Bismarck	奥托·冯·俾斯麦
Abort	堕胎
Skjavitù	奴隶制度
Logħob Olimpiku tas-sajf 2008	2008年夏季奥林匹克运动会
US Sassuolo Calcio	萨索罗足球俱乐部
Logħob Olimpiku tas-sajf 2016	2016年夏季奥林匹克运动会
Gwerra Ċivili Amerikana	南北战争
Imperu Brittaniku	大英帝国
Real Madrid CF	皇家马德里足球俱乐部
Sivilja	塞维利亚
Rivoluzzjoni Russa	1917年俄国革命
Arkimede	阿基米德
Thomas Edison	爱迪生
Ewklide	欧几里得
Bit	位元
Parlament Ewropew	欧洲议会
Kostellazzjoni	星座
Karl Marx	卡尔·马克思
Voltaire	伏爾泰
Ħinduiżmu	印度教
Erwin Schrödinger	埃尔温·薛定谔
Lingwa Maltija	马耳他语
Reliġjon	宗教
René Descartes	勒内·笛卡儿
Pawlu minn Tarsu	保罗 (使徒)
Immanuel Kant	伊曼努尔·康德
Guy de Maupassant	居伊·德·莫泊桑
Friedrich Nietzsche	弗里德里希·尼采
Fwied	肝臟
Kilwa	腎
Fenek	兔
Psikoloġija	心理学
Gautama Buddha	释迦牟尼
Premier League	英格兰足球超级联赛
Muħammed	穆罕默德
Probabbiltà	概率
Martin Luteru	馬丁·路德
Xigħa	什叶派
Knisja Kattolika	天主教會
Chelsea FC	切尔西足球俱乐部
Arsenal FC	阿森纳足球俱乐部
Sistema diġestiva	消化系统
Logħob Olimpiku tax-xitwa 2010	2010年冬季奥林匹克运动会
Reġina Eliżabetta II	伊丽莎白二世
Alfabett	字母系統
Ronald Reagan	罗纳德·里根
Festival tal-Eurovision 2005	2005年歐洲歌唱大賽
Festival tal-Eurovision 2006	2006年歐洲歌唱大賽
Festival tal-Eurovision 2007	2007年歐洲歌唱大賽
Festival tal-Eurovision 2008	2008年歐洲歌唱大賽
Festival tal-Eurovision 2009	2009年歐洲歌唱大賽
Festival tal-Eurovision 2010	2010年欧洲歌唱大赛
Festival tal-Eurovision 2011	2011年歐洲歌唱大賽
Festival tal-Eurovision 2012	2012年欧洲歌唱大赛
Festival tal-Eurovision 2013	2013年欧洲歌唱大赛
Main-Spessart	美因-斯佩萨特县
Catherine Middleton	劍橋公爵夫人凱薩琳
David Beckham	大卫·贝克汉姆
Ryan Giggs	瑞恩·吉格斯
Frankonja t'Isfel	下弗兰肯行政区
Tom Cleverley	汤姆·克莱维利
Ben Foster	賓·科士打 (足球運動員)
Ashley Young	艾殊利·楊格
Kim Jong-il	金正日
Kategorija:Veneżwela	Category:委内瑞拉
Belfast	贝尔法斯特
Tavla perjodika	元素周期表
Tórshavn	托爾斯港
Manuel Almunia	曼努埃尔·阿穆尼亚
Attakki tal-11 ta' Settembru	九一一袭击事件
Chordata	脊索动物
Kultura	文化
Trattat ta' Maastricht	马斯特里赫特条约
Mediċina	医学
Sarajevo	塞拉耶佛
Ekwazzjoni differenzjali	微分方程
Kategorija:Brażil	Category:巴西
Kategorija:Rumanija	Category:罗马尼亚
Element kimiku	化學元素
Funzjonijiet (matematika)	函数
Kimika organika	有机化学
Mekkanika klassika	经典力学
Klassifikazzjoni bijoloġika	生物分類法
Arti marzjali	武術
Rota	自行車
Relatività ristretta	狭义相对论
Ħġieġ	玻璃
Karta	纸
Kilogramm	千克
Cristiano Ronaldo	基斯坦奴·朗拿度
Metru	米 (单位)
Pittura	绘画
Skultura	雕塑
Żfin	舞蹈
Pajjiżi tad-dinja	世界政區索引
Preistorja	史前時代
Silvio Berlusconi	西尔维奥·贝卢斯科尼
4′33″	4分33秒
Kolera	霍亂
Skerma	击剑
Sfera ċelesti	天球
Malarja	疟疾
AIDS	艾滋病
Tuberkulożi	結核
Mona Lisa	蒙娜丽莎
Teorija tan-numri	数论
Kileb	叠涩
Biżantini	拜占庭帝国
Kruċjata	十字軍東征
Imperu Ottoman	奥斯曼帝国
Malgrat de Mar	滨海马尔格拉特
Stephan El Shaarawy	斯蒂凡·艾尔·沙拉维
Mirtilla	藍莓
Lampuna	樹莓
Tuta tal-għollieq	黑莓
Kurgan (belt)	库尔干
Trapani	特拉帕尼
Wikispeċi	維基物種
Lingwa Għarbija	阿拉伯语
Jum ir-Ringrazzjament	感恩节
Lingwa Oċċitanija	奥克语
Lingwa tas-Sinjali Amerikana	美國手語
Kategorija:Provinċji tal-Italja	意大利省份列表
Alkoħoliżmu	酗酒
FC Bayern Munich	拜仁慕尼黑足球俱乐部
Serie A	意大利足球甲级联赛
Queen	皇后乐队
Provinċja ta' Agrigento	阿格里真托省
Provinċja ta' Bergamo	貝加莫省
Provinċja ta' Kaltanissetta	卡爾塔尼塞塔省
Provinċja ta' Lodi	洛迪省
Wikipedija:Vetrina	Wikipedia:特色条目
Mudell:Link FA	Template:Link FA
Dinja	世界
Wikipedija:Pjazza	Wikipedia:互助客栈
Takson	分類單元
Papa Pawlu VI	保祿六世
Etna	埃特纳火山
Clube de Regatas do Flamengo	法林明高競賽會
Gerard Piqué	赫拉德·皮克
San Lawrenz	羅馬的聖老楞佐
Martin Schulz	馬丁·舒爾茨 (德國政治家)
KAA Gent	KAA根特
Mudell Standard	标准模型
Teorija ta' kollox	万有理论
Tamworth FC	塔姆沃思足球俱乐部
Mafja	黑手党
Manchester United FC	曼徹斯特聯足球俱樂部
Aston Villa FC	阿士東維拉足球會
West Ham United FC	西汉姆联足球俱乐部
UEFA Champions League	欧洲冠军联赛
UEFA Europa League	欧足联欧洲联赛
Fenek tal-istrixxi ta' Sumatra	蘇門答臘兔
Tazza tad-Dinja tal-Futbol	世界盃足球賽
Daniel Parejo Muñoz	丹尼尔·帕雷霍
Blackburn Rovers FC	布莱克本流浪者足球俱乐部
Wolverhampton Wanderers FC	伍尔弗汉普顿流浪足球俱乐部
Rafael Correa	拉斐尔·科雷亚
R. Charleroi SC	皇家沙勒罗瓦体育俱乐部
FC Twente	特温特足球俱乐部
Motorhead	摩托头
Milied	圣诞节
Lingwi Romaniċi	罗曼语族
Steve Jobs	史蒂夫·乔布斯
Lady Gaga	Lady Gaga
Indoewropew	印欧语系
Muammar al-Gaddafi	穆阿迈尔·卡扎菲
Francesco Totti	弗朗切斯科·托蒂
Chișinău	基希讷乌
Soċjoloġija	社会学
Şalom	Şalom報
Caenolestidae	鼩负鼠科
Trojja	特洛伊
The Pirate Bay	海盜灣
Kampjonati Ewropej tal-Futbol 2012	2012年欧洲足球锦标赛
Audi	奥迪
Abkażja	阿布哈茲
Antropoloġija	人类学
Baħar l-Aħmar	红海
Octave Mirbeau	奥克塔夫·米尔博
Abjad	白色
Iswed	黑色
Lordi	妖怪樂團
Lingwa uffiċjali	官方语言
Provinċja ta' Quảng Bình	廣平省
Entrena	恩特雷纳
Mérida (Veneżwela)	梅里達市
Benito Mussolini	贝尼托·墨索里尼
LOST (Serje televiżiva)	迷失
Ġebla tal-ġir	石灰岩
Valletta	瓦莱塔
Papa Ġwanni XXIII	若望二十三世
Benetice (Světlá nad Sázavou)	贝内蒂采
Prixtina	普里什蒂纳
Curaçao	库拉索
Coccinellidae	瓢蟲
Metatheria	有袋類
Pangolin	穿山甲
Lagomorpha	兔形目
Baqra tal-baħar	海牛目
Eutheria	真獸下綱
Fenek Ewropew	穴兔
Leporidae	兔科
Imperu Kushan	貴霜帝國
Qlugħ	帆
Klaas-Jan Huntelaar	克拉斯-扬·亨特拉尔
Proboscidea	长鼻目
Università Niccolò Cusano	尼可罗库萨诺大学
FK Radnik Bijeljina	比耶利納工人足球俱樂部
Fażijiet lunari	月相
Fariżej	法利赛人
Liebru Ewropew	歐洲野兔
Lepisma saccharina	蠹魚
Membru tal-Parlament Ewropew	歐洲議會議員
Laurasiatheria	勞亞獸總目
Afrotheria	非洲獸總目
Ewropa t'Isfel	南欧
Ewropa Ċentrali	中欧
Kristadelfjani	基督弟兄會
Tim nazzjonali tal-futbol tal-Eġittu	埃及國家足球隊
Maja	瑪雅文明
Chow Chow	鬆獅犬
FC Kuban Krasnodar	克拉斯諾達爾庫班足球俱樂部
Derivata	导数
Kwalifikazzjoni għall-Kampjonati Ewropej tal-Futbol 2008	2008年欧洲足球锦标赛外围赛
Chris Smalling	克里斯·斯莫林
Jonny Evans	乔尼·埃文斯
Michael Carrick	迈克尔·卡里克
Multilingwiżmu	多语制
Lingwa Sileżjana	西里西亞語
Avril Lavigne	艾薇兒·拉維尼
Mikhail Gorbachev	米哈伊尔·谢尔盖耶维奇·戈尔巴乔夫
Slogan	標語
Madre Tereża ta' Kalkutta	真福加爾各答的德肋撒
UEFA Champions League 2013–14	2013–14年歐洲冠軍聯賽
Rudolf Clausius	魯道夫·克勞修斯
Auguste Rodin	奥古斯特·罗丹
Blogg	網誌
Oscar Wilde	奥斯卡·王尔德
Krakovja	克拉科夫
Malala Yousafzai	马拉拉·优素福扎伊
Marsa FC	马萨足球俱乐部
Valery Leontiev	瓦列里里昂惕夫
Mużew	博物馆
Du Fu	杜甫
Popolazzjoni	人口
Arċipelagu	群島
Lingwa Sqallija	西西里语
Valparaíso	瓦尔帕莱索
Nju	紐埃
Tim nazzjonali tal-futbol tal-Iskozja	蘇格蘭足球代表隊
Lingwa Leoniża	萊昂語
Żews	宙斯
Lingwa tas-Sinjali	手語
Astroloġija	占星学
Mošovce	莫绍夫采
Saint-Dié-des-Vosges	孚日圣迪耶
Boris Yeltsin	鲍里斯·尼古拉耶维奇·叶利钦
Hirohito	昭和天皇
Baħar Eġew	爱琴海
J.K. Rowling	J·K·罗琳
Hiroshima	廣島市
Mitoloġija Griega	希腊神话
Ġeneru (tassonomija)	属 (生物)
Xjenzi soċjali	社会科学
Lista ta' kodiċi telefoniċi	国际电话区号列表
Lista ta' bliet kapitali	各国首都列表
Noemi (kantanta)	Noemi
Sit elettroniku	網站
Odissea	奥德赛
Lingwa Ido	伊多語
Etimoloġija	语源学
Nikita Krushchev	尼基塔·謝爾蓋耶維奇·赫魯曉夫
Kia Motors	起亚汽车
Familja (bijoloġija)	科 (生物)
UEFA	歐洲足球協會聯盟
Arthur Conan Doyle	阿瑟·柯南·道尔
Sport Club Corinthians Paulista	哥連泰斯保利斯塔體育會
Lingwa Kopta	科普特语
Folklor	民俗學
Siligo	西利戈
Mark Zuckerberg	马克·扎克伯格
Neolitiku	新石器时代
Katerina II tar-Russja	叶卡捷琳娜二世
Guglielmo Marconi	古列尔莫·马可尼
Ordni (bijoloġija)	目 (生物)
Cork	科克 (爱尔兰)
Renju (bijoloġija)	界 (生物)
Novial	诺维亚语
Aung San Suu Kyi	翁山蘇姬
Kompożitur	作曲家
Influwenza tal-majjali	豬流感
Serbja u Montenegro	塞爾維亞與蒙特內哥羅
Romantiċiżmu	浪漫主义
It-Trinita' Mqaddsa	三位一體
Faragħun	法老
Mariupol	马里乌波尔
Tazza tad-Dinja tal-Futbol 2006	2006年世界杯足球赛
Klaus Ebner	克勞斯·埃布訥
Klassi (bijoloġija)	纲
Campora San Giovanni	肯波拉圣吉奥瓦尼
Bălţi	伯爾茲
Auckland Grammar School	奧克蘭文法學校
Bolla postali	邮票
Era (mitoloġija)	赫拉
Premju Nobel għall-Fiżika	诺贝尔物理学奖
Enya	恩雅
Phylum	门 (生物)
Enriku VIII tal-Ingilterra	亨利八世
São Paulo FC	聖保羅足球會
Baħar Tirren	第勒尼安海
Leeds	利兹
NK Čelik Zenica	澤尼察鋼鐵足球俱樂部
Surrealiżmu	超现实主义
San Ġwann (Malta)	聖瓜安
Ħaż-Żabbar	扎巴爾
Mosta	莫斯塔
Tas-Sliema	斯利馬
Ħal Qormi	戈爾米 (馬耳他)
Birkirkara	比爾基卡拉
Radio Studio 54 Network	第54演播室電台聯播網
Lamantin tal-Karibew	西印度海牛
Atti ta' l-Appostli	使徒行传
Żodjaku	黃道帶
Paulínia	保利尼亚
Fonoloġija	音位學
Kim Il-sung	金日成
Jan Vermeer	扬·弗美尔
Borussia Dortmund	多特蒙德足球俱樂部
Għenba tax-xewk	鵝莓
Michel de Montaigne	米歇爾·德·蒙泰涅
Golf ta' Biskaja	比斯開灣
Sorċid	鼩鼱科
Feniċi	腓尼基
Akille	阿喀琉斯
Gramma	克
.mt	.mt
Michelangelo Merisi da Caravaggio	卡拉瓦乔
Tim nazzjonali tal-futbol ta' Spanja	西班牙國家足球隊
Martin Weinek	馬丁·韋內克
Björk	碧玉 (歌手)
H. G. Wells	赫伯特·乔治·威尔斯
Tumas More	托马斯·莫尔
Fernando Torres	費蘭度·托利斯
Lamantin	海牛屬
Baħar Liguri	利古里亞海
Dima Bilan	季马·比兰
Lega Anżejatika	汉萨同盟
Fażi eliminatorja tal-Kampjonati Ewropej tal-Futbol 2008	2008年歐洲足球錦標賽淘汰賽
Kubiżmu	立体主义
Qawwiet tal-Assi tat-Tieni Gwerra Dinjija	轴心国
Wikipedija:Mistoqsijiet rikorrenti	Wikipedia:常见问题解答
Għar ta' Thien Duong	天堂洞
Arg-é Bam	巴姆古城
Tim nazzjonali tal-futbol tal-Ġermanja	德國國家足球隊
Gustave Flaubert	古斯塔夫·福樓拜
San Mattew	馬太
Sant'Ambroġju	安波羅修
Ġwanni Kriżostmu	约翰一世 (君士坦丁堡牧首)
Papa Piju X	庇護十世
Papa Ljun XIII	利奥十三世
Rasputin	格里高利·叶菲莫维奇·拉斯普京
San Girgor Nażjanżenu	聖額我略·納齊安
Egon Schiele	埃貢·席勒
Duminku ta' Guzmán	聖道明
Hamit Altıntop	哈米德·阿尔滕托普
Maximilien Robespierre	马克西米连·罗伯斯庇尔
Ġlormu	耶柔米
San Bażilju	該撒利亞的巴西流
Michel Foucault	米歇尔·福柯
Daniel Van Buyten	丹尼尔·范比滕
Rabat (Malta)	拉巴特 (馬耳他)
Fgura	弗古拉
Żejtun	榟橔
Naxxar	納沙爾
Iż-Żurrieq	祖里格
John Henry Newman	約翰·亨利·紐曼
Ħ'Attard	阿塔爾德
Ħaż-Żebbuġ	澤布季
Morus (botanika)	桑树
Son Doong	山水洞
Alex Ferguson	亚历克斯·弗格森
Erwin Hoffer	埃爾文·霍費爾
Arkanġlu Mikiel	米迦勒
Titan	提坦
Kardinal	樞機
Iżabella ta' Kastilja	伊莎贝拉一世 (卡斯蒂利亚)
Liebru	兔属
Felix Mendelssohn	费利克斯·门德尔松·巴托尔迪
Orikteropu	土豚
Leonardo Araújo	莱昂纳多·阿劳若
Metodu xjentifiku	科学方法
Espoo	埃斯波
Bijodiversità	生物多樣性
Kannella (kulur)	褐色
Tizjanu	提齊安諾·維伽略
Matteo Renzi	马泰奥·伦齐
Venere (mitoloġija)	维纳斯
Tazza tad-Dinja tal-Futbol 2002	2002年世界盃足球賽
Tim nazzjonali tal-futbol tal-Ingilterra	英格蘭足球代表隊
Tim nazzjonali tal-futbol ta' Franza	法國國家足球隊
Sid Vicious	席德·维瑟斯
Mario Monti	马里奥·蒙蒂
Stojċiżmu	斯多亞學派
Martin Heidegger	马丁·海德格尔
Tazza tad-Dinja tal-Futbol 1930	1930年世界盃足球賽
Università ta' New York	纽约大学
Giulio Andreotti	朱利奥·安德烈奥蒂
Park Ji-Sung	朴智星
Slaten Maġi	東方三博士
Pajjiżi Nordiċi	北歐五國
Kategorija:Mudelli tal-kimika	Category:化学模板
Trattat ta' Liżbona	里斯本条约
Claudio Monteverdi	克劳迪奥·蒙特威尔第
Iraċ	蹄兔目
Sami Khedira	萨米·赫迪拉
Provinċja ta' Soria	索里亚省
Arkanġlu Rafel	拉斐尔 (天使)
George Abela	乔治·阿贝拉
Moħammed VI	穆罕默德六世 (摩洛哥)
Jum l-Indipendenza	国庆日
Lawrence Gonzi	劳伦斯·贡齐
Assedju ta' Malta (1565)	马耳他之围 (1565年)
CONMEBOL	南美洲足球協會
Erbivoru	食草动物
Oskar Schindler	奧斯卡·辛德勒
Enejide	埃涅阿斯纪
Flamurtari Vlorë	法拿莫達利體育會
Besa Kavajë	比沙卡華積體育會
KF Laçi	拉奇足球俱樂部
Affiss	詞綴
Norberto Murara Neto	诺伯托·穆拉拉·内托
L-Għanja tal-Milied	小氣財神
Semitiku	閃米特人
Marrara	胆囊
Sottospeċi	亞種
Ħassan II	哈桑二世 (摩洛哥)
It-Tielet Repubblika Franċiża	法兰西第三共和国
Joyeux Noël	聖誕快樂 (電影)
FK Kukësi	庫克斯足球俱樂部
KF Skënderbeu Korçë	史簡達布足球會
Alfred Wegener	阿尔弗雷德·魏格纳
Edith Stein	艾蒂特·史坦茵
Friedrich Carl von Savigny	弗里德里希·卡尔·冯·萨维尼
Wilhelm von Humboldt	威廉·馮·洪堡
Wikipedija:Vetrina/Senjalazzjonijiet	Wikipedia:特色条目评选
Tazza tad-Dinja tal-Futbol 2014	2014年世界盃足球賽
Coronel Fabriciano	法布里西亚诺上校城
L-Integral	积分
Miroslav Klose	米罗斯拉夫·克洛泽
Alla Pugacheva	阿拉·普加乔娃
Dante Bonfim Costa Santos	丹特 (足球运动员)
Isco	伊斯高
Fes	非斯
Liebru taż-żarbuna tas-silġ	白靴兔
Greenpeace	绿色和平
KS Vllaznia Shkodër	維拉斯尼亞足球會
Teuta Durrës	圖達杜利斯體育會
Arkanġlu Gabrijel	加百列
Mata Hari	玛塔·哈里
Fußball-Bundesliga	德国足球甲级联赛
Pressjoni tad-demm	血壓
Enea	埃涅阿斯
Politiku	政治人物
David Villa	大卫·比利亚
Demenzja	失智症
Jürgen Klopp	尤尔根·克洛普
Tazza tan-Nazzjonijiet Afrikani	非洲國家盃
Romeo u Ġuljetta	罗密欧与朱丽叶
Konfederazzjoni Ażjatika tal-Futbol	亚洲足球联合会
Robin Williams	羅賓·威廉斯
Normanni	諾曼人
Tim nazzjonali tal-futbol tal-Brażil	巴西國家足球隊
Grupp (matematika)	群
Mesut Özil	梅苏特·厄齐尔
Isabel Allende	伊莎貝·阿言德
Wes Brown	韦斯·布朗
It-Tempesta	暴風雨 (莎士比亞)
Jum l-Indipendenza (Stati Uniti)	美国独立日
Mudell:Ċita ktieb	Template:Cite book
Robert Tappan Morris	罗伯特·泰潘·莫里斯
Divorzju	离婚
Chrzanów	赫扎努夫
Impuls FC Dilijan	迪利然脉冲足球俱乐部
Suffiss	後綴
Artiklu (grammatika)	冠词
Australopithecus	南方古猿
Festival tal-Eurovision tat-Tfal	歐洲青少年歌唱大賽
Kaspar Capparoni	卡斯帕·卡帕罗尼
Ħolma ta’ Lejla Sajfija	仲夏夜之夢
Berthe Morisot	貝爾特·莫里索
Manuel Neuer	曼努埃尔·诺伊尔
Penny Black	黑便士
Armistizju	停戰協定
KV Mechelen	梅赫倫足球俱樂部
Heiko Westermann	海科·韦斯特曼
Papa Ċelestinu V	雷定五世
Luftëtari Gjirokastër	吉諾卡斯特足球俱樂部
Amedeo Modigliani	阿梅代奥·莫迪利亚尼
Appendiċite	闌尾炎
Hakan Yakın	哈坎·雅金
Ludovic Magnin	卢多维奇·马格宁
Diego Benaglio	迭戈·貝納利奧
Daniel Bernoulli	丹尼尔·伯努利
Jacob Bernoulli	雅各布·伯努利
Pajjiż interkjuż	內陸國家
Nicolaus I Bernoulli	尼古拉一世·伯努利
Nicolaus II Bernoulli	尼古拉二世·伯努利
Gwerer Puniċi	布匿战争
Ġunone	朱諾 (羅馬神話)
Massimo Oddo	马西莫·奥多
Fraizer Campbell	弗雷泽·坎贝尔
Allianz Arena	安联竞技场
San Ġużepp	聖若瑟
Hidetoshi Nakata	中田英壽
FK Borac Banja Luka	巴尼亞盧卡戰士足球俱樂部
L-Aħħar Ċena (Leonardo)	最后的晚餐 (达芬奇)
Macroscelididae	象鼩
Dugongu	儒艮
Galway	戈尔韦
Mario Balotelli	马里奥·巴洛特利
Marvin Compper	馬雲·甘柏
Macbeth	馬克白
Theria	獸亞綱
Akropoli ta' Ateni	雅典衛城
Filatelija	郵票研究
Stromboli	斯通波利島
The Fame	超人气 (专辑)
FK Austria Wien	奧地利維也納足球會
SK Rapid Wien	維也納迅速足球會
Venere ta' Willendorf	维伦多尔夫的维纳斯
Bandiera ta' Malta	马耳他国旗
Teorija tal-grafi	图论
Lola Pagnani	洛拉·帕尼亞尼
Bitcoin	比特币
Tim nazzjonali tal-futbol tad-Danimarka	丹麥國家足球隊
Black metal	黑金屬音樂
Ġeroglifiċi Eġizzjani	圣书体
Pika ta' Kozlov	柯氏鼠兔
Sataniżmu	撒旦教
Grawnd Nazzjonali ta' Bejġing	国家体育场 (北京)
Stadio Giuseppe Meazza	聖西路球場
SC Wiener Neustadt	馬納維也納新城體育會
Plotinu	普罗提诺
Tim nazzjonali tal-futbol tal-Kroazja	克羅地亞國家足球隊
Eomanis	始穿山甲屬
Tim nazzjonali tal-futbol tal-Greċja	希臘國家足球隊
Pika ta' Muli	木里鼠兔
Tazza tad-Dinja tal-Futbol tal-Klabbs 2006	2006年世界冠軍球會盃
Tazza tad-Dinja tal-Futbol tal-Klabbs 2007	2007年世界冠軍球會盃
Tazza tad-Dinja tal-Futbol tal-Klabbs 2009	2009年世界冠軍球會盃
Tazza tad-Dinja tal-Futbol tal-Klabbs 2008	2008年世界冠軍球會盃
Eklissi	食 (天文現象)
Neymar	内马尔
Brendi	白兰地
Dominju (bijoloġija)	域 (生物)
Kassisa	黑加仑
Daniel Schneidermann	丹尼爾·施內德芒
David de Gea	大衞·迪基亞
Westfalenstadion	西格納伊度納公園
Robert Lewandowski	罗伯特·莱万多夫斯基
Kunflitt Iżraeli-Palestinjan	以巴冲突
Għajnuna:Kif timmodifika artiklu	Help:编辑页面
Lidl	Lidl
Jupp Heynckes	積普·希基斯
Plutone (mitoloġija)	普路托
Eddie Fenech Adami	埃迪·芬内克·阿达米
Prim Ministru ta' Malta	馬耳他總理
Riccardo Montolivo	列卡度·蒙度利禾
Tazza tad-Dinja tal-Futbol tal-Klabbs 2010	2010年世界冠軍球會盃
Cristian Zaccardo	克里斯蒂安·扎卡尔多
Gwerra totali	总体战
Nickelodeon	尼克国际儿童频道
Ugo Grozju	胡果·格老秀斯
René Adler	勒内·阿德勒
Eruka	芝麻菜
Ablativ	离格
Tazza Ażjatika tal-Futbol	亚足联亚洲杯
Boomerang TV	迴旋鏢 (電視頻道)
Internazzjonali Soċjalista	社會黨國際
Nannakola tas-seba' tikek	七星瓢虫
Santa Sede	聖座
Ettore	赫克特
WK	西元
Reġina ta' Saba	示巴女王
Alġebra astratta	抽象代数
CONCACAF	中北美洲及加勒比海足球協會
Skanderbeg	斯坎德培
Tim nazzjonali tal-futbol tal-Iżvezja	瑞典國家足球隊
Paul Allen	保罗·艾伦
Eroj	英雄
Kuopio	庫奧皮奧
Sirt	蘇特 (利比亞)
Soccer City	足球城體育場
Tim nazzjonali tal-futbol tal-Awstrija	奧地利國家足球隊
Tim nazzjonali tal-futbol tal-Irlanda	愛爾蘭國家足球隊
Nemanja Vidić	內馬尼亞·維迪奇
Derry	德里 (北愛爾蘭)
Ġuvni	學士
Drużiżmu	德鲁兹派
Omnivoru	雜食動物
George Best	佐治·貝斯
Oliver Twist	雾都孤儿
Javier Hernández Balcázar	哈维尔·埃尔南德斯
Tim nazzjonali tal-futbol tal-Iżvizzera	瑞士國家足球隊
Ekwazzjoni ta' Schrödinger	薛定谔方程
Priżma	稜鏡
Ballun tad-Deheb	金球奖 (足球)
Tim nazzjonali tal-futbol tal-Polonja	波蘭國家足球隊
Foviżmu	野兽派
Tim nazzjonali tal-futbol tal-Belġju	比利時國家足球隊
Dom Mintoff	多姆·明托夫
Sant'Antnin ta' Padova	里斯本的聖安多尼
Eredivisie	荷兰足球甲级联赛
Ugo Mifsud Bonnici	乌戈·米夫苏德·邦尼奇
Guido de Marco	圭多·德马科
Pawlu Xuereb	保罗·苏埃雷布
Ċensu Tabone	文森特·塔博恩
Konfederazzjoni Afrikana tal-Futbol	非洲足球協會
Agatha Barbara	阿加莎·芭芭拉
Tim nazzjonali tal-futbol tar-Rumanija	羅馬尼亞國家足球隊
Dimitar Berbatov	迪米塔尔·贝尔巴托夫
Tim nazzjonali tal-futbol tal-Ukrajna	烏克蘭國家足球隊
Għawdex	戈佐岛
Tim nazzjonali tal-futbol tal-Ungerija	匈牙利國家足球隊
Natura mejta	静物画
Laura Pausini	蘿拉·普西妮
Gwerra Anglo-Żanżibarjana	英桑战争
Children of Bodom	死神之子
Festival tal-Eurovision 1956	1956年歐洲歌唱大賽
Tazza tal-Konfederazzjonijiet	国际足联联合会杯足球赛
Tim nazzjonali tal-futbol tas-Slovenja	斯洛文尼亞國家足球隊
Darren Fletcher	达伦·弗莱彻
Gowler	守門員
Mary Cassatt	玛丽·卡萨特
Frankinċens	乳香
Cape Town Stadium	開普敦球場
Xenarthra	异关节总目
Lista ta' kimiċi organiċi	有机化合物
Lira Maltija	马耳他里拉
Antonio Valencia	安东尼奥·瓦伦西亚
Tim nazzjonali tal-futbol tas-Slovakkja	斯洛伐克國家足球隊
Tereża ta' Ávila	亚维拉的德兰
Guernica (pittura)	格尔尼卡 (绘画)
Tim nazzjonali tal-futbol ta' New Zealand	新西蘭國家足球隊
Kompjuter kwantistiku	量子计算机
Tazza tad-Dinja tal-Futbol 2010	2010年世界盃足球賽
Kantant	歌手
Andrea Palladio	安德烈亚·帕拉弟奥
Heurelho Gomes	靴里奴·高美斯
Moviment Brownjan	布朗运动
Filosofija Presokratika	前苏格拉底哲学
Apparat Periferali	外部设备
Meknès	梅克内斯
Copa América	美洲盃足球賽
Serje ta' Fourier	傅里叶级数
Santa Katarina ta' Lixandra	亚历山大的加大肋纳
Lipari	埃奥利群岛
Liebru tal-muntanji	雪兔
Konfederazzjoni Oċeanika tal-Futbol	大洋洲足球協會
Kwalifikazzjoni għall-Kampjonati Ewropej tal-Futbol 2012	2012年欧洲足球锦标赛预选赛
Tim nazzjonali tal-futbol tal-Andorra	安道爾國家足球隊
Tim nazzjonali tal-futbol tal-Ażerbajġan	阿塞拜疆國家足球隊
Klassifika dinjija tal-FIFA	國際足總世界排名
Charlotte Perrelli	夏洛特·佩雷利
Tim nazzjonali tal-futbol tal-Bulgarija	保加利亞國家足球隊
Tim nazzjonali tal-futbol ta' Wales	威爾斯足球代表隊
Atomium	原子球塔
Tim nazzjonali tal-futbol tal-Bożnija u Ħerżegovina	波斯尼亞和黑塞哥維那國家足球隊
Tereża ta' Lisieux	裡修的聖德蘭
Tabella tal-midalji tal-Logħob Olimpiku tas-sajf 2008	2008年夏季奥林匹克运动会奖牌榜
Ellis Park Stadium	埃利斯公園球場
Tazza Interkontinentali (futbol)	洲際盃足球賽
Bing	Bing
Plejer tas-Sena tal-FIFA	國際足協世界足球先生
Santa Luċija (qaddisa)	聖露西
Tim nazzjonali tal-futbol tal-Armenja	亞美尼亞國家足球隊
San Bastjan	圣巴斯弟盎
Kolugo	皮翼目
Tim nazzjonali tal-futbol tal-Każakistan	哈萨克斯坦国家足球队
Tazza tal-Konfederazzjonijiet 2009	2009年洲際國家盃
Pika	鼠兔
Thomas Vermaelen	托马斯·维尔马伦
UEFA Champions League 2009–10	2009–10年欧洲冠军联赛
Tim nazzjonali tal-futbol tal-Lussemburgu	盧森堡國家足球隊
Gareth Bale	格瑞斯·贝尔
Inkwiżizzjoni Spanjola	西班牙宗教裁判所
Glen Johnson	格連·莊臣
Manuel Rivera-Ortiz	曼努埃尔·里维拉-奥尔蒂斯
Tim nazzjonali tal-futbol ta' San Marino	聖馬力諾國家足球隊
Immakulata Kunċizzjoni	圣母无染原罪
Nigel de Jong	尼祖·迪莊
Tim nazzjonali tal-futbol tal-Bjelorussja	白俄羅斯國家足球隊
Tim nazzjonali tal-futbol tal-Albanija	阿爾巴尼亞國家足球隊
Tim nazzjonali tal-futbol tal-Ġeorġja	格魯吉亞國家足球隊
Tim nazzjonali tal-futbol tal-Litwanja	立陶宛國家足球隊
Karmelitani	加尔默罗会
UEFA Champions League 2007–08	2007–08年欧洲冠军联赛
Tim nazzjonali tal-futbol tal-Finlandja	芬兰国家足球队
Tim nazzjonali tal-futbol tal-Liechtenstein	列支敦士登国家足球队
Premier League 2008–09	2008–09賽季英格蘭超級聯賽
Tim nazzjonali tal-futbol tal-Estonja	愛沙尼亞國家足球隊
Premier League 2010–11	2010–11賽季英格蘭超級聯賽
Ħin supplementari	加时赛
Peter Mokaba Stadium	彼得·莫卡巴球場
Joe Hart	乔·哈特
Premier League 2007–08	2007–08賽季英格蘭超級聯賽
RSC Anderlecht	安德莱赫特足球俱乐部
Barriera	沙石场
Oroskopju	天宫图
Eġizzjan demotiku	世俗體
Fatt	事實
FK Partizan	游擊隊足球俱樂部
Tim nazzjonali tal-futbol ta' Malta	馬爾他國家足球隊
Supereroj	超级英雄
UEFA Champions League 2008–09	2008–09年欧洲冠军联赛
Tim nazzjonali tal-futbol ta' Ċipru	塞浦路斯國家足球隊
Premier League 2009–10	2009–10賽季英格蘭超級聯賽
Tim nazzjonali tal-futbol tal-Montenegro	蒙特內哥羅國家足球隊
Andrey Korotayev	安德烈·科罗塔耶夫
UEFA Champions League 2010–11	2010–11年歐洲冠軍聯賽
Rafael Pereira da Silva (twieled fl-1990)	拉斐尔·达·席尔瓦
FA Community Shield	英格蘭社區盾
Tim nazzjonali tal-futbol tal-Iżlanda	冰島國家足球隊
Tim nazzjonali tal-futbol tal-Unjoni Sovjetika	蘇聯國家足球隊
Soċjaliżmu Demokratiku	民主社会主义
Tim nazzjonali tal-futbol tal-Latvja	拉脫維亞國家足球隊
CONCACAF Gold Cup	美洲金盃
Pont du Gard	加爾橋
Sligo	斯莱戈
Emblema ta' Malta	马耳他国徽
Benvenuto Cellini	本韦努托·切利尼
Ordni Militari Sovran ta' Malta	馬爾他騎士團
Standard Liège	标准列日足球俱乐部
Club Brugge KV	布鲁日足球俱乐部
Jóhanna Guðrún Jónsdóttir	約翰娜·歌倫·約翰斯多蒂爾
Tim nazzjonali tal-futbol tal-Irlanda ta' Fuq	北愛爾蘭足球代表隊
Edward Sapir	愛德華·薩丕爾
Kemmuna	科米诺岛
FC BATE Borisov	鲍里索夫BATE足球俱乐部
Lucrezia Borgia	盧克雷齊亞·波吉亞
Klara ta' Assisi	亚西西的嘉勒
Tim nazzjonali tal-futbol tal-Iżrael	以色列國家男子足球隊
Gareth Barry	加雷斯·巴里
San Valentinu	聖瓦倫丁
FK Ekranas	伊蘭拿斯足球會
Mini ta' Cu Chi	古芝地道
L-Innu Malti	马耳他颂
Midfilder	中场
Kwalifikazzjoni għat-Tazza tad-Dinja tal-Futbol 2010	2010年世界盃外圍賽
Kate Ryan	凱特·萊恩
Lys Assia	莉斯·阿西娅
Patri Piju	畢奧神父
Analisi komplessa	複分析
Martín Cáceres	馬田·卡沙利斯
Thylacinus	袋狼属
Royale Union Saint-Gilloise	聖基萊錫皇家聯盟
Łobez	沃貝茲
Fertilizzazzjoni ''in vitro''	體外人工受精
Tim nazzjonali tal-futbol tal-Gżejjer Faroe	法羅群島足球代表隊
Magnificat	尊主頌
Gowler (futbol)	守門員 (足球)
Theofanis Gekas	塞奥法尼斯·耶卡斯
Ażerbajġan fil-Festival tal-Eurovision	阿塞拜疆在歐洲歌唱大賽之歷年表現
Papat ta' Avignon	亞維農教廷
G-14	G-14
Armenja fil-Festival tal-Eurovision	亚美尼亚在欧洲歌唱大赛之历年表现
Rush	匆促樂團
Dundalk	邓多克
Id-Dsatax-il Emenda għall-Kostituzzjoni tal-Istati Uniti	美國憲法第十九修正案
'O sole mio	我的太阳
SK Sturm Graz	格拉茲風暴體育俱樂部
Il-Merkant ta’ Venezja	威尼斯商人
Hugo (film)	雨果 (电影)
Hapoel Tel Aviv FC	特拉維夫夏普爾足球會
UEFA Europa League 2009–10	2009–10年歐洲聯賽
Phil Jones	菲尔·琼斯
UEFA Europa League 2010–11	2010–11年歐洲聯賽
Olympe de Gouges	奥兰普·德古热
Giovanni Falcone	乔瓦尼·法尔科内
Mdina	姆迪纳
Vulcano	武尔卡诺岛
Tranquillo Barnetta	特兰基洛·巴内塔
Liġi tan-numri kbar	大数定律
Andorra fil-Festival tal-Eurovision	安道爾在歐洲歌唱大賽之歷年表現
Kitba jeratika	僧侶體
Rapidshare	RapidShare
Batterija	巴特里
Kung fu	功夫
Federico Macheda	费德里科·马凯达
Regola tal-gowls barra mid-dar	作客入球優惠制
Las Meninas	宮女 (委拉斯開茲)
Ingólfr Arnarson	殷格·亚纳逊
Elezzjonijiet Ewropej 2009	2009年歐洲議會選舉
KF Tirana	KF地拉那
Superliga Albaniża	阿爾巴尼亞超級足球聯賽
Kewkba ta' Betlehem	伯利恒之星
FC Dinamo Minsk	明斯克戴拿模足球會
Zoran Tošić	佐兰·托西奇
Golf	高尔夫 (消歧义)
Kwalifikazzjoni għat-Tazza tad-Dinja tal-Futbol 2010 (UEFA)	2010年世界盃外圍賽 (歐洲區)
Palazz Belvedere	美景宮
Andrea Poli	安德雷·波利
Artemisia Gentileschi	阿尔泰米西娅·真蒂莱斯基
Gżejjer Aran	阿倫群島
André Villas-Boas	安德烈·維拉斯-波亞斯
Samir Handanovič	萨米尔·汉达诺维奇
Ignazio Abate	伊格纳奇奥·阿巴特
Gelson Fernandes	謝臣·費南迪斯
Idriss Carlos Kameni	伊德里斯·卡文尼
Marlee Matlin	瑪麗·麥特琳
Dasyuromorphia	袋鼬目
Football League	英格兰足球联赛
Fábio Pereira da Silva	法比奥·达·席尔瓦
Antonio Nocerino	安东尼奥·诺切里诺
Mohamed Bouazizi	穆罕默德·布瓦吉吉
Denílson Pereira Neves	丹尼遜·彭利拿·尼維斯
Emerson Ferreira da Rosa	埃默森·费雷拉·达罗萨
L-Ewwel Diviżjoni Belġjana	比利時足球甲級聯賽
KRC Genk	KRC亨克
Lied	藝術歌曲
Kalkulu tal-varjazzjonijiet	变分法
UNCLOS Konvenzjoni tal-Ġnus Magħquda dwar id-Dritt tal-Baħar	聯合國海洋法公約
Trama (narrattiva)	情節
Neftchi Baku PFC	尼菲治巴库足球俱乐部
Bundesliga (Awstrija)	奧地利足球超級聯賽
Al-Fatiħa	開端章
Tazza tal-Konfederazzjonijiet 2013	2013年洲際國家盃
Giuseppe Rossi	朱塞佩·罗西
Darron Gibson	达隆·吉布森
Enzo Scifo	安素·史斯富
Air Malta	馬耳他航空
Kwalifikazzjoni għat-Tazza tad-Dinja tal-Futbol 2010 (CONCACAF)	2010年世界盃外圍賽 (中北美洲及加勒比海區)
F91 Dudelange	迪德朗日足球俱樂部
FC Santa Coloma	聖達哥林瑪足球會
KSC Lokeren Oost-Vlaanderen	东佛兰德洛克伦体育俱乐部
Tito Vilanova	蒂托·比拉诺瓦
Kwalifikazzjoni għat-Tazza tad-Dinja tal-Futbol 2010 (OFC)	2010年世界盃外圍賽 (大洋洲區)
Tazza tad-Dinja tal-Futbol tal-Klabbs	國際足協世界冠軍球會盃
No (teatru)	能剧
AFC	AFC
CAF	CAF
Alessandro Nesta	亚历山德罗·内斯塔
Johann Bernoulli	約翰·白努利
Tribù (bijoloġija)	族 (生物)
Santa Katerina ta' Siena	聖加大利納
Alexa Internet	Alexa Internet
Tupaja	樹鼩目
Liebru tal-Artiku	北极兔
Żarbuna tad-Deheb	歐洲金靴獎
Denis Law	丹尼斯·劳
Notoryctemorphia	袋鼹属
Daniele Bonera	丹尼爾·博內拉
Incertae sedis	地位未定
Sofonisba Anguissola	索福尼斯巴·安圭索拉
Elena Gheorghe	艾莲娜·乔治
Lavinia Fontana	拉维尼亚·丰塔纳
Premier League Armen	亞美尼亞足球超級聯賽
Al-naxid al-xarif	摩洛哥颂
FK Sarajevo	萨拉热窝足球俱乐部
Konvenzjoni ta' Vjenna dwar id-Dritt tat-Trattati	维也纳条约法公约
Grupp D tal-Kampjonati Ewropej tal-Futbol 2008	2008年歐洲足球錦標賽D組
Muniti tal-ewro ta' Malta	馬爾他的歐元硬幣
Kampjonati Ewropej tal-Futbol 2008	2008年欧洲足球锦标赛
Myrmecobiidae	袋食蚁兽
Papessa Ġovanna	女教宗瓊安
Ottorino Respighi	奥托里诺·雷斯庇基
Storja ta' Malta	马耳他历史
Fenek pigmew	侏兔
FC Pyunik	佩歷克足球會
Mikrostat	微型国家
Vinċenz de Paul	文生·德·保祿
Premier League Bjelorussu	白俄羅斯足球超級聯賽
Linfield FC	连菲特足球俱乐部
Peramelemorphia	袋狸目
Anders Lindegaard	安達斯·連迪加特
Florentino Pérez	弗洛伦蒂诺·佩雷斯
Lista ta' missjonijiet diplomatiċi tas-Santa Sede	聖座駐外機構列表
Diżugwaljanza ta' Čebyšëv	切比雪夫不等式
Halloween	万圣夜
FIFA	国际足球联合会
Dipendenza (Informatika)	耦合性 (計算機科學)
Primera Divisió	安道爾甲組足球聯賽
Birżebbuġa	比尔泽布贾
Imblokk Kontinentali	大陆封锁
Tupaia	樹鼩屬
Lista ta' pajjiżi skont l-erja	国家面积列表
Kampjonati Ewropej tal-Futbol	欧洲足球锦标赛
FC Wacker Innsbruck (2002)	因斯布魯克華卡迪路足球會
Msida Saint-Joseph FC	穆斯达圣约瑟夫足球俱乐部
Pangolin ta' denbu twil	长尾穿山甲
NK Široki Brijeg	希羅基布里耶格足球俱樂部
SV Mattersburg	馬特斯堡足球俱樂部
Jean Parisot de la Valette	让·德·瓦莱特
Fażi eliminatorja tal-UEFA Champions League 2012–13	2012/13赛季欧洲冠军联赛淘汰赛
Palazz Leopoldskron	雷翁波德斯克恩宮
Wayne Rooney	韦恩·鲁尼
Marsa	馬爾薩 (馬耳他)
Tim nazzjonali tal-futbol tal-Awstralja	澳洲國家足球隊
Finali tat-Tazza tad-Dinja tal-Futbol 2006	2006年世界杯足球赛决赛
Pangolin Malajan	馬來穿山甲
Nouvelle Fédération-Board	非国际足球联合会成员董事会
Ukraina fil-Festival tal-Eurovision	乌克兰在欧洲歌唱大赛之历年表现
Attakkant	前鋒 (足球)
Nihat Kahveci	尼哈特·卡赫维奇
Pika ta' Forrest	灰颈鼠兔
Oscar Romero	奥斯卡·罗梅罗
Lisandro López	利桑德罗·洛佩斯
Chris Eagles	克里斯·伊格尔斯
Gianluca Ramazzotti	吉昂路卡·雷瑪若提
ASEAN Football Federation	東南亞足球協會
Robertu Bellarmino	聖羅伯·白敏
St. Georges FC	圣乔治足球俱乐部
Fenek tax-xmara	南非山兔
Opossum ta' spallejh suwed	黑肩负鼠属
Fenek ta' Assam	粗毛兔
Salve Reġina	又聖母經
FK Liepājas Metalurgs	美達雷斯足球會
John O'Shea	約翰·奧沙
Guillermo Stábile	吉列尔莫·斯塔比莱
Massimo Busacca	马西莫·布萨卡
Ritchie De Laet	里奇·德莱特
Manucho Gonçalves	曼努乔
Diego Cavalieri	迭戈·卡瓦列里
Bernd Leno	貝恩德·萊諾
Urby Emanuelson	乌尔比·埃曼努埃尔森
Pika ta' Nubra	奴布拉鼠兔
Pika ta' Gaoligong	高黎贡鼠兔
Pika ħamra taċ-Ċina	红耳鼠兔
Pika ta' Thomas	狭颅鼠兔
Gomphos	釘齒獸
Gracilinanus	袋负鼠属
Pika ta' Tsing-ling	秦岭鼠兔
Pika tal-Ħimalaja	喜马拉雅鼠兔
Gurban Gurbanov	哥班·古亞班洛夫
Paolo Borsellino	保罗·博尔塞利诺
Jô	若
Grupp A tat-Tazza tad-Dinja tal-Futbol 2006	2006年世界盃足球賽決賽週 - A組
Adem Ljajić	阿德姆·利亚伊奇
Lucien Laurent	吕西安·洛朗
Sebastian Prödl	塞巴斯蒂安·普勒德爾
Julien Faubert	祖利安·法拔
Danny Simpson	丹尼·辛普森
Michael Mancienne	迈克尔·曼希恩尼
Dong Fangzhuo	董芳卓
San Ġennaru	聖雅納略
Carlos Eugênio Simon	卡洛斯·欧赫尼奥·西蒙
Pascal Zuberbühler	帕斯卡·蘇巴保拿
Franco Di Santo	法蘭高·迪山度
Patrick Müller	帕特里克·穆勒
Digão	迪加奧
Leonardo Sciascia	列昂纳多·夏夏
Edward Maya	爱德华·玛雅
Grupp A tal-Kampjonati Ewropej tal-Futbol 2008	2008年歐洲足球錦標賽A組
Federazzjoni tal-Futbol tal-Andorra	安道爾足球總會
Gonzalo Javier Rodríguez	干沙路·查維亞·洛迪古斯
Tazza tad-Dinja VIVA	萬歲世界盃
Premier League Malti	馬耳他足球超級聯賽
La Liga	西班牙足球甲级联赛
Joel Obi	乔尔·奥比
Premier League Ażerbajġan	阿塞拜疆足球超級聯賽
Grupp Ġ tat-Tazza tad-Dinja tal-Futbol 2006	2006年世界盃足球賽決賽週 - G組
Grupp Ċ tat-Tazza tad-Dinja tal-Futbol 2006	2006年世界盃足球賽決賽週 - C組
Grupp E tat-Tazza tad-Dinja tal-Futbol 2006	2006年世界盃足球賽決賽週 - E組
Grupp F tat-Tazza tad-Dinja tal-Futbol 2006	2006年世界盃足球賽決賽週 - F組
Grupp D tat-Tazza tad-Dinja tal-Futbol 2006	2006年世界盃足球賽決賽週 - D組
Alleati tat-Tieni Gwerra Dinjija	同盟國 (第二次世界大戰)
Valletta FC	瓦莱塔足球俱乐部
Gustavo Gutiérrez	古斯塔沃·古鐵雷斯
Difensur	後衛 (足球)
Ħamrun	哈姆倫 (馬耳他)
Jores Okore	祖利斯·奧高尼
Gary Neville	加利·尼維利
Johnny Leoni	尊尼·里安尼
Emiliano Insúa	艾美利安奴·恩素亞
Ritratt ta' Adele Bloch-Bauer I	艾蒂兒肖像一號
Paul Van Himst	保羅·雲·希姆斯特
Cercle Brugge KSV	色格拉布魯日皇家體育會
Opossum ta' erba' għajnejn kannella	四眼负鼠属
Unuri tat-Tazza tad-Dinja tal-Futbol	世界杯金靴奖
Kwalifikazzjoni għat-Tazza tad-Dinja tal-Futbol 2010 (UEFA) - Grupp 6	2010年世界盃外圍賽－歐洲區第六組
Memorial Day	亡兵紀念日
Unuri għall-klabbs tal-UEFA	欧洲足联俱乐部足球奖
Bloggosfera	網誌空間
Life of Pi	少年Pi的奇幻漂流
SV Zulte Waregem	祖尔特瓦雷根足球俱乐部
Semih Şentürk	塞米赫·森图尔克
Tupaja tat-Tramuntana	树鼩
Dasyurus	袋鼬属
Mattia De Sciglio	马蒂亚·德西利奥
San Gejtanu	聖嘉耶當
UEFA Europa League 2012–13	2012–13年歐洲聯賽
Ameridelphia	美洲有袋類
Marsaxlokk FC	马尔萨什洛克足球俱乐部
Servizz Awstrijak barra l-pajjiż	奥地利国外服务
Pangolin Ġgant	大穿山甲
Lamantin Afrikan	西非海牛
Deloitte Football Money League	德勤足球俱樂部財富排名榜
Congratulations (Eurovision)	欧洲歌唱大赛50周年庆典
Serbja fil-Festival tal-Eurovision	塞尔维亚在欧洲歌唱大赛之历年表现
Assoċjazzjoni tal-Futbol Albaniż	阿爾巴尼亞足球協會
Lista ta' vulkani fl-Italja	義大利火山列表
Fenek ta' denbu qotni tal-Ingilterra l-Ġdida	新英格蘭棉尾兔
Innu tal-Emirati Għarab Magħquda	祖国万岁 (阿联酋)
Università ta' Malta	马耳他大学
Facundo Roncaglia	法昆多·隆卡里亚
Owen Hargreaves	欧文·哈格里夫斯
Elvedin Džinić	埃爾韋丁·季尼奇
Papa Franġisku	方濟各 (教宗)
Lamantin Amazoniku	亚马逊海牛
SV Ried	列特足球俱樂部
Fabio Coltorti	法比奥·科尔托蒂
Frederick Russell Burnham	弗雷德里克·羅素·伯納姆
Il-Ktieb ta' Mormon	摩爾門經
Prospero Grech	普罗斯珀·格雷奇
Víctor Fernández	域陀·費南迪斯
It-Twerżiqa	吶喊 (繪畫)
Euarchontoglires	靈長總目
Paramore	帕拉莫尔
Ħal Luqa	盧加 (馬耳他)
Klabb tal-futbol	足球俱乐部
Grupp B tal-Kampjonati Ewropej tal-Futbol 2008	2008年歐洲足球錦標賽B組
Pangolin ta' Temminck	南非穿山甲
Coritiba Foot Ball Club	科里蒂巴足球俱乐部
Ajruport Internazzjonali ta' Tan Son Nhat	新山一國際機場
Nani	蘭尼
Edwin van der Sar	埃德文·范德萨
Paolo Maldini	保罗·马尔蒂尼
Loreen	羅琳 (歌手)
Gonzalo Higuaín	冈萨洛·伊瓜因
Tim nazzjonali tal-futbol tat-Turkija	土耳其國家足球隊
Tim nazzjonali tal-futbol tar-Repubblika Ċeka	捷克國家足球隊
Tomasz Kuszczak	湯馬士·古斯錫
Anderson Luís de Abreu Oliveira	安德森·路易斯·迪·阿布努·奧利維拉
UEFA Champions League 2011–12	2011–12年歐洲冠軍聯賽
Charles Manson	查尔斯·曼森
UEFA Champions League 2012–13	2012–13年歐洲冠軍聯賽
Arda Turan	阿尔达·图兰
Oġġett (filosofija)	客體
RAEC Mons	RAEC蒙斯
Renault Samsung Motors	雷諾三星汽車
Galatasaray SK	加拉塔沙雷體育會足球隊
Linosa	利诺萨岛
Tazza tad-Dinja tal-Futbol tal-Klabbs 2005	2005年世界冠軍球會盃
Tazza tad-Dinja tal-Futbol tal-Klabbs 2000	2000年世界冠軍球會盃
Waasland-Beveren	華斯蘭德貝弗倫足球俱樂部
Liebru ta' Yarkand	塔里木兔
Kwalifikazzjoni għat-Tazza tad-Dinja tal-Futbol 2010 (CONMEBOL)	2010年世界盃外圍賽 (南美洲區)
KS Bylis Ballsh	拜利斯體育會
Liebru ta' Granada	格拉纳达野兔
Felipe Santana	菲臘比·辛坦拿
Ronaldo	罗纳尔多
Kwalifikazzjoni għall-Kampjonati Ewropej tal-Futbol 2012 - Grupp Ċ	2012年歐洲國家盃外圍賽C組
Kaká	卡卡
FC Shakhtyor Salihorsk	索利戈爾斯克礦工足球俱樂部
Wied il-Għajn (Marsaskala)	馬爾薩斯卡拉
Pika ta' Ladak	拉达克鼠兔
Planigale	侏袋鼬属
Rivalità bejn Liverpool FC u Manchester United FC	利曼大戰
FK Leotar	萊奧塔爾足球俱樂部
FC Neman Grodno	格羅德諾足球俱樂部
Rumanija fil-Festival tal-Eurovision	羅馬尼亞在歐洲歌唱大賽之歷年表現
Finali tal-UEFA Champions League 2013	2013年歐洲冠軍聯賽決賽
Ipertensjoni	張力亢進
Lista tal-kodiċi nazzjonali tal-FIFA	国际足联国家代码列表
Dun Karm Psaila	敦·卡姆·普塞拉
Liebru sufi	高原兔
Tupaja tal-Filippini	菲律賓樹鼩
Tupaja ta' Madras	南印樹鼩
FC Mika	米卡足球俱乐部
Santa Venera	聖韋內拉
Partit Nazzjonalista (Malta)	国民党 (马耳他)
FC Minsk	明斯克足球俱樂部
Coccinella	瓢蟲屬
Super Cup Ewropea 2013	2013年歐洲超級盃
Librerija ta' Klassijiet Bażi	基础类库
FC Encamp	恩坎普足球俱乐部
Kon-Katidral ta' San Ġwann	圣若望副主教座堂 (瓦莱塔)
FIFA Puskás Award	国际足联普斯卡什奖
Folivoru	食叶动物
KV Kortrijk	科爾特里克足球俱樂部
Wikipedija:Abbrevjazzjoni	Wikipedia:捷徑
Australidelphia	澳洲有袋总目
Gżira (lokalità)	格齊拉
UE Sant Julià	辛特祖利亞體育聯盟
The Kite Runner	追風箏的孩子
Fenek ta' Bunyoro	中非兔
Leġjun ta' Marija	圣母军
Qerda tal-innoċenti	諸聖嬰孩殉道慶日
Beerschot AC	比尔肖特足球俱乐部
Gianpaolo Bellini	詹保羅·貝利尼
Pika ħamra tat-Turkestan	红鼠兔
Japok	蹼足负鼠属
Glires	啮齿动物
Cinco de Mayo	五月五日节
Litwanja fil-Festival tal-Eurovision	立陶宛在欧洲歌唱大赛之历年表现
Shirak FC	希拉克足球俱乐部
Fenek tal-vulkan	火山兔
San Ġiljan (lokalità)	聖朱利安斯
Ouija Board	通靈板
Iqbal Masih	伊克巴勒·馬西
San Franġisk t'Assisi	亞西西的方濟各
Tim nazzjonali tal-futbol tal-Italja	意大利國家足球隊
Daknamstadion	达克纳姆体育场
European Border Breakers Awards	欧洲跨国界音乐奖
Pietà Hotspurs FC	皮埃塔热刺足球俱乐部
Partit Laburista (Malta)	工黨 (馬爾他)
Pronolagus	红兔属
Trzebinia	切比尼亞
Fenek ta' Amami	琉球兔
Opossum tal-Patagonja	草地负鼠属
Wolfsberger AC	沃爾夫斯貝格足球俱樂部
SV Grödig	格勒迪希足球俱樂部
FC Admira Wacker Mödling	阿德米拉足球俱乐部
FC Lusitanos	卢西塔诺斯足球俱乐部
Cartoon Network	卡通頻道
De facto	De facto
Lista ta' pajjiżi skont il-popolazzjoni	国家人口列表
Klad	演化支
Kaptan (futbol)	隊長 (足球)
Kunsilli lokali ta' Malta	马耳他行政区划
Kwalifikazzjoni għall-Kampjonati Ewropej tal-Futbol 2012 - Grupp B	2012年歐洲國家盃外圍賽B組
Grupp Ċ tal-Kampjonati Ewropej tal-Futbol 2008	2008年歐洲足球錦標賽C組
Tim nazzjonali tal-futbol tal-Komunità tal-Istati Indipendenti	獨聯體國家足球隊
Kwalifikazzjoni għall-Kampjonati Ewropej tal-Futbol 2012 - Grupp A	2012年歐洲國家盃外圍賽A組
Lierse SK	利尔斯SK
Tim nazzjonali tal-futbol tar-Russja	俄羅斯國家足球隊
FC Gomel	高美爾足球俱樂部
Floriana FC	弗罗瑞安娜足球俱乐部
Euarchonta	灵长动物
Assoċjazzjoni tal-Futbol ta' Malta	馬爾他足球協會
Kwalifikazzjoni għall-Kampjonati Ewropej tal-Futbol 2012 - Grupp Ħ	2012年歐洲國家盃外圍賽H組
Ester	以斯帖
Cobh	科芙
Fażi tal-gruppi tal-UEFA Champions League 2012–13	2012/13賽季歐洲冠軍聯賽分組賽
Rhynchocyon	东非象鼩属
Ħal Tarxien	塔爾欣
Tupaja ta' denbu pinna	筆尾樹鼩
Liebru ta' Kap	草兔
Fenek ta' denbu qotni	棉尾兔属
Kwalifikazzjoni għall-Kampjonati Ewropej tal-Futbol 2012 - Grupp Ġ	2012年歐洲國家盃外圍賽G組
Birgu	比尔古
Rabat (Għawdex)	維多利亞 (哥佐島)
Pangolin tas-siġar	树穿山甲
Kwalifikazzjoni għall-Kampjonati Ewropej tal-Futbol 2012 - Grupp I	2012年歐洲國家盃外圍賽I組
Kwalifikazzjoni għall-Kampjonati Ewropej tal-Futbol 2012 - Grupp F	2012年歐洲國家盃外圍賽F組
Kwalifikazzjoni għall-Kampjonati Ewropej tal-Futbol 2012 - Grupp E	2012年歐洲國家盃外圍賽E組
Kwalifikazzjoni għall-Kampjonati Ewropej tal-Futbol 2012 - Grupp D	2012年歐洲國家盃外圍賽D組
Finali tal-Kampjonati Ewropej tal-Futbol 2008	2008年歐洲足球錦標賽決賽
Pangolin Indjan	印度穿山甲
Mellieħa	梅利哈
FC Belshina Bobruisk	博布魯伊斯克足球俱樂部
FC Torpedo-BelAZ Zhodino	若基諾魚雷足球俱樂部
Bormla	科斯皮夸
Varjetà (botanika)	變種 (植物學)
FK Olimpic	奧林匹克薩拉熱窩足球俱樂部
FC Brest	布列斯特迪納摩足球俱樂部
Tupaja tal-muntanji	山地树鼩
Fenek ta' denbu qotni tal-Lvant	東部棉尾兔
Tim nazzjonali tal-futbol ta' Malta ta' taħt il-21 sena	馬爾他21歲以下國家足球隊
President ta' Malta	马耳他总统
Festa della Repubblica	義大利共和國日
Birkirkara FC	比尔基尔卡拉足球俱乐部
Dendrogale	細尾樹鼩屬
Familja Bernoulli	伯努利家族
Lista ta' timijiet nazzjonali tal-futbol tal-irġiel	國家足球隊列表
Grupp B tat-Tazza tad-Dinja tal-Futbol 2006	2006年世界盃足球賽決賽週 - B組
Lingwa Awżiljari Internazzjonali	国际辅助语
Dugongidae	儒艮科
FC Naftan Novopolotsk	新波洛茨克足球俱樂部
Lista ta' lingwi uffiċjali	官方语言列表
It-Tripletta	三冠王 (足球)
Partizani Tirana	地拉那遊擊隊足球俱樂部
Raħal Ġdid	保拉 (馬耳他)
L-Isla	森格萊阿
East Asian Football Federation	東亞足球協會
Liebru ta' Burma	緬甸野兔
Fenek ta' denbu qotni tal-foresta	森林兔
Borussia Dortmund II	多特蒙德二队
UEFA Jubilee Awards	欧洲足联五十周年纪念奖
Lemma ta’ Borel-Cantelli	波莱尔－坎泰利引理
Transnistrija	德涅斯特河沿岸
Nesolagus	苏门答腊兔属
Għajnuna:Kontenut	Help:目录
Għajnuna:Gwida essenzjali	Wikipedia:新手入門/參與
Oud-Heverlee Leuven	奧哈瓦里足球俱樂部
Logħob tal-Pajjiżi ż-Żgħar tal-Ewropa	歐洲小國運動會
UE Engordany	英奧達尼聯育聯盟
Siġġiewi	錫傑維
Pika ta' Moupin	藏鼠兔
Hibernians FC	希伯尼安斯足球俱乐部
Sarcophilus	袋獾屬
Joseph Muscat	约瑟夫·穆斯卡特
Stade Maurice Dufrasne	莫里斯-杜法臣體育場
Michael Essien	迈克尔·埃辛
FC Bayern Munich II	拜仁慕尼黑足球俱乐部二队
FC Red Bull Salzburg	薩爾斯堡紅牛足球俱樂部
Opossum ta' denbu sufi	雅负鼠属
Pika ta' Sardinja	意大利鼠兔
Markapaġna	書籤
Statistika tat-Tazza tad-Dinja tal-Futbol 2010	2010年世界盃足球賽統計
Opossum bugeddum ta' mnieħru twil	智利袋鼠
Liebru Ċiniż	华南兔
Jum il-Ħelsien (Malta)	自由日 (马耳他)
Cynocephalus volans	鼯猴
Laurent Ciman	洛朗·西曼
Senġi ta' wiċċu griż	灰臉象尖鼠
Luttu nazzjonali	全国哀悼日
Apolonia Fier	阿普朗尼亞足球會
Liverpool FC	利物浦足球俱乐部
FIFPro	國際職業足球員協會
Djalett Grieg-Kalabriż	希腊-卡拉布里亚方言
Stade du Pays de Charleroi	沙勒罗瓦球场
Subphylum	亚门
West Asian Football Federation	西亚足球协会
FC Slavia-Mozyr	斯拉維亞莫茲里足球俱樂部
Pika ta' Daurian	达乌尔鼠兔
Merlin (serje televiżiva)	梅林传奇
Tupaiidae	樹鼩科
Wikipedija:Ambaxxata	Wikipedia:大使館
Lutreolina	粗尾负鼠属
Kampjonat tal-futbol Ingliż 1888-89	1888年至1889年英格兰足球联赛
Philander	林负鼠属
Sliema Wanderers FC	斯利马流浪者足球俱乐部
Liebru ta' Yunnan	雲南兔
Senġi ta' taħt dahru dehebi	黄臀象鼩
KS Kastrioti	卡斯特里堤體育會
Pangolin ta' Palaw	菲律宾穿山甲
Opossum bugeddum Peruvjan	秘鲁鼩负鼠
FK Tomori Berat	湯瑪利足球會
Shkumbini Peqin	薩克比尼
Cohesion	內聚性 (計算機科學)
Ekonomija ta' Malta	馬耳他經濟
Liebru ta' Hainan	海南兔
Candies (grupp)	糖果合唱團
Pika tax-xofftejn suwed	高原鼠兔
Palazz tal-Gran Mastru	大教长宫 (瓦莱塔)
FK Rudar Prijedor	普里耶多爾礦工足球俱樂部
Wikipedija:Glossarju	Wikipedia:术语表
Opossum ġurdien ta' denbu oħxon	鼠负鼠属
Kategorija:Ġermanja	Category:德国
Kategorija:Italja	Category:意大利
Kategorija:Stati Uniti	Category:美国
Kategorija:Russja	Category:俄罗斯
Kategorija:Renju Unit	Category:英国
Kategorija:Spanja	Category:西班牙
Kategorija:Indja	Category:印度
Kategorija:Turkija	Category:土耳其
Kategorija:New Zealand	Category:新西兰
Opossum ta' denbu qasir	短尾负鼠属
Phascolosorex	革囊袋鼬属
Kategorija:Afganistan	Category:阿富汗
Kategorija:Alġerija	Category:阿爾及利亞
Kategorija:Awstrija	Category:奧地利
Kategorija:Pajjiżi l-Baxxi	Category:荷兰
Kategorija:Niġerja	Category:奈及利亞
Kategorija:Polonja	Category:波蘭
Kategorija:Portugall	Category:葡萄牙
Kategorija:Żvizzera	Category:瑞士
Kategorija:Ukraina	Category:烏克蘭
Kategorija:Vjetnam	Category:越南
Kategorija:Fiżika	Category:物理学
Kategorija:Bijoloġija	Category:生物学
Kategorija:Kimika	Category:化学
Kategorija:Storja	Category:历史
Kategorija:Ġeografija	Category:地理
Kategorija:Arti viżiva	Category:視覺藝術
Kategorija:Reliġjon	Category:宗教
Kategorija:Sport	Category:体育
Kategorija:Xjenza	Category:科学
Kategorija:Unjoni Ewropea	Category:欧盟
Kategorija:Ċinema	Category:电影
Kategorija:Komunikazzjoni	Category:通信
Liebru Manċurjan	东北兔
Opossum sufi	绵毛负鼠属
Myoictis	纹袋鼬属
Premier League 2011–12	2011–12賽季英格蘭超級聯賽
Lista ta' ħwawar u ħxejjex aromatiċi	香草和调味品列表
Kategorija:Mietu fl-2012	Category:2012年逝世
Partit Nazzjonalista	國民黨 (消歧義)
Phascogale	帚尾袋鼩属
Ningaui	里氏袋鼬属
Mudell:Portal tmiem	Template:Box-footer
Pika ta' Glover	川西鼠兔
Pika ta' Royle	灰鼠兔
Pika ta' Pallas	蒙古鼠兔
Pika ta' Gansu	间颅鼠兔
Pika tal-widnejn kbar	大耳鼠兔
No. 5, 1948	1948年第5号
Ħin tal-Afrika tal-Lvant	東非時間
Nicklas Helenius	歷卡斯·軒倫尼斯
Juan Antonio Villacañas	胡安·安東尼奧·比亞加亞斯
Kategorija:Ekoloġija	Category:生態學
Kategorija:Diżambigwazzjoni	Category:消歧义
Kategorija:Olimpjadi	Category:奥林匹克运动会
Kategorija:Filosofija	Category:哲学
Kategorija:Psikoloġija	Category:心理学
Kategorija:Buddiżmu	Category:佛教
Kategorija:Kristjaneżmu	Category:基督教
Kategorija:Induiżmu	Category:印度教
Kategorija:Iżlam	Category:伊斯兰教
Kategorija:Ġudaiżmu	Category:犹太教
Oġġett	对象
Ronaldo (diżambigwazzjoni)	罗纳尔多 (消歧义)
Stat Iżlamiku	伊斯兰国
Malti	欠发达地区
Opossum ġurdien sufi	小尾负鼠属
Palaeolagus	古兔
Storja ta' Arsenal FC (1886–1966)	阿仙奴足球會歷史 (1886年至1966年)
Kastell ta' Rayen	瑞巖城堡
Għoti tal-penalties	互射十二碼
Parantechinus	斑袋鼬属
Orycteropodidae	土豚科
Kategorija:Abbozzi	Category:小作品
Kategorija:Pjaneti	Category:行星
Kategorija:Abbozzi tal-mużika	Category:音乐小作品
Kategorija:Abbozzi tal-kultura	Category:文化小作品
Kategorija:Kultura	Category:文化
Kategorija:Snin	Category:年
Kategorija:Xjenzi soċjali	Category:人文科學
Kategorija:Kontinenti	Category:大洲
12 Years a Slave	为奴十二年
Għajnuna:Gwida essenzjali/Editjar	Wikipedia:新手入門/編輯
Mudell:SistemaSolari	Template:太阳系
Wikipedija:Konvenzjonijiet ta' nomenklatura	Wikipedia:命名常规
Sottoġeneru	亞屬
Introduzzjoni għall-ġenetika	遗传学入门
Għajnuna:Kif tirreġistra	Help:登录
Għajnuna:Wikiketta	Wikipedia:礼仪
Kategorija:Bots tal-Wikipedija	Category:維基百科機器人
Parteċipazzjoni fil-Festival tal-Eurovision	欧洲歌唱大赛参赛国家列表
Mudell:Kwota	Template:Quote
Kategorija:Nies Taljani	Category:意大利人
Kategorija:Mużiċisti Amerikani	Category:美國音樂家
Kategorija:Futbolers Ġermaniżi	Category:德国足球运动员
Mudell:Tl	Template:Tl
Mudell:Kaxxa tal-utent	Template:Userbox
Sergio Mattarella	塞尔焦·马塔雷拉
Kategorija:Pajjiżi	Category:国家
Wikipedija:Amministraturi	Wikipedia:管理员
Kategorija:Każakistan	Category:哈萨克斯坦
Wikipedija:Amministraturi/Kandidati	Wikipedia:申请成为管理人员
Kategorija:Kategoriji skont in-nazzjonalità	Category:依國籍來作的分類
Wikipedija:Bot	Wikipedia:机器人
Kategorija:Kategoriji moħbija	Category:隐藏分类
Kategorija:Internet	Category:互联网
Kategorija:Botanika	Category:植物學
Kategorija:Politika	Category:政治
Kategorija:Arti	Category:艺术
Eġittu	埃及
Kategorija:2013	Category:2013年
Bryan Cristante	布莱恩·克里斯坦特
Mudell:Bot	Template:Bot
Kanada	加拿大
Kategorija:Ungerija	Category:匈牙利
Kategorija:Stati membri tal-Unjoni Ewropea	Category:欧盟成员国
Kategorija:Belġju	Category:比利時
Kategorija:Ċekja	Category:捷克
Kategorija:Danimarka	Category:丹麥
Kategorija:Estonja	Category:爱沙尼亚
Kategorija:Finlandja	Category:芬蘭
Kategorija:Latvja	Category:拉脫維亞
Kategorija:Iżlanda	Category:冰島
Kategorija:Litwanja	Category:立陶宛
Kategorija:Malta	Category:馬爾他
Kategorija:Żvezja	Category:瑞典
Kategorija:Slovakkja	Category:斯洛伐克
Kategorija:Slovenja	Category:斯洛維尼亞
Kategorija:Repubblika tal-Irlanda	Category:爱尔兰
Kategorija:Artikli fil-vetrina	Category:特色条目
Wikipedija:Rispons tal-esperjenza tal-utent	Wikipedia:用戶體驗反饋
Kategorija:Logħob elettroniku	Category:电子游戏
Wikipedija:Bot/Rikjesti	Wikipedia:机器人/作业请求
Mudell:Flagicon	Template:Flagicon
Kategorija:Pajjiżi tal-Ewropa	Category:欧洲国家
Kategorija:Ewropa	Category:欧洲
Kategorija:Għajnuna	Category:帮助文档
Mudell:Dokumentazzjoni	Template:Documentation
Wikipedija:Bot/Rikjesti għall-approvazzjoni	Wikipedia:机器人/申请
Kategorija:Paġni protetti	Category:被保护的页面
Wikipedija:Politika dwar il-protezzjoni	Wikipedia:保護方針
Kategorija:Paġni semi-protetti	Category:被半保护的页面
Kategorija:Wikipedjani	Category:维基人
Wikipedija:Kunsens	Wikipedia:共识
Wikipedija:L-ebda attakk personali	Wikipedia:不要人身攻击
Wikipedija:Kuntatt	Wikipedia:联络我们
Kategorija:Utenti skont il-lingwa	Category:用户语言
Kategorija:Politiki tal-Wikipedija	Category:维基百科正式方针
Wikipedija:Sondaġġi	Wikipedia:投票
Wikipedija:Firem	Wikipedia:签名
Wikipedija:Abbozz	Wikipedia:小作品
Wikipedija:Artikli rikjesti	Wikipedia:条目请求
Mudell:Softredirect	Template:軟重定向
Mudell:Ħassar minnufih	Template:Delete
Kategorija:Teknoloġija	Category:技术
Kategorija:Lingwa	Category:语言
Għajnuna:Kif tibda artiklu	Help:创建新条目
Kategorija:Wikipedija	Category:维基百科
Wikipedija:Ċaħda ġenerali	Wikipedia:免责声明
Kategorija:Paġni mhux indiċizzati	Category:不可索引页面
Wikipedija:Mudelli kollha	Wikipedia:模板消息
Kategorija:Avvenimenti kurrenti	Category:新闻动态
Wikipedija:Manwal tal-istil	Wikipedia:格式手册
Mudell:-	Template:-
Mudell:Navbox	Template:Navbox
Mudell:Abbrevjazzjoni	Template:Shortcut
Kategorija:Żoni tal-ħin	Category:時區
Kategorija:Nies ħajjin	Category:在世人物
Festival tal-Eurovision 2014	2014年歐洲歌唱大賽
Kategorija:Mudelli ta' bnadar	Category:旗帜模板
Mudell:!-	Template:!-
Mudell:!!	Template:!!
Mudell:=	Template:=
Mudell:Tnavbar	Template:Navbar
Mudell:Ċiklu	Template:Loop
Mudell:0	Template:0
Kategorija:Mudelli ta' formattjar	Category:格式模板
Mudell:Clear	Template:Clear
Mudell:Col-break	Template:Col-break
Mudell:Col-begin	Template:Col-begin
Mudell:Col-end	Template:Col-end
Mudell:Kulur	Template:Color
Mudell:Deskrizzjoni kmand	Template:Abbr
Wikipedija:Lista ta' artikli li kull Wikipedija għandu jkollha	Wikipedia:基礎條目
Kategorija:Afrika	Category:非洲
Kategorija:Elettronika	Category:電子學
Kategorija:Xhur tas-sena	Category:月份
Mudell:Wikisors	Template:Wikisource
Mudell:Babel	Template:Babel
Mudell:Commons	Template:Commons
Mudell:Link GA	Template:Link GA
Mudell:Referenzi	Template:Reflist
Kategorija:Avvenimenti sportivi kurrenti	Category:體育新聞動態
Jum il-Ħelsien	自由日
Għajnuna:Esplora lill-Wikipedija	Help:搜索
Mudell:Pajjiżi tal-Commonwealth	Template:大英國協
Mudell:Stub	Template:Stub
Mudell:Utent ar-1	Template:User ar-1
Mudell:Utent az	Template:User az
Mudell:Utent be-2	Template:User be-2
Mudell:Utent da-1	Template:User da-1
Mudell:Utent bg-1	Template:User bg-1
Mudell:Utent eo-3	Template:User eo-3
Mudell:Utent de	Template:User de
Mudell:Utent de-1	Template:User de-1
Mudell:Utent el	Template:User el
Mudell:Utent es	Template:User es
Mudell:Utent de-3	Template:User de-3
Mudell:Utent en-3	Template:User en-3
Mudell:Utent en-1	Template:User en-1
Mudell:Utent en-2	Template:User en-2
Mudell:Utent en-4	Template:User en-4
Mudell:Utent en-0	Template:User en-0
Mudell:Utent en	Template:User en
Mudell:Utent de-2	Template:User de-2
Mudell:Utent es-1	Template:User es-1
Mudell:Utent fa	Template:User fa
Mudell:Utent fr-1	Template:User fr-1
Mudell:Utent ia-2	Template:User ia-2
Mudell:Utent hr	Template:User hr
Mudell:Utent it-3	Template:User it-3
Mudell:Utent grc-1	Template:User grc-1
Mudell:Utent ja-4	Template:User ja-4
Mudell:Utent sk	Template:User sk
Mudell:Utent tr-2	Template:User tr-2
Mudell:Utent fr-2	Template:User fr-2
Mudell:Utent ja	Template:User ja
Mudell:Utent it-1	Template:User it-1
Mudell:Utent fr	Template:User fr
Mudell:Ebda firma	Template:Unsigned
Mudell:Pl	Template:Pl icon
Kategorija:Turiżmu	Category:旅游
Kategorija:1957	Category:1957年
Kategorija:1949	Category:1949年
Kategorija:1927	Category:1927年
Kategorija:1919	Category:1919年
Mudell:Dati pajjiż Taġikistan	Template:Country data Tajikistan
Kategorija:Moldova	Category:摩爾多瓦
Kategorija:Ażerbajġan	Category:亞塞拜然
Mudell:Plejers fit-tim tal-futbol/nofs	Template:Football squad mid
Kategorija:Asja	Category:亚洲
Kategorija:Ċili	Category:智利
Kategorija:Seklu 21	Category:21世纪
Kategorija:Mudelli ta' servizz	Category:維基百科維護模板
Kategorija:Utenti uk	Category:Uk 使用者
Kategorija:1930	Category:1930年
Kategorija:Utenti uk-N	Category:Uk 母語使用者
Kategorija:1936	Category:1936年
Kategorija:1947	Category:1947年
Mudell:Mudell ikkumplikat	Template:Esoteric
Kategorija:1937	Category:1937年
Kategorija:1940	Category:1940年
Kategorija:1934	Category:1934年
Kategorija:1960	Category:1960年
Kategorija:1943	Category:1943年
Kategorija:1951	Category:1951年
Mudell:Tim tal-futbol	Template:Football squad
Kategorija:1942	Category:1942年
Kategorija:1959	Category:1959年
Kategorija:1938	Category:1938年
Kategorija:1928	Category:1928年
Kategorija:1913	Category:1913年
Kategorija:1918	Category:1918年
Kategorija:1954	Category:1954年
Kategorija:1941	Category:1941年
Kategorija:1955	Category:1955年
Kategorija:1950	Category:1950年
Kategorija:1921	Category:1921年
Kategorija:1977	Category:1977年
Kategorija:1946	Category:1946年
Kategorija:1948	Category:1948年
Kategorija:1932	Category:1932年
Mudell:Plejers fit-tim tal-futbol	Template:Football squad player
Kategorija:Futbol	Category:足球
Kategorija:1945	Category:1945年
Mudell:Dati pajjiż Kuwajt	Template:Country data Kuwait
Mudell:Mod	Template:Mod
Kategorija:1923	Category:1923年
Kategorija:1935	Category:1935年
Kategorija:1910	Category:1910年
Kategorija:1917	Category:1917年
Kategorija:1904	Category:1904年
Kategorija:1926	Category:1926年
Kategorija:1907	Category:1907年
Kategorija:1914	Category:1914年
Mudell:Utent sv	Template:User sv
Kategorija:1929	Category:1929年
Kategorija:1920	Category:1920年
Mudell:Utent it	Template:User it
Kategorija:1925	Category:1925年
Mudell:Utent uk	Template:User uk
Kategorija:1905	Category:1905年
Kategorija:1915	Category:1915年
Mudell:Utent es-2	Template:User es-2
Kategorija:1908	Category:1908年
Kategorija:Mudelli ta' avviż	Category:用戶警告模板
Kategorija:1901	Category:1901年
Kategorija:1903	Category:1903年
Kategorija:1902	Category:1902年
Kategorija:1900	Category:1900年
Mudell:Ru	Template:Ru icon
Mudell:PaġnaPrinċipali/Proġetti	Template:Wikipediasister
Kategorija:1933	Category:1933年
Mudell:Dati pajjiż Belġju	Template:Country data Belgium
Kategorija:1912	Category:1912年
Kategorija:Klabbs tal-futbol Ingliżi	Category:英格蘭足球俱樂部
Mudell:Dati pajjiż Slovakkja	Template:Country data Slovakia
Kategorija:Mudelli tal-koordinati	Category:經緯模板
Kategorija:Klabbs tal-futbol Spanjoli	Category:西班牙足球俱乐部
Mudell:Dati pajjiż El Salvador	Template:Country data El Salvador
Mudell:Dati pajjiż Panama	Template:Country data Panama
Kategorija:1952	Category:1952年
Mudell:Dati pajjiż Ekwador	Template:Country data Ecuador
Mudell:Dati pajjiż Etjopja	Template:Country data Ethiopia
Mudell:Dati pajjiż Tuneżija	Template:Country data Tunisia
Mudell:Dati pajjiż Repubblika Ċeka	Template:Country data Czech Republic
Mudell:Dati pajjiż Tajlandja	Template:Country data Thailand
Mudell:Dati pajjiż Kuba	Template:Country data Cuba
Mudell:Dati pajjiż Indoneżja	Template:Country data Indonesia
Mudell:Dati pajjiż Kambodja	Template:Country data Cambodia
Mudell:Dati pajjiż Senegal	Template:Country data Senegal
Mudell:Dati pajjiż Madagaskar	Template:Country data Madagascar
Mudell:Dati pajjiż Albanija	Template:Country data Albania
Mudell:Dati pajjiż Perù	Template:Country data Peru
Mudell:Dati pajjiż Paragwaj	Template:Country data Paraguay
Mudell:Dati pajjiż Makaw	Template:Country data Macau
Mudell:Dati pajjiż Kenja	Template:Country data Kenya
Mudell:Dati pajjiż San Marino	Template:Country data San Marino
Mudell:Dati pajjiż Nikaragwa	Template:Country data Nicaragua
Mudell:Dati pajjiż Ħonduras	Template:Country data Honduras
Mudell:Dati pajjiż Użbekistan	Template:Country data Uzbekistan
Mudell:Dati pajjiż Bolivja	Template:Country data Bolivia
Mudell:Dati pajjiż Repubblika Dominikana	Template:Country data Dominican Republic
Mudell:Dati pajjiż Liechtenstein	Template:Country data Liechtenstein
Mudell:Dati pajjiż Togo	Template:Country data Togo
Mudell:Dati pajjiż Gwatemala	Template:Country data Guatemala
Kategorija:Klabbs tal-futbol Ġermaniżi	Category:德國足球俱樂部
Kategorija:Lingwistika	Category:语言学
Mudell:Dati pajjiż Ħaiti	Template:Country data Haiti
Mudell:Dati pajjiż Mali	Template:Country data Mali
Mudell:Dati pajjiż Latvja	Template:Country data Latvia
Mudell:Football kit	Template:Football kit
Mudell:Dati pajjiż Malta	Template:Country data Malta
Mudell:Dati pajjiż Monako	Template:Country data Monaco
Mudell:Dati pajjiż Danimarka	Template:Country data Denmark
Mudell:Dati pajjiż Iżlanda	Template:Country data Iceland
Mudell:Dati pajjiż Polonja	Template:Country data Poland
Kategorija:1911	Category:1911年
Kategorija:1922	Category:1922年
Kategorija:1924	Category:1924年
Mudell:Dati pajjiż Bulgarija	Template:Country data Bulgaria
Kategorija:1906	Category:1906年
Mudell:Dati pajjiż Bosnja-Ħerzegovina	Template:Country data Bosnia and Herzegovina
Kategorija:Klabbs tal-futbol	Category:足球俱乐部
Mudell:Dati pajjiż Gujana	Template:Country data Guyana
Kategorija:Mudelli tal-futbol	Category:足球模板
Kategorija:Utenti fr-1	Category:Fr-1 使用者
Mudell:Dati pajjiż Norveġja	Template:Country data Norway
Mudell:Dati pajjiż Afrika t'Isfel	Template:Country data South Africa
Mudell:Dati pajjiż Ġamajka	Template:Country data Jamaica
Mudell:Dati pajjiż Ġeorġja	Template:Country data Georgia
Mudell:Dati pajjiż Arġentina	Template:Country data Argentina
Mudell:Dati pajjiż Urugwaj	Template:Country data Uruguay
Mudell:Wikiquote	Template:Wikiquote
Mudell:Dati pajjiż Trinidad u Tobago	Template:Country data Trinidad and Tobago
Kategorija:Innijiet Nazzjonali	Category:国歌
Mudell:Dati pajjiż Brunej	Template:Country data Brunei
Mudell:Dati pajjiż Sri Lanka	Template:Country data Sri Lanka
Mudell:Dati pajjiż Messiku	Template:Country data Mexico
Mudell:Dati pajjiż Greċja	Template:Country data Greece
Mudell:Dati pajjiż Lussemburgu	Template:Country data Luxembourg
Mudell:Infobox Kumpanija Dotcom	Template:Infobox dot-com company
Mudell:Dati pajjiż Arabja Sawdija	Template:Country data Saudi Arabia
Mudell:Dati pajjiż Baħamas	Template:Country data Bahamas
Mudell:Dati pajjiż Kroazja	Template:Country data Croatia
Mudell:Afrika	Template:Africa
Mudell:Edizzjoni Olimpika	Template:Infobox Olympics
Mudell:Dati pajjiż Emirati Għarab Magħquda	Template:Country data United Arab Emirates
Mudell:Wikimedia	Template:维基媒体项目
Mudell:Infobox artist mużikali	Template:Infobox musical artist
Mudell:Dati pajjiż Gżejjer Verġni Amerikani	Template:Country data U.S. Virgin Islands
Mudell:Dati pajjiż Marokk	Template:Country data Morocco
Mudell:Dati pajjiż Serbja	Template:Country data Serbia
Mudell:Dati pajjiż Awstralja	Template:Country data Australia
Mudell:WIP	Template:Inuse
Mudell:Es	Template:Es icon
Mudell:Dati pajjiż Franza	Template:Country data France
Mudell:Ambox	Template:Ambox
Mudell:Għall-aġġornament	Template:更新
Mudell:Cs	Template:Cs icon
Mudell:Infobox Pajjiż	Template:國家基礎資訊
Mudell:Mas	Template:Max
Mudell:Dati pajjiż Laos	Template:Country data Laos
Mudell:Fi	Template:Fi icon
Mudell:Stampa kbira	Template:Wide image
Mudell:Dati pajjiż Awstrija	Template:Country data Austria
Mudell:Dati pajjiż Nepal	Template:Country data Nepal
Mudell:Sar	Template:完成
Mudell:Dati pajjiż Finlandja	Template:Country data Finland
Mudell:Awdjo	Template:Audio
Mudell:Dati pajjiż Eġittu	Template:Country data Egypt
Mudell:Dati pajjiż Litwanja	Template:Country data Lithuania
Għajnuna:Gwida essenzjali/Ħoloq	Wikipedia:新手入門/維基文本
Kategorija:Timijiet nazzjonali tal-futbol Ewropej	Category:歐洲國家足球隊
Mudell:Dati pajjiż Ġappun	Template:Country data Japan
Mudell:Sezzjoni-stub	Template:Expand section
Mudell:Dati pajjiż Pajjiżi l-Baxxi	Template:Country data Netherlands
Mudell:Tmbox	Template:Tmbox
Mudell:Navbox with columns	Template:Navbox with columns
Mudell:Kaxxa tal-bidu	Template:Start
Mudell:Klassifikazzjoni Tassonomika Obligatorja	Template:Taxonomic ranks
Mudell:Politika	Template:Policy
Mudell:Facebook	Template:Facebook
Mudell:Dati pajjiż Ażerbajġan	Template:Country data Azerbaijan
Mudell:Dablink	Template:Dablink
Mudell:Dati pajjiż Ċekoslovakkja	Template:Country data Czechoslovakia
Mudell:Dati pajjiż Vjetnam	Template:Country data Vietnam
Mudell:Vetrina	Template:Featured article
Mudell:Dati pajjiż Libja	Template:Country data Libya
Mudell:Dati pajjiż Russja	Template:Country data Russia
Mudell:Round4	Template:Round4
Mudell:Portal bidu	Template:Box-header
Kategorija:Utenti en-4	Category:En-4 使用者
Kategorija:Utenti en	Category:En 使用者
Kategorija:Utenti zh	Category:Zh 使用者
Kategorija:Kroazja	Category:克罗地亚
Kategorija:Utenti zh-N	Category:Zh 母语使用者
Kategorija:Utenti en-2	Category:En-2 使用者
Mudell:TOCright	Template:TOCright
Mudell:Żmien utent Wikipedija	Template:User Wikipedian For
Kategorija:Mietu fl-1902	Category:1902年逝世
Mudell:Utent zh	Template:User zh
Mudell:Infobox Tim nazzjonali tal-futbol	Template:Infobox 國家足球代表隊
Mudell:Leġenda	Template:Legend
Mudell:Ċita web	Template:Cite web
Mudell:Dati pajjiż Italja	Template:Country data Italy
Kategorija:Unuri tal-futbol	Category:足球獎項
Mudell:Ombox	Template:Ombox
Mudell:Lx	Template:Lx
Mudell:Dati pajjiż	Template:Country data
Mudell:Futbol internazzjonali	Template:國際足球
Kategorija:Kċina	Category:飲食
Mudell:Coor URL	Template:MapsServer
Mudell:Pp-mudell	Template:Pp-template
Mudell:Min	Template:Min
Mudell:Subon	Template:Subon
Mudell:Wikizzjunarju	Template:Wiktionary
Mudell:Utent nl-2	Template:User nl-2
Mudell:Dati pajjiż Żvezja	Template:Country data Sweden
Kategorija:Terminoloġija tal-futbol	Category:足球術語
Mudell:Bar box	Template:Bar box
Mudell:Languageicon	Template:Language icon
Kategorija:Agrikoltura	Category:农业
Kategorija:Utenti hi	Category:Hi 使用者
Kategorija:Seklu 20	Category:20世纪
Kategorija:Politiċi	Category:政治人物
Kategorija:Amerika	Category:美洲
Mudell:Użioħra	Template:Otheruses
Mudell:Dati pajjiż Kosta Rika	Template:Country data Costa Rica
Mudell:Dati pajjiż Unjoni Sovjetika	Template:Country data Soviet Union
Mudell:Dati pajjiż Indja	Template:Country data India
Kategorija:Bliet tal-Marokk	Category:摩洛哥城市
Mudell:Imbox	Template:Imbox
Mudell:Data tat-twelid u età	Template:Birth date and age
Mudell:Dati pajjiż Alġerija	Template:Country data Algeria
Mudell:Clade	Template:Clade
Mudell:ISEMXAHAR	Template:MONTHNAME
Mudell:Rindirizzament kategorija	Template:分类重定向
Mudell:Dati pajjiż Veneżwela	Template:Country data Venezuela
Mudell:Infobox Kariga pubblika	Template:Infobox Officeholder
Mudell:Proġetti oħra	Template:Sister project links
Mudell:Sortname	Template:Sortname
Mudell:Dati pajjiż Andorra	Template:Country data Andorra
Mudell:Dati pajjiż Angola	Template:Country data Angola
Mudell:Dati pajjiż Botswana	Template:Country data Botswana
Mudell:Dati pajjiż Unjoni Ewropea	Template:Country data European Union
Mudell:Dati pajjiż Portugall	Template:Country data Portugal
Mudell:Data tal-mewt u età	Template:Death date and age
Kategorija:Twieldu fl-1879	Category:1879年出生
Mudell:NUMRUXAHAR	Template:MONTHNUMBER
Kategorija:Abbozzi ta' bijografiji	Category:人物小作品
Mudell:Sport fil-futur	Template:Future sport
Mudell:Dati pajjiż Belt tal-Vatikan	Template:Country data Vatican City
Kategorija:Twieldu fl-1955	Category:1955年出生
Mudell:Ikoni tat-titlu	Template:Topicon
Kategorija:Twieldu fl-1963	Category:1963年出生
Mudell:Kulur taxobox	Template:Taxobox colour
Kategorija:Mudelli ta' dati tal-pajjiżi	Category:国家资料模板
Kategorija:Twieldu fl-1817	Category:1817年出生
Kategorija:Twieldu fl-1998	Category:1998年出生
Mudell:Dati pajjiż Ċina	Template:Country data China
Mudell:Dati pajjiż Benin	Template:Country data Benin
Mudell:Wikifikazzjoni	Template:Wikify
Mudell:Dati pajjiż Ingilterra	Template:Country data England
Kategorija:Seklu 19	Category:19世纪
Mudell:Dati pajjiż Repubblika tal-Irlanda	Template:Country data Republic of Ireland
Mudell:Dati pajjiż Turkija	Template:Country data Turkey
Kategorija:Kittieba	Category:作家
Mudell:PD-Italja	Template:PD-Italy
Mudell:Yel	Template:Yel
Mudell:Dati pajjiż Ċipru	Template:Country data Cyprus
Mudell:Dati pajjiż Żvizzera	Template:Country data Switzerland
Mudell:Dati pajjiż Filippini	Template:Country data Philippines
Mudell:Dati pajjiż Niġerja	Template:Country data Nigeria
Mudell:Dati pajjiż Belarus	Template:Country data Belarus
Mudell:Dati pajjiż Malażja	Template:Country data Malaysia
Mudell:Dati pajjiż Armenja	Template:Country data Armenia
Mudell:Dati pajjiż Żimbabwe	Template:Country data Zimbabwe
Mudell:Dati pajjiż Timor tal-Lvant	Template:Country data East Timor
Mudell:Tim ta' AC Milan	Template:AC米兰球员名单
Mudell:Dati pajjiż Aramea	Template:Country data Aramean Syriac
Mudell:Dati pajjiż Tajwan	Template:Country data Taiwan
Mudell:Dati pajjiż Vjetnam t'Isfel	Template:Country data South Vietnam
Mudell:Dati pajjiż Każakistan	Template:Country data Kazakhstan
Mudell:Dati pajjiż Ċili	Template:Country data Chile
Mudell:Dati pajjiż Slovenja	Template:Country data Slovenia
Mudell:Dati pajjiż Libanu	Template:Country data Lebanon
Mudell:Dati pajjiż Tajpej Ċiniżi	Template:Country data Chinese Taipei
Mudell:Dati pajjiż Butan	Template:Country data Bhutan
Mudell:Nat fs g start	Template:Nat fs g start
Mudell:Utent pt-1	Template:User pt-1
Kategorija:1931	Category:1931年
Kategorija:1958	Category:1958年
Kategorija:1956	Category:1956年
Kategorija:1944	Category:1944年
Kategorija:Jiem ta' Jannar	Category:1月
Kategorija:1916	Category:1916年
Kategorija:1939	Category:1939年
Mudell:Tavla Perjodika kumpatta	Template:元素週期表
Kategorija:1909	Category:1909年
Kategorija:Klabbs tal-futbol Taljani	Category:意大利足球俱樂部
Mudell:Tazza tad-Dinja tal-Futbol tal-Klabbs	Template:世界冠軍球會盃
Kategorija:Mietu fl-1221	Category:1221年逝世
Mudell:Utent no-2	Template:User no-2
Mudell:Kategorijamoħbija	Template:Hidden category
Mudell:Klassifika tal-futbol	Template:Fb cl team
Mudell:Dokumentazzjoni mudell	Template:Documentation subpage
Mudell:Bundesliga	Template:德甲球隊
Mudell:CcTLD	Template:CcTLD
Mudell:Div col	Template:Div col
Mudell:Klassifikazzjoni	Template:Rating
Kategorija:Pittura	Category:繪畫
Mudell:Div col end	Template:Div col end
Mudell:TħassirKategorija	Template:Empty category
Kategorija:Pajjiżi mhux rikonoxxuti	Category:未被国际普遍承认的国家
Mudell:'	Template:'
Mudell:Goal	Template:Goal
Mudell:Paġna utent	Template:Userpage
Mudell:Bandierapajjiż2	Template:Flag/core
Mudell:Logo	Template:Non-free logo
Kategorija:UEFA Europa League	Category:欧洲联盟杯
Mudell:Infobox Album	Template:Infobox Album
Mudell:Utent	Template:User
Mudell:Tazza tad-Dinja tal-Klabbs Rawnd 8	Template:ClubWCRound8
Kategorija:Ajruporti fil-Vjetnam	Category:越南機場
Mudell:Logħba futbol	Template:Footballbox
Mudell:Emerġenza-buttuna-tifi	Template:Emergency-bot-shutoff
Mudell:Imdb	Template:Imdb name
Kategorija:Tuneżija	Category:突尼西亞
Mudell:Futbol internazzjonali tal-klabbs	Template:國際足球俱樂部
Mudell:It	Template:It icon
Mudell:Infobox Stadju	Template:Infobox 體育場館
Mudell:Wikibarijiet	Template:Wikinews
Mudell:Cmbox	Template:Cmbox
Mudell:Rindirizz	Template:Redirect
Mudell:TwoLegStart	Template:TwoLeg start
Mudell:Pajjiżi fil-Logħob Olimpiku tas-Sajf 2008	Template:NOCin2008SummerOlympics
Mudell:Kontra	Template:Oppose
Mudell:Coord/link	Template:Coord/link
Mudell:LTU	Template:LTU
Mudell:Utent SUL	Template:SUL Box
Kategorija:Utenti ja-N	Category:Ja 母语使用者
Kategorija:Futbolers Belġjani	Category:比利時足球運動員
Kategorija:Futbolers Sloveni	Category:斯洛文尼亞足球運動員
Mudell:Kwantitajiet Ta' Bit	Template:比特单位
Kategorija:Artikli kandidati għall-vetrina tal-Wikipedija	Category:特色條目候選
Mudell:Pdf	Template:PDFlink
Mudell:Dati pajjiż Ġermanja tal-Punent	Template:Country data West Germany
Mudell:Dati pajjiż Ġermanja tal-Lvant	Template:Country data East Germany
Kategorija:Twieldu fl-1903	Category:1903年出生
Kategorija:Imperi	Category:帝國
Kategorija:Twieldu fl-1925	Category:1925年出生
Kategorija:Twieldu fl-1936	Category:1936年出生
Kategorija:Twieldu fl-1916	Category:1916年出生
Kategorija:Twieldu fl-1910	Category:1910年出生
Kategorija:Twieldu fl-1939	Category:1939年出生
Mudell:Siġra ġenealoġika/bidu	Template:Familytree/start
Mudell:Diżambigwazzjoni	Template:Disambig
Kategorija:1962	Category:1962年
Mudell:Pt	Template:Pt icon
Mudell:Dati pajjiż Ħong Kong	Template:Country data Hong Kong
Mudell:Ma sarx	Template:未完成
Mudell:QasamKat	Template:Category diffuse
Mudell:Uk	Template:Uk icon
Kategorija:Mudelli infobox	Category:信息框模板
Mudell:Penmiss	Template:Penmiss
Kategorija:Real Madrid CF	Category:皇家马德里足球俱乐部
Kategorija:Storja ta' l-isport	Category:体育史
Mudell:Dati pajjiż Żajr	Template:Country data Zaire
Mudell:Dati pajjiż Imperu Ġermaniż	Template:Country data German Empire
Kategorija:Futbol fi Spanja	Category:西班牙足球
Mudell:Pengoal	Template:Pengoal
Kategorija:Mietu fl-2013	Category:2013年逝世
Mudell:Dati pajjiż Krimea	Template:Country data Crimea
Mudell:Fb	Template:Fb
Kategorija:Twieldu fl-1938	Category:1938年出生
Kategorija:Meta-mudelli tal-Wikipedija	Category:维基百科元模板
Mudell:Utent no-3	Template:User no-3
Mudell:Annotazzjoni	Template:Annotation
Mudell:Dati pajjiż Gżira tal-Milied	Template:Country data Christmas Island
Mudell:Dati pajjiż Imperu Ottoman	Template:Country data Ottoman Empire
Kategorija:Mudelli ta' ikoni tal-lingwi	Category:语言模板
Mudell:Infobox Filosfu	Template:Infobox philosopher
Mudell:Hy	Template:Hy icon
Kategorija:Teoloġija	Category:神學
Mudell:Infobox Organizzazzjoni	Template:Infobox Organization
Robin Stjernberg	羅賓·胡溫貝里
Kategorija:1663	Category:1663年
Kategorija:Mietu fl-1663	Category:1663年逝世
Mudell:Hr	Template:Hr icon
Mudell:Tr	Template:Tr icon
Mudell:Az	Template:Az icon
Kategorija:Arkitettura	Category:建筑
Mudell:Nl	Template:Nl icon
Mudell:NATO	Template:北大西洋公約組織
Mudell:Dati pajjiż Qatar	Template:Country data Qatar
Mudell:Utent it-2	Template:User it-2
Mudell:De	Template:De icon
Kategorija:Bliet tal-Italja	Category:意大利自治市
Mudell:Età	Template:Age
Mudell:Għoti tal-penalties	Template:Penshootoutbox
Mudell:Bliet kapitali tal-UE	Template:欧盟首都城市
Mudell:Infobox Ċelebrità	Template:Infobox person
Mudell:La	Template:La
Mudell:Dati pajjiż Iżrael	Template:Country data Israel
Kategorija:1953	Category:1953年
Mudell:Tim ta' AS Roma	Template:羅馬球員名單
Mudell:Lista ta' kapitali Ewropej skont ir-reġjun	Template:歐洲各國及其首都
Mudell:Dati pajjiż Ukraina	Template:Country data Ukraine
Mudell:Dati pajjiż Kolombja	Template:Country data Colombia
Mudell:Dati pajjiż Pakistan	Template:Country data Pakistan
Mudell:Dati pajjiż Gana	Template:Country data Ghana
Mudell:Dati pajjiż Rumanija	Template:Country data Romania
Mudell:Dati pajjiż Korea t'Isfel	Template:Country data South Korea
Kategorija:Maltin skont ix-xogħol tagħhom	Category:各职业马耳他人
Mudell:Sr	Template:Sr icon
Mudell:Coord	Template:Coord
Kategorija:Twieldu fis-seklu 20	Category:20世纪出生
Kategorija:Twieldu fis-seklu 19	Category:19世纪出生
Kategorija:Twieldu fis-seklu 21	Category:21世纪出生
Kategorija:Twieldu fis-seklu 18	Category:18世纪出生
Kategorija:Twieldu fis-seklu 17	Category:17世纪出生
Kategorija:Twieldu fis-seklu 16	Category:16世纪出生
Kategorija:Twieldu fis-seklu 15	Category:15世纪出生
Kategorija:Mudelli tal-klabbs tal-futbol Franċiżi	Category:法国足球俱乐部名单模板
Kategorija:FIFA	Category:国际足球联合会
Kategorija:Timijiet nazzjonali tal-futbol Oċeaniċi	Category:大洋洲国家足球队
Mudell:Dati pajjiż Boemja	Template:Country data Bohemia
Kategorija:Futbolers Ivorjani	Category:科特迪瓦足球運動員
Mudell:Timijiet nazzjonali tal-CAF	Template:非洲足球協會國家足球代表隊
Mudell:Utent bg	Template:User bg
Mudell:Dati pajjiż Baħrejn	Template:Country data Bahrain
Kategorija:Mietu fl-1622	Category:1622年逝世
Mudell:Ewropa	Template:Europe
Kategorija:Futbolers skont in-nazzjonalità	Category:各国足球运动员
Kategorija:Utenti yue	Category:Zh-yue 使用者
Kategorija:Utenti az	Category:Az 使用者
Kategorija:Utenti be	Category:Be 使用者
Kategorija:Utenti hr	Category:Hr 使用者
Kategorija:Utenti eo	Category:Eo 使用者
Kategorija:Utenti fr	Category:Fr 使用者
Kategorija:Utenti cy	Category:Cy 使用者
Kategorija:Utenti id	Category:Id 使用者
Kategorija:Utenti ga	Category:Ga 使用者
Kategorija:Utenti ja	Category:Ja 使用者
Kategorija:Utenti nn	Category:Nn 使用者
Kategorija:Utenti pt	Category:Pt 使用者
Kategorija:Utenti scn	Category:Scn 使用者
Kategorija:Utenti sv	Category:Sv 使用者
Kategorija:Utenti fr-3	Category:Fr-3 使用者
Kategorija:Utenti it-3	Category:It-3 使用者
Kategorija:Utenti no-3	Category:No-3 使用者
Kategorija:Utenti pl-3	Category:Pl-3 使用者
Kategorija:Utenti scn-3	Category:Scn-3 使用者
Kategorija:Utenti da-1	Category:Da-1 使用者
Kategorija:Utenti ga-1	Category:Ga-1 使用者
Kategorija:Utenti mt-1	Category:Mt-1 使用者
Kategorija:Utenti nl-1	Category:Nl-1 使用者
Kategorija:Utenti scn-1	Category:Scn-1 使用者
Kategorija:Utenti tr-1	Category:Tr-1 使用者
Kategorija:Utenti ar-1	Category:Ar-1 使用者
Kategorija:Utenti id-4	Category:Id-4 使用者
Kategorija:Utenti it-4	Category:It-4 使用者
Kategorija:Utenti pl-4	Category:Pl-4 使用者
Kategorija:Utenti be-2	Category:Be-2 使用者
Kategorija:Utenti da-2	Category:Da-2 使用者
Kategorija:Utenti fr-2	Category:Fr-2 使用者
Kategorija:Utenti cy-2	Category:Cy-2 使用者
Kategorija:Utenti hi-2	Category:Hi-2 使用者
Kategorija:Utenti it-2	Category:It-2 使用者
Kategorija:Utenti ja-2	Category:Ja-2 使用者
Kategorija:Utenti nl-2	Category:Nl-2 使用者
Kategorija:Utenti pl-2	Category:Pl-2 使用者
Kategorija:Utenti scn-2	Category:Scn-2 使用者
Kategorija:Utenti tr-2	Category:Tr-2 使用者
Kategorija:Utenti be-N	Category:Be 母語使用者
Kategorija:Utenti cs-N	Category:Cs 母語使用者
Kategorija:Utenti hr-N	Category:Hr 母語使用者
Kategorija:Utenti fr-N	Category:Fr 母語使用者
Kategorija:Utenti it-N	Category:It 母語使用者
Kategorija:Utenti nl-N	Category:Nl 母語使用者
Kategorija:Utenti no-N	Category:No 母語使用者
Kategorija:Utenti ru-N	Category:Ru 母語使用者
Kategorija:Utenti scn-N	Category:Scn 母语使用者
Kategorija:Divertiment	Category:娱乐
Mudell:Nfteams	Template:NFT player
Kategorija:Klabbs tal-futbol xolti	Category:已解散的足球俱樂部
Kategorija:UEFA Champions League	Category:欧洲冠军联赛
Mudell:Utent yue	Template:User zh-yue
Mudell:Utent pdc-1	Template:User pdc-1
Kategorija:Għall-wikifikazzjoni	Category:需要维基化的页面
Kategorija:1220	Category:1220年
Kategorija:Kompetizzjonijiet tal-UEFA	Category:欧洲足联赛事
Kategorija:Utenti af	Category:Af 使用者
Kategorija:Utenti af-3	Category:Af-3 使用者
Kategorija:Utenti ar	Category:Ar 使用者
Kategorija:Utenti az-N	Category:Az 母語使用者
Kategorija:Pajjiżi fil-Festival tal-Eurovision	Category:各國在歐洲歌唱大賽之歷年表現
Kategorija:Utenti bg	Category:Bg 使用者
Kategorija:Utenti bg-1	Category:Bg-1 使用者
Kategorija:Utenti bg-N	Category:Bg 母语使用者
Kategorija:Mużiċisti Awstrijaċi	Category:奧地利音樂家
Kategorija:Utenti cs	Category:Cs 使用者
Kategorija:Utenti da	Category:Da 使用者
Kategorija:Provinċja ta' Quang Binh	Category:廣平省
Kategorija:Abbozzi ta' annimali	Category:动物小作品
Kategorija:Utenti de	Category:De 使用者
Kategorija:Utenti de-2	Category:De-2 使用者
Kategorija:Utenti de-3	Category:De-3 使用者
Kategorija:Utenti de-4	Category:De-4 使用者
Kategorija:Utenti de-N	Category:De 母語使用者
Kategorija:Utenti el	Category:El 使用者
Kategorija:Utenti el-N	Category:El 母語使用者
Kategorija:Utenti en-3	Category:En-3 使用者
Kategorija:Utenti en-N	Category:En 母语使用者
Kategorija:Utenti eo-3	Category:Eo-3 使用者
Kategorija:Utenti es	Category:Es 使用者
Kategorija:Utenti es-1	Category:Es-1 使用者
Mudell:Pajjiżi tal-Unjoni Ewropea	Template:欧盟
Kategorija:Utenti es-2	Category:Es-2 使用者
Kategorija:Utenti es-3	Category:Es-3 使用者
Kategorija:Utenti es-N	Category:Es 母语使用者
Kategorija:Utenti fa	Category:Fa 使用者
Kategorija:Utenti fa-N	Category:Fa 母語使用者
Kategorija:Utenti fi	Category:Fi 使用者
Kategorija:Utenti fi-N	Category:Fi 母語使用者
Kategorija:Utenti grc	Category:Grc 使用者
Kategorija:Utenti grc-1	Category:Grc-1 使用者
Kategorija:Utenti hu	Category:Hu 使用者
Kategorija:Utenti hu-1	Category:Hu-1 使用者
Kategorija:1452	Category:1452年
Mudell:Tim ta' Bayer 04 Leverkusen	Template:利華古遜球員名單
Kategorija:Plejers ta' Los Angeles Galaxy	Category:洛杉磯銀河球員
Kategorija:Mietu fl-1904	Category:1904年逝世
Kategorija:Politiċi Veneżwelani	Category:委内瑞拉政治人物
Mudell:Tim ta' Málaga CF	Template:馬拉加足球會球員名單
Kategorija:Utenti pl-N	Category:Pl 母語使用者
Kategorija:Utenti pt-1	Category:Pt-1 使用者
Mudell:Dati pajjiż Ġermanja	Template:Country data Germany
Mudell:Dati pajjiż Renju Unit	Template:Country data United Kingdom
Kategorija:Mietu fl-1852	Category:1852年逝世
Kategorija:Mietu fl-1880	Category:1880年逝世
Kategorija:Ġeometrija	Category:几何学
Kategorija:Klabbs tal-futbol stabbiliti fl-1920	Category:1920年建立的足球俱樂部
Kategorija:Klabbs tal-futbol stabbiliti fl-1948	Category:1948年建立的足球俱乐部
Kategorija:Klabbs tal-futbol stabbiliti fl-1904	Category:1904年建立的足球俱樂部
Kategorija:Mietu fl-1942	Category:1942年逝世
Kategorija:Klabbs tal-futbol stabbiliti fl-1924	Category:1924年建立的足球俱樂部
Kategorija:Klabbs tal-futbol stabbiliti fl-1901	Category:1901年建立的足球俱樂部
Kategorija:Klabbs tal-futbol stabbiliti fl-1902	Category:1902年建立的足球俱樂部
Kategorija:Klabbs tal-futbol stabbiliti fl-1910	Category:1910年建立的足球俱樂部
Kategorija:Klabbs tal-futbol stabbiliti fl-1899	Category:1899年建立的足球俱樂部
Kategorija:Klabbs tal-futbol stabbiliti fl-1947	Category:1947年建立的足球俱樂部
Kategorija:Klabbs tal-futbol stabbiliti fl-1909	Category:1909年建立的足球俱樂部
Kategorija:Klabbs tal-futbol stabbiliti fl-1967	Category:1967年建立的足球俱樂部
Kategorija:Klabbs tal-futbol stabbiliti fl-1928	Category:1928年建立的足球俱樂部
Kategorija:Klabbs tal-futbol stabbiliti fl-1886	Category:1886年建立的足球俱樂部
Kategorija:Klabbs tal-futbol stabbiliti fl-1926	Category:1926年建立的足球俱樂部
Kategorija:Klabbs tal-futbol stabbiliti fl-1900	Category:1900年建立的足球俱樂部
Kategorija:Klabbs tal-futbol stabbiliti fl-1988	Category:1988年建立的足球俱樂部
Kategorija:Klabbs tal-futbol stabbiliti fl-1905	Category:1905年建立的足球俱樂部
Kategorija:Klabbs tal-futbol stabbiliti fl-1946	Category:1946年建立的足球俱樂部
Kategorija:Klabbs tal-futbol stabbiliti fl-1912	Category:1912年建立的足球俱樂部
Kategorija:Kampjonati Ewropej tal-Futbol 2012	Category:2012年歐洲足球錦標賽
Mudell:Dati pajjiż Skozja	Template:Country data Scotland
Għajnuna:Gwida essenzjali/Ifformattjar	Wikipedia:新手入門/格式
Mudell:Dati pajjiż Estonja	Template:Country data Estonia
Mudell:Dati pajjiż Montenegro	Template:Country data Montenegro
Kategorija:Klabbs tal-futbol stabbiliti fl-1911	Category:1911年建立的足球俱樂部
Kategorija:Klabbs tal-futbol stabbiliti fl-1906	Category:1906年建立的足球俱樂部
Kategorija:Klabbs tal-futbol stabbiliti fl-1907	Category:1907年建立的足球俱樂部
Kategorija:Klabbs tal-futbol stabbiliti fl-1955	Category:1955年建立的足球俱樂部
Kategorija:Utenti it	Category:It 使用者
Kategorija:Utenti it-1	Category:It-1 使用者
Kategorija:Klabbs tal-futbol stabbiliti fl-1972	Category:1972年建立的足球俱樂部
Kategorija:Klabbs tal-futbol stabbiliti fl-1991	Category:1991年建立的足球俱樂部
Kategorija:Klabbs tal-futbol stabbiliti fl-1950	Category:1950年建立的足球俱樂部
Kategorija:Futbolers Ażerbajġani	Category:阿塞拜疆足球运动员
Kategorija:Vulkani	Category:火山
Kategorija:Mietu fl-1564	Category:1564年逝世
Kategorija:1564	Category:1564年
Kategorija:Provinċji tal-Vjetnam	Category:越南的省
Kategorija:1592	Category:1592年
Kategorija:Kompetizzjonijiet tal-futbol skont il-pajjiż	Category:各國足球賽事
Kategorija:Arti marzjali	Category:武术
Mudell:Informazzjoni	Template:Information
Kategorija:Plejers ta' De Graafschap	Category:迪加史卓普球員
Kategorija:Pitturi tar-Rinaxximent	Category:文藝復興畫家
Kategorija:Bijoloġi evoluzzjonarji	Category:演化生物學家
Kategorija:Knisja Kattolika Rumana	Category:天主教會
Kategorija:Kowċis Olandiżi	Category:荷蘭足球主教練
Kategorija:Mużiċisti Olandiżi	Category:荷兰音乐家
Kategorija:Kantanti Olandiżi	Category:荷兰歌手
Mudell:Klassifikazzjoni xjentifika	Template:Biological classification
Kategorija:Mietu fl-1794	Category:1794年逝世
Kategorija:Mietu fl-1931	Category:1931年逝世
Kategorija:Mietu fl-1827	Category:1827年逝世
Kategorija:Utenti ru-1	Category:Ru-1 使用者
Mudell:TOClimit	Template:TOClimit
Wikipedija:Babel	Wikipedia:巴別
Kategorija:Mietu fl-1829	Category:1829年逝世
Kategorija:Mietu fl-1778	Category:1778年逝世
Kategorija:Mietu fl-1547	Category:1547年逝世
Mudell:·wrap	Template:·wrap
Kategorija:Abbozzi tal-kimika	Category:化学小作品
Kategorija:1687	Category:1687年
Kategorija:1614	Category:1614年
Kategorija:1612	Category:1612年
Kategorija:Mietu fl-1612	Category:1612年逝世
Kategorija:Mietu fl-1655	Category:1655年逝世
Kategorija:Mietu fl-1616	Category:1616年逝世
Kategorija:Mietu fl-1614	Category:1614年逝世
Kategorija:Futbolers Olandiżi	Category:荷兰足球运动员
Kategorija:1655	Category:1655年
Kategorija:Utenti mt	Category:Mt 使用者
Kategorija:Utenti mt-2	Category:Mt-2 使用者
Kategorija:Utenti mt-3	Category:Mt-3 使用者
Kategorija:Mietu fl-1994	Category:1994年逝世
Kategorija:Twieldu fl-1906	Category:1906年出生
Kategorija:Kompożituri tal-opra	Category:歌劇作曲家
Kategorija:Ibħra	Category:海洋
Kategorija:Bliet tal-Polonja	Category:波兰城市
Kategorija:Kompożituri skont in-nazzjonalità	Category:各国作曲家
Kategorija:Futbolers f'Wales skont il-klabb	Category:效力威爾斯球會的球員
Kategorija:Atturi skont in-nazzjonalità	Category:各國演員
Kategorija:Mietu fl-2009	Category:2009年逝世
Kategorija:Logħob ta' FC Bayern Munich	Category:拜仁慕尼黑比赛
Kategorija:Sistema solari	Category:太阳系
Trasformata ta' Fourier	傅里叶变换
Mudell:Coord/dms2dec	Template:Coord/dms2dec
Mudell:Dati pajjiż Brażil	Template:Country data Brazil
Mudell:Dati pajjiż Irlanda ta' Fuq	Template:Country data Northern Ireland
Mudell:UEFA	Template:UEFA player
Kategorija:Entomoloġija	Category:昆蟲學
Mudell:PD-old-70	Template:PD-old-70
Kategorija:Carnivora	Category:食肉目
Mudell:Botnav	Template:Botnav
Kategorija:Klabbs tal-futbol Torok	Category:土耳其足球俱樂部
Kategorija:Mietu fl-1321	Category:1321年逝世
Kategorija:Mietu fl-2005	Category:2005年逝世
Kategorija:Twieldu fl-1983	Category:1983年出生
Kategorija:Mietu fl-1592	Category:1592年逝世
Kategorija:Futbolers Pollakki	Category:波蘭足球運動員
Kategorija:Vandaliżmu tal-Wikipedija	Category:維基百科破壞
Kategorija:Mietu fl-1991	Category:1991年逝世
Kategorija:Mietu fl-1992	Category:1992年逝世
Kategorija:Plejers ta' Sport Club Corinthians Paulista	Category:哥連泰斯球員
Kategorija:Twieldu fl-1992	Category:1992年出生
Kategorija:Utenti nb	Category:Nb 使用者
Kategorija:Twieldu fl-1970	Category:1970年出生
Kategorija:Mietu fl-1980	Category:1980年逝世
Kategorija:Mietu fl-2008	Category:2008年逝世
Kategorija:Mietu fl-1966	Category:1966年逝世
Kategorija:Mietu fl-1946	Category:1946年逝世
Kategorija:Mietu fl-1938	Category:1938年逝世
Kategorija:Twieldu fl-1984	Category:1984年出生
Kategorija:Mietu fl-1962	Category:1962年逝世
Kategorija:Twieldu fl-1990	Category:1990年出生
Kategorija:Mietu fl-1934	Category:1934年逝世
Kategorija:Twieldu fl-1974	Category:1974年出生
Kategorija:Mietu fl-1947	Category:1947年逝世
Kategorija:Mietu fl-2007	Category:2007年逝世
Kategorija:Twieldu fl-1965	Category:1965年出生
Kategorija:Twieldu fl-1940	Category:1940年出生
Kategorija:Twieldu fl-1898	Category:1898年出生
Kategorija:Twieldu fl-1867	Category:1867年出生
Kategorija:Twieldu fl-1871	Category:1871年出生
Kategorija:Twieldu fl-1862	Category:1862年出生
Kategorija:Twieldu fl-1977	Category:1977年出生
Kategorija:Twieldu fl-1899	Category:1899年出生
Kategorija:1844	Category:1844年
Kategorija:Twieldu fl-1931	Category:1931年出生
Kategorija:Twieldu fl-1915	Category:1915年出生
Kategorija:Twieldu fl-1929	Category:1929年出生
Kategorija:Poeti Spanjoli	Category:西班牙诗人
Portal:Sport	Portal:体育运动
Mudell:Id	Template:Id icon
Kategorija:Abbozzi tal-arkeoloġija	Category:考古學小作品
Kategorija:Twieldu fl-1954	Category:1954年出生
Kategorija:Xjenza soċjali	Category:社会科学
Kategorija:Bjelorussja	Category:白俄羅斯
Kategorija:Twieldu fl-1960	Category:1960年出生
Kategorija:Mudelli għall-kalkolu tad-dati	Category:日期计算模板
Kategorija:Kantanti Kanadiżi	Category:加拿大歌手
Mudell:Dati pajjiż Ungerija	Template:Country data Hungary
Kategorija:Mietu fl-1830	Category:1830年逝世
Kategorija:Ewropa tal-Lvant	Category:东欧
Kategorija:Mietu fl-1993	Category:1993年逝世
Mudell:PortaliWikimedia	Template:主题关联维基媒体
Kategorija:Pajjiżi tal-Afrika	Category:非洲国家
Kategorija:Mietu fl-1998	Category:1998年逝世
Kategorija:Klabbs tal-futbol Ażerbajġani	Category:阿塞拜疆足球俱乐部
Kategorija:1170	Category:1170年
Kategorija:Twieldu fl-1170	Category:1170年出生
Kategorija:Twieldu fl-1182	Category:1182年出生
Kategorija:Twieldu fl-1185	Category:1185年出生
Kategorija:Mietu fl-1220	Category:1220年逝世
Kategorija:1226	Category:1226年
Kategorija:Mietu fl-1226	Category:1226年逝世
Kategorija:1227	Category:1227年
Kategorija:Mietu fl-1227	Category:1227年逝世
Kategorija:Twieldu fl-1951	Category:1951年出生
Kategorija:Mietu fl-1882	Category:1882年逝世
Kategorija:Mietu fl-1883	Category:1883年逝世
Kategorija:1265	Category:1265年
Kategorija:Twieldu fl-1265	Category:1265年出生
Kategorija:1296	Category:1296年
Kategorija:Mietu fl-1296	Category:1296年逝世
Mudell:Storjafilosofija	Template:西方哲学史
Mudell:Ballun tad-Deheb	Template:歷年金球獎得獎者
Mudell:Utent da-3	Template:User da-3
Didelphimorphia	負鼠目
Mudell:Tim ta' FC Barcelona	Template:巴塞罗那足球俱乐部球员名单
Mudell:Utent ja-2	Template:User ja-2
Kategorija:1528	Category:1528年
Mudell:Dati pajjiż New Zealand	Template:Country data New Zealand
Kategorija:1405	Category:1405年
Mudell:Utent ru-2	Template:User ru-2
Kategorija:Twieldu fl-1405	Category:1405年出生
Kategorija:1522	Category:1522年
Kategorija:1419	Category:1419年
Mudell:Lv	Template:Lv icon
Kategorija:1508	Category:1508年
Kategorija:1519	Category:1519年
Kategorija:Futbol fil-Polonja	Category:波蘭足球
Kategorija:Futbolers fil-Polonja skont il-klabb	Category:效力波蘭球會的球員
Kategorija:Twieldu fl-1452	Category:1452年出生
Kategorija:1466	Category:1466年
Kategorija:1468	Category:1468年
Kategorija:Mietu fl-1468	Category:1468年逝世
Kategorija:1471	Category:1471年
Kategorija:Twieldu fl-1471	Category:1471年出生
Mudell:Skwadra Taljana Tazza tad-Dinja tal-Futbol 2010	Template:2010年世界盃足球賽意大利參賽名單
Kategorija:1478	Category:1478年
Kategorija:Twieldu fl-1478	Category:1478年出生
Kategorija:Twieldu fl-1480	Category:1480年出生
Kategorija:1483	Category:1483年
Kategorija:1494	Category:1494年
Kategorija:Twieldu fl-1494	Category:1494年出生
Kategorija:Utenti ru	Category:Ru 使用者
Kategorija:Utenti ru-2	Category:Ru-2 使用者
Kategorija:Utenti ru-3	Category:Ru-3 使用者
Kategorija:Twieldu fl-1508	Category:1508年出生
Kategorija:Twieldu fl-1515	Category:1515年出生
Kategorija:Mietu fl-1519	Category:1519年逝世
Kategorija:1532	Category:1532年
Kategorija:Twieldu fl-1532	Category:1532年出生
Kategorija:Twieldu fl-1533	Category:1533年出生
Kategorija:Mietu fl-1535	Category:1535年逝世
Kategorija:Mietu fl-1539	Category:1539年逝世
Kategorija:1542	Category:1542年
Kategorija:Utenti sv-3	Category:Sv-3 使用者
Kategorija:1547	Category:1547年
Kategorija:Utenti sv-N	Category:Sv 母語使用者
Kategorija:Twieldu fl-1552	Category:1552年出生
Kategorija:1562	Category:1562年
Kategorija:Twieldu fl-1564	Category:1564年出生
Kategorija:1567	Category:1567年
Kategorija:1568	Category:1568年
Kategorija:Mietu fl-1568	Category:1568年逝世
Kategorija:1573	Category:1573年
Kategorija:Twieldu fl-1573	Category:1573年出生
Kategorija:1581	Category:1581年
Kategorija:Twieldu fl-1582	Category:1582年出生
Kategorija:1591	Category:1591年
Kategorija:1593	Category:1593年
Kategorija:1597	Category:1597年
Kategorija:1600	Category:1600年
Kategorija:1616	Category:1616年
Kategorija:1621	Category:1621年
Kategorija:Utenti tr	Category:Tr 使用者
Kategorija:Mietu fl-1621	Category:1621年逝世
Kategorija:1625	Category:1625年
Kategorija:Mietu fl-1625	Category:1625年逝世
Kategorija:Utenti uk-4	Category:Uk-4 使用者
Kategorija:1636	Category:1636年
Kategorija:1643	Category:1643年
Kategorija:Mietu fl-1643	Category:1643年逝世
Kategorija:1654	Category:1654年
Kategorija:Twieldu fl-1654	Category:1654年出生
Kategorija:1656	Category:1656年
Kategorija:Mietu fl-1656	Category:1656年逝世
Kategorija:Utenti yue-N	Category:Zh-yue 母语使用者
Kategorija:1660	Category:1660年
Kategorija:1667	Category:1667年
Kategorija:Mietu fl-1667	Category:1667年逝世
Kategorija:1670	Category:1670年
Kategorija:Mietu fl-1670	Category:1670年逝世
Kategorija:1675	Category:1675年
Kategorija:1685	Category:1685年
Kategorija:Twieldu fl-1687	Category:1687年出生
Mudell:En	Template:En icon
Kategorija:1694	Category:1694年
Kategorija:1695	Category:1695年
Kategorija:Twieldu fl-1696	Category:1696年出生
Kategorija:Twieldu fl-1699	Category:1699年出生
Kategorija:1700	Category:1700年
Kategorija:Mietu fl-1705	Category:1705年逝世
Kategorija:1709	Category:1709年
Kategorija:1710	Category:1710年
Kategorija:Twieldu fl-1715	Category:1715年出生
Kategorija:Twieldu fl-1724	Category:1724年出生
Mudell:Spazji	Template:Spaces
Kategorija:Mużiċisti	Category:音乐家
Kategorija:Logħob ta' abilità mentali	Category:邏輯謎題
Mudell:DotNET	Template:DotNET
Mudell:Dati pajjiż Stati Uniti	Template:Country data United States
Kategorija:Twieldu fl-1881	Category:1881年出生
Mudell:Timijiet nazzjonali tal-UEFA	Template:UEFA teams
Mudell:Tim ta' Manchester United FC	Template:曼聯球員名單
Mudell:Da	Template:Da icon
Kategorija:Kantanti Irlandiżi	Category:愛爾蘭歌手
Mudell:Skwadra Ġermaniża Tazza tad-Dinja tal-Futbol 2010	Template:2010年世界盃足球賽德國參賽名單
Mudell:Skwadra Ġermaniża Kampjonati Ewropej tal-Futbol 2008	Template:2008年欧洲足球锦标赛德国参赛名单
Mudell:Sq	Template:Sq icon
Mudell:Dati pajjiż Serbja u Montenegro	Template:Country data Serbia and Montenegro
Kategorija:Twieldu fl-1944	Category:1944年出生
Kategorija:Twieldu fl-1932	Category:1932年出生
Kategorija:Twieldu fl-1934	Category:1934年出生
Kategorija:Twieldu fl-1935	Category:1935年出生
Kategorija:Terminoloġija sportiva	Category:體育術語
Kategorija:Twieldu fl-1941	Category:1941年出生
Kategorija:Matematiċi Russi	Category:俄国数学家
Kategorija:Soċjoloġija	Category:社会学
Kategorija:Twieldu fis-seklu 12	Category:12世纪出生
Kategorija:Twieldu fis-seklu 13	Category:13世纪出生
Kategorija:Twieldu fis-seklu 14	Category:14世纪出生
Kategorija:Twieldu fl-1466	Category:1466年出生
Kategorija:Twieldu fl-1483	Category:1483年出生
Kategorija:Twieldu fl-1542	Category:1542年出生
Kategorija:Twieldu fl-1547	Category:1547年出生
Kategorija:Twieldu fl-1562	Category:1562年出生
Kategorija:Twieldu fl-1567	Category:1567年出生
Kategorija:Twieldu fl-1581	Category:1581年出生
Kategorija:Twieldu fl-1591	Category:1591年出生
Kategorija:Twieldu fl-1593	Category:1593年出生
Kategorija:Twieldu fl-1600	Category:1600年出生
Kategorija:Twieldu fl-1636	Category:1636年出生
Kategorija:Twieldu fl-1643	Category:1643年出生
Kategorija:Twieldu fl-1667	Category:1667年出生
Kategorija:Twieldu fl-1675	Category:1675年出生
Kategorija:Twieldu fl-1685	Category:1685年出生
Kategorija:Twieldu fl-1694	Category:1694年出生
Kategorija:Twieldu fl-1695	Category:1695年出生
Kategorija:Twieldu fl-1700	Category:1700年出生
Kategorija:Twieldu fl-1710	Category:1710年出生
Kategorija:Twieldu fl-1744	Category:1744年出生
Kategorija:Twieldu fl-1748	Category:1748年出生
Kategorija:Twieldu fl-1749	Category:1749年出生
Kategorija:Twieldu fl-1756	Category:1756年出生
Kategorija:Twieldu fl-1758	Category:1758年出生
Kategorija:Twieldu fl-1759	Category:1759年出生
Kategorija:Twieldu fl-1764	Category:1764年出生
Kategorija:Twieldu fl-1767	Category:1767年出生
Kategorija:Twieldu fl-1769	Category:1769年出生
Kategorija:Twieldu fl-1770	Category:1770年出生
Kategorija:Twieldu fl-1772	Category:1772年出生
Kategorija:Twieldu fl-1773	Category:1773年出生
Kategorija:Twieldu fl-1779	Category:1779年出生
Kategorija:Twieldu fl-1786	Category:1786年出生
Kategorija:Twieldu fl-1797	Category:1797年出生
Kategorija:Twieldu fl-1801	Category:1801年出生
Kategorija:Twieldu fl-1803	Category:1803年出生
Kategorija:Twieldu fl-1808	Category:1808年出生
Kategorija:Twieldu fl-1809	Category:1809年出生
Kategorija:Twieldu fl-1813	Category:1813年出生
Kategorija:Twieldu fl-1815	Category:1815年出生
Kategorija:Twieldu fl-1818	Category:1818年出生
Kategorija:Twieldu fl-1821	Category:1821年出生
Kategorija:Twieldu fl-1822	Category:1822年出生
Kategorija:Twieldu fl-1824	Category:1824年出生
Kategorija:Twieldu fl-1840	Category:1840年出生
Kategorija:Twieldu fl-1841	Category:1841年出生
Kategorija:Twieldu fl-1844	Category:1844年出生
Kategorija:Twieldu fl-1846	Category:1846年出生
Kategorija:Twieldu fl-1847	Category:1847年出生
Kategorija:Twieldu fl-1848	Category:1848年出生
Kategorija:Twieldu fl-1849	Category:1849年出生
Kategorija:Twieldu fl-1853	Category:1853年出生
Kategorija:Twieldu fl-1854	Category:1854年出生
Kategorija:Twieldu fl-1859	Category:1859年出生
Kategorija:Twieldu fl-1860	Category:1860年出生
Kategorija:Twieldu fl-1861	Category:1861年出生
Kategorija:Twieldu fl-1864	Category:1864年出生
Kategorija:Twieldu fl-1866	Category:1866年出生
Kategorija:Twieldu fl-1869	Category:1869年出生
Kategorija:Twieldu fl-1873	Category:1873年出生
Kategorija:Twieldu fl-1874	Category:1874年出生
Kategorija:Twieldu fl-1876	Category:1876年出生
Kategorija:Twieldu fl-1877	Category:1877年出生
Kategorija:Twieldu fl-1880	Category:1880年出生
Kategorija:Twieldu fl-1883	Category:1883年出生
Kategorija:Twieldu fl-1884	Category:1884年出生
Kategorija:Twieldu fl-1885	Category:1885年出生
Kategorija:Twieldu fl-1886	Category:1886年出生
Kategorija:Twieldu fl-1887	Category:1887年出生
Kategorija:Twieldu fl-1889	Category:1889年出生
Kategorija:Twieldu fl-1890	Category:1890年出生
Kategorija:Twieldu fl-1891	Category:1891年出生
Kategorija:Twieldu fl-1892	Category:1892年出生
Kategorija:Twieldu fl-1893	Category:1893年出生
Kategorija:Twieldu fl-1894	Category:1894年出生
Kategorija:Twieldu fl-1895	Category:1895年出生
Kategorija:Twieldu fl-1896	Category:1896年出生
Kategorija:Twieldu fl-1897	Category:1897年出生
Kategorija:Twieldu fl-1900	Category:1900年出生
Kategorija:Twieldu fl-1901	Category:1901年出生
Kategorija:Twieldu fl-1902	Category:1902年出生
Kategorija:Twieldu fl-1904	Category:1904年出生
Kategorija:Twieldu fl-1905	Category:1905年出生
Kategorija:Twieldu fl-1907	Category:1907年出生
Kategorija:Twieldu fl-1908	Category:1908年出生
Kategorija:Twieldu fl-1909	Category:1909年出生
Kategorija:Twieldu fl-1912	Category:1912年出生
Kategorija:Twieldu fl-1913	Category:1913年出生
Kategorija:Twieldu fl-1914	Category:1914年出生
Kategorija:Twieldu fl-1917	Category:1917年出生
Kategorija:Twieldu fl-1918	Category:1918年出生
Kategorija:Twieldu fl-1919	Category:1919年出生
Kategorija:Twieldu fl-1922	Category:1922年出生
Kategorija:Twieldu fl-1923	Category:1923年出生
Kategorija:Twieldu fl-1927	Category:1927年出生
Kategorija:Twieldu fl-1928	Category:1928年出生
Kategorija:Twieldu fl-1942	Category:1942年出生
Kategorija:Twieldu fl-1943	Category:1943年出生
Kategorija:Twieldu fl-1945	Category:1945年出生
Kategorija:Twieldu fl-1947	Category:1947年出生
Kategorija:Twieldu fl-1949	Category:1949年出生
Kategorija:Twieldu fl-1952	Category:1952年出生
Kategorija:Twieldu fl-1953	Category:1953年出生
Kategorija:Twieldu fl-1957	Category:1957年出生
Kategorija:Twieldu fl-1958	Category:1958年出生
Kategorija:Twieldu fl-1959	Category:1959年出生
Kategorija:Twieldu fl-1961	Category:1961年出生
Kategorija:Twieldu fl-1962	Category:1962年出生
Kategorija:Twieldu fl-1966	Category:1966年出生
Kategorija:Twieldu fl-1967	Category:1967年出生
Kategorija:Twieldu fl-1968	Category:1968年出生
Kategorija:Twieldu fl-1969	Category:1969年出生
Kategorija:Twieldu fl-1971	Category:1971年出生
Kategorija:Twieldu fl-1972	Category:1972年出生
Kategorija:Twieldu fl-1973	Category:1973年出生
Kategorija:Twieldu fl-1975	Category:1975年出生
Kategorija:Twieldu fl-1976	Category:1976年出生
Kategorija:Twieldu fl-1978	Category:1978年出生
Kategorija:Twieldu fl-1979	Category:1979年出生
Kategorija:Twieldu fl-1980	Category:1980年出生
Kategorija:Twieldu fl-1981	Category:1981年出生
Kategorija:Twieldu fl-1982	Category:1982年出生
Kategorija:Twieldu fl-1985	Category:1985年出生
Kategorija:Twieldu fl-1986	Category:1986年出生
Kategorija:Twieldu fl-1987	Category:1987年出生
Kategorija:Twieldu fl-1988	Category:1988年出生
Kategorija:Twieldu fl-1989	Category:1989年出生
Kategorija:Twieldu fl-1991	Category:1991年出生
Kategorija:Twieldu fl-1993	Category:1993年出生
Kategorija:Twieldu fl-1994	Category:1994年出生
Kategorija:Twieldu fl-1995	Category:1995年出生
Kategorija:Twieldu fl-1996	Category:1996年出生
Kategorija:Twieldu fl-1997	Category:1997年出生
Kategorija:Twieldu fl-1999	Category:1999年出生
Kategorija:Twieldu fl-2000	Category:2000年出生
Mudell:Dati pajjiż Afganistan	Template:Country data Afghanistan
Mudell:Dati pajjiż Bangladexx	Template:Country data Bangladesh
Kategorija:1715	Category:1715年
Kategorija:1797	Category:1797年
Kategorija:1787	Category:1787年
Kategorija:1539	Category:1539年
Kategorija:1321	Category:1321年
Mudell:Nowrap end	Template:Nowrap end
Mudell:Tazza tad-Dinja tal-Klabbs Rawnd 7	Template:ClubWCRound7
Mudell:Tim ta' ACF Fiorentina	Template:費倫天拿球員名單
Kategorija:Seklu 17	Category:17世纪
Kategorija:Deċennju tal-1260	Category:1260年代
Mudell:Tim ta' Arsenal FC	Template:阿仙奴球員名單
Mudell:CopyrightByWikimedia	Template:Non-free Wikimedia logo
Kategorija:1182	Category:1182年
Kategorija:1185	Category:1185年
Kategorija:Proġetti tal-Wikimedia	Category:维基媒体工程
Kategorija:1221	Category:1221年
Kategorija:Plejers ta' Celta de Vigo	Category:切爾達球員
Mudell:Bar percent	Template:Bar percent
Mudell:Bk	Template:Bk
Kategorija:2014	Category:2014年
Mudell:Skwadra Brażiljana Tazza tal-Konfederazzjonijiet 2009	Template:2009年聯合會盃足球賽巴西參賽名單
Mudell:Skwadra Brażiljana Tazza tad-Dinja tal-Futbol 2010	Template:2010年世界盃足球賽巴西參賽名單
Mudell:Utent sv-3	Template:User sv-3
Mudell:Fr	Template:Fr icon
Kategorija:1515	Category:1515年
Mudell:Twitter	Template:Twitter
Kategorija:Mietu fl-1522	Category:1522年逝世
Kategorija:Portali	Category:主题首页
Kategorija:Mietu fl-1528	Category:1528年逝世
Kategorija:1533	Category:1533年
Kategorija:1535	Category:1535年
Kategorija:1546	Category:1546年
Kategorija:1552	Category:1552年
Kategorija:Futbolers Sud-Koreani	Category:韩国足球运动员
Kategorija:1580	Category:1580年
Kategorija:Mietu fl-1580	Category:1580年逝世
Kategorija:1582	Category:1582年
Kategorija:1595	Category:1595年
Mudell:Utent af-3	Template:User af-3
Kategorija:1622	Category:1622年
Kategorija:1642	Category:1642年
Kategorija:Mietu fl-1642	Category:1642年逝世
Kategorija:Mietu fl-1660	Category:1660年逝世
Kategorija:1696	Category:1696年
Kategorija:1699	Category:1699年
Kategorija:1705	Category:1705年
Kategorija:1726	Category:1726年
Kategorija:Mietu fl-1726	Category:1726年逝世
Kategorija:Mietu fl-1727	Category:1727年逝世
Marie Louise Coleiro Preca	玛丽·路易斯·科勒略·普雷卡
Kategorija:Mietu fl-1748	Category:1748年逝世
Kategorija:Mietu fl-1757	Category:1757年逝世
Kategorija:Mietu fl-1759	Category:1759年逝世
Kategorija:Mietu fl-1760	Category:1760年逝世
Kategorija:1764	Category:1764年
Kategorija:1767	Category:1767年
Kategorija:1769	Category:1769年
Kategorija:Mietu fl-1772	Category:1772年逝世
Kategorija:1779	Category:1779年
Kategorija:Mietu fl-1782	Category:1782年逝世
Kategorija:Mietu fl-1787	Category:1787年逝世
Kategorija:Mietu fl-1789	Category:1789年逝世
Kategorija:Mietu fl-1790	Category:1790年逝世
Kategorija:1778	Category:1778年
Kategorija:Mużika popolari	Category:世界音樂
Mudell:Artiklu prinċipali	Template:Main
Mudell:Coord/dec2dms/dm	Template:Coord/dec2dms/dm
Kategorija:Mudelli ta' kampjonati bl-eliminatorji	Category:對陣形勢圖模板
Mudell:Plejers fit-tim tal-futbol/tmiem	Template:Football squad end
Kategorija:Avvenimenti sportivi	Category:體育事件
Mudell:Plejers fit-tim tal-futbol/bidu	Template:Football squad start
Kategorija:Avvenimenti futuri	Category:未来事件
Kategorija:It-Tieni Gwerra Dinjija	Category:第二次世界大战
Kategorija:L-Ewwel Gwerra Dinjija	Category:第一次世界大战
Kategorija:Plejers ta' AC Milan	Category:AC米蘭球員
Kategorija:Logħob tal-mejda	Category:圖版遊戲
Kategorija:Mudelli ta' ċitazzjoni tas-sorsi	Category:引用模板
Kategorija:UC Sampdoria	Category:桑普多利亚足球俱乐部
Mudell:PD-utent	Template:PD-self
Mudell:Tim ta' FC Bayern Munich	Template:拜仁慕尼黑球員名單
Kategorija:Tubulidentata	Category:管齿目
Kategorija:Klabbs tal-futbol Albaniżi	Category:阿爾巴尼亞足球俱樂部
Kategorija:Kittieba Spanjoli	Category:西班牙作家
Kategorija:Klabbs tal-futbol Bjelorussi	Category:白俄罗斯足球俱乐部
Kategorija:Klabbs tal-futbol stabbiliti fl-1877	Category:1877年建立的足球俱樂部
Kategorija:Klabbs tal-futbol stabbiliti fl-1878	Category:1878年建立的足球俱樂部
Kategorija:Klabbs tal-futbol stabbiliti fl-1935	Category:1935年建立的足球俱樂部
Kategorija:Klabbs tal-futbol stabbiliti fl-1939	Category:1939年建立的足球俱樂部
Kategorija:Klabbs tal-futbol stabbiliti fl-1943	Category:1943年建立的足球俱樂部
Kategorija:Klabbs tal-futbol stabbiliti fl-1957	Category:1957年建立的足球俱樂部
Kategorija:Klabbs tal-futbol stabbiliti fl-1964	Category:1964年建立的足球俱樂部
Kategorija:Klabbs tal-futbol stabbiliti fl-1992	Category:1992年建立的足球俱樂部
Kategorija:Klabbs tal-futbol stabbiliti fl-2004	Category:2004年建立的足球俱樂部
Kategorija:Klabbs tal-futbol stabbiliti skont is-sena	Category:依建立年份劃分的足球俱樂部
Kategorija:Klabbs tal-futbol Latvjani	Category:拉脫維亞足球會
Kategorija:Klabbs tal-futbol Maltin	Category:马耳他足球俱乐部
Mudell:Round8	Template:Round8
Mudell:Cquote	Template:Cquote
Mudell:Tim ta' Chelsea FC	Template:車路士球員名單
Kategorija:Mietu fl-1937	Category:1937年逝世
Kategorija:Mietu fl-1950	Category:1950年逝世
Kategorija:Angola	Category:安哥拉
Kategorija:Libja	Category:利比亞
Kategorija:Marokk	Category:摩洛哥
Kategorija:Personalitajiet televiżivi Taljani	Category:義大利電視人物
Kategorija:1480	Category:1480年
Kategorija:Mietu fl-1595	Category:1595年逝世
Kategorija:Mietu fl-1597	Category:1597年逝世
Kategorija:1610	Category:1610年
Kategorija:Mietu fl-1610	Category:1610年逝世
Mudell:Kaxxa ġenb	Template:Side box
Kategorija:Unuri u trofej sportivi	Category:體育獎項
Kategorija:Mietu fl-2011	Category:2011年逝世
Kategorija:Kantanti Taljani	Category:意大利歌手
Mudell:Rquote	Template:Rquote
Kategorija:Mietu fl-1546	Category:1546年逝世
Kategorija:1724	Category:1724年
Kategorija:1748	Category:1748年
Kategorija:1749	Category:1749年
Kategorija:1750	Category:1750年
Kategorija:Mietu fl-1750	Category:1750年逝世
Kategorija:1756	Category:1756年
Kategorija:1757	Category:1757年
Kategorija:1758	Category:1758年
Kategorija:1759	Category:1759年
Kategorija:1760	Category:1760年
Kategorija:1770	Category:1770年
Kategorija:1772	Category:1772年
Kategorija:1773	Category:1773年
Kategorija:1782	Category:1782年
Kategorija:Pajjiżi stabbiliti fl-1814	Category:1814年建立的國家或政權
Kategorija:1786	Category:1786年
Kategorija:1791	Category:1791年
Kategorija:Mietu fl-1791	Category:1791年逝世
Kategorija:1792	Category:1792年
Kategorija:Mietu fl-1792	Category:1792年逝世
Kategorija:1794	Category:1794年
Kategorija:1801	Category:1801年
Kategorija:1803	Category:1803年
Kategorija:1804	Category:1804年
Kategorija:Mietu fl-1804	Category:1804年逝世
Kategorija:1807	Category:1807年
Kategorija:Mietu fl-1807	Category:1807年逝世
Kategorija:1809	Category:1809年
Kategorija:1813	Category:1813年
Kategorija:1815	Category:1815年
Kategorija:1818	Category:1818年
Kategorija:Mietu fl-1818	Category:1818年逝世
Kategorija:Mietu fl-1821	Category:1821年逝世
Kategorija:1827	Category:1827年
Kategorija:Mietu fl-1828	Category:1828年逝世
Kategorija:1830	Category:1830年
Kategorija:Mietu fl-1832	Category:1832年逝世
Kategorija:1835	Category:1835年
Kategorija:1840	Category:1840年
Kategorija:1842	Category:1842年
Kategorija:Mietu fl-1842	Category:1842年逝世
Kategorija:1846	Category:1846年
Kategorija:1847	Category:1847年
Kategorija:Mietu fl-1847	Category:1847年逝世
Kategorija:1848	Category:1848年
Kategorija:1849	Category:1849年
Kategorija:1852	Category:1852年
Kategorija:1853	Category:1853年
Kategorija:1854	Category:1854年
Kategorija:1859	Category:1859年
Kategorija:Mietu fl-1859	Category:1859年逝世
Kategorija:1860	Category:1860年
Kategorija:1861	Category:1861年
Kategorija:Mietu fl-1861	Category:1861年逝世
Kategorija:1862	Category:1862年
Kategorija:1864	Category:1864年
Kategorija:1866	Category:1866年
Kategorija:1869	Category:1869年
Kategorija:Mietu fl-1869	Category:1869年逝世
Kategorija:1870	Category:1870年
Kategorija:1871	Category:1871年
Kategorija:1872	Category:1872年
Kategorija:Mietu fl-1873	Category:1873年逝世
Kategorija:1874	Category:1874年
Kategorija:1875	Category:1875年
Kategorija:1876	Category:1876年
Kategorija:1877	Category:1877年
Kategorija:1879	Category:1879年
Kategorija:1880	Category:1880年
Kategorija:1881	Category:1881年
Kategorija:1882	Category:1882年
Kategorija:1883	Category:1883年
Kategorija:1884	Category:1884年
Kategorija:1885	Category:1885年
Kategorija:1886	Category:1886年
Kategorija:1887	Category:1887年
Kategorija:1889	Category:1889年
Kategorija:1890	Category:1890年
Kategorija:Mietu fl-1890	Category:1890年逝世
Kategorija:1891	Category:1891年
Kategorija:1892	Category:1892年
Kategorija:1893	Category:1893年
Kategorija:Mietu fl-1893	Category:1893年逝世
Kategorija:1894	Category:1894年
Kategorija:Mietu fl-1894	Category:1894年逝世
Kategorija:1895	Category:1895年
Kategorija:Mietu fl-1895	Category:1895年逝世
Kategorija:1897	Category:1897年
Kategorija:Mietu fl-1897	Category:1897年逝世
Kategorija:Mietu fl-1898	Category:1898年逝世
Kategorija:1899	Category:1899年
Kategorija:Mietu fl-1900	Category:1900年逝世
Kategorija:Mietu fl-1901	Category:1901年逝世
Kategorija:Mietu fl-1905	Category:1905年逝世
Kategorija:Mietu fl-1915	Category:1915年逝世
Kategorija:Mietu fl-1916	Category:1916年逝世
Kategorija:Mietu fl-1917	Category:1917年逝世
Kategorija:Mietu fl-1918	Category:1918年逝世
Kategorija:Mietu fl-1920	Category:1920年逝世
Kategorija:Mietu fl-1921	Category:1921年逝世
Kategorija:Mietu fl-1925	Category:1925年逝世
Kategorija:Mietu fl-1926	Category:1926年逝世
Kategorija:Mietu fl-1927	Category:1927年逝世
Kategorija:Mietu fl-1935	Category:1935年逝世
Kategorija:Mietu fl-1936	Category:1936年逝世
Kategorija:Mietu fl-1939	Category:1939年逝世
Kategorija:Mietu fl-1940	Category:1940年逝世
Kategorija:Mietu fl-1954	Category:1954年逝世
Kategorija:1961	Category:1961年
Kategorija:1964	Category:1964年
Kategorija:Mietu fl-1964	Category:1964年逝世
Kategorija:1965	Category:1965年
Kategorija:1966	Category:1966年
Kategorija:1967	Category:1967年
Kategorija:Mietu fl-1967	Category:1967年逝世
Kategorija:Mietu fl-1968	Category:1968年逝世
Kategorija:1969	Category:1969年
Kategorija:1970	Category:1970年
Kategorija:Mietu fl-1970	Category:1970年逝世
Kategorija:Mietu fl-1971	Category:1971年逝世
Kategorija:1972	Category:1972年
Kategorija:Mietu fl-1972	Category:1972年逝世
Kategorija:1973	Category:1973年
Kategorija:Mietu fl-1973	Category:1973年逝世
Kategorija:1974	Category:1974年
Kategorija:1975	Category:1975年
Kategorija:1976	Category:1976年
Kategorija:Mietu fl-1977	Category:1977年逝世
Kategorija:1978	Category:1978年
Kategorija:1979	Category:1979年
Kategorija:1980	Category:1980年
Kategorija:1981	Category:1981年
Kategorija:1982	Category:1982年
Kategorija:Mietu fl-1982	Category:1982年逝世
Kategorija:1983	Category:1983年
Kategorija:Mietu fl-1983	Category:1983年逝世
Kategorija:1984	Category:1984年
Kategorija:Mietu fl-1984	Category:1984年逝世
Kategorija:1985	Category:1985年
Kategorija:1986	Category:1986年
Kategorija:1987	Category:1987年
Kategorija:Mietu fl-1987	Category:1987年逝世
Kategorija:1988	Category:1988年
Kategorija:1989	Category:1989年
Kategorija:Mietu fl-1989	Category:1989年逝世
Kategorija:1990	Category:1990年
Kategorija:Mietu fl-1990	Category:1990年逝世
Kategorija:1991	Category:1991年
Kategorija:1992	Category:1992年
Kategorija:1993	Category:1993年
Kategorija:1994	Category:1994年
Kategorija:1995	Category:1995年
Kategorija:Mietu fl-1995	Category:1995年逝世
Kategorija:Fußball-Bundesliga	Category:德国足球甲级联赛
Kategorija:1996	Category:1996年
Kategorija:Mietu fl-1996	Category:1996年逝世
Kategorija:1997	Category:1997年
Kategorija:Mietu fl-1997	Category:1997年逝世
Kategorija:1999	Category:1999年
Kategorija:2000	Category:2000年
Kategorija:Mietu fl-2000	Category:2000年逝世
Kategorija:2001	Category:2001年
Kategorija:Mietu fl-2001	Category:2001年逝世
Kategorija:2002	Category:2002年
Kategorija:Mietu fl-2002	Category:2002年逝世
Kategorija:Mietu fl-2003	Category:2003年逝世
Kategorija:2004	Category:2004年
Kategorija:Mietu fl-2004	Category:2004年逝世
Kategorija:2005	Category:2005年
Kategorija:2006	Category:2006年
Kategorija:Mietu fl-2006	Category:2006年逝世
Kategorija:2007	Category:2007年
Kategorija:2008	Category:2008年
Kategorija:2009	Category:2009年
Kategorija:2010	Category:2010年
Kategorija:2011	Category:2011年
Kategorija:Ajruporti skont il-pajjiż	Category:各国机场
Kategorija:Pajjiżi gżejjer	Category:岛国
Kategorija:Pajjiżi interkjużi	Category:內陸國家
Kategorija:Ġurnalisti Franċiżi	Category:法國記者
Kategorija:Storja tal-futbol	Category:足球历史
Kategorija:Grawnds tal-futbol fl-Italja	Category:義大利足球場
Mudell:Amerika t'Isfel	Template:南美洲主題
Kategorija:Futbol fil-Gambja	Category:岡比亞足球
Kategorija:Futbol fil-Greċja	Category:希臘足球
Kategorija:Futbol fin-Niġerja	Category:尼日利亞足球
Kategorija:Futbol fl-Afrika t'Isfel	Category:南非足球
Kategorija:Futbol fil-Latvja	Category:拉脫維亞足球
Kategorija:Futbol fir-Rumanija	Category:羅馬尼亞足球
Kategorija:Futbol fil-Litwanja	Category:立陶宛足球
Kategorija:Futbol fil-Montenegro	Category:黑山足球
Kategorija:Futbol f'Malta	Category:馬爾他足球
Kategorija:Futbol fl-Istati Uniti	Category:美國足球
Kategorija:Futbol fil-Belġju	Category:比利時足球
Kategorija:Futbol fil-Bożnija u Ħerżegovina	Category:波斯尼亞和黑塞哥維那足球
Kategorija:Futbol fil-Bulgarija	Category:保加利亞足球
Kategorija:Futbol fis-Serbja	Category:塞尔维亚足球
Kategorija:Futbol fl-Unjoni Sovjetika	Category:苏联足球
Kategorija:Futbol fl-Iżvizzera	Category:瑞士足球
Kategorija:Futbol fl-Iskozja	Category:蘇格蘭足球
Kategorija:Futbol fis-Slovakkja	Category:斯洛伐克足球
Kategorija:Futbol fl-Arġentina	Category:阿根廷足球
Kategorija:Futbol fl-Iżlanda	Category:冰島足球
Kategorija:Futbol fl-Irlanda	Category:愛爾蘭共和國足球
Kategorija:Futbol fl-Albanija	Category:阿爾巴尼亞足球
Kategorija:Futbol fl-Angola	Category:安哥拉足球
Kategorija:Futbol fl-Estonja	Category:愛沙尼亞足球
Kategorija:Futbol fl-Awstralja	Category:澳大利亞足球
Kategorija:Futbol f'Wales	Category:威爾斯足球
Kategorija:Futbol fl-Iżrael	Category:以色列足球
Kategorija:Futbol fiċ-Ċina	Category:中國足球
Kategorija:Futbol fil-Kamerun	Category:喀麥隆足球
Kategorija:Futbol fil-Kosta tal-Avorju	Category:科特迪瓦足球
Kategorija:Futbol f'Ċipru	Category:塞浦路斯足球
Mudell:Utent be	Template:User be
Mudell:Utent ga-2	Template:User ga-2
Mudell:Utent hu-1	Template:User hu-1
Kategorija:Presidenti tar-Royal Society	Category:英国皇家学会会长
Mudell:Utent ru-1	Template:User ru-1
Mudell:Utent tr-1	Template:User tr-1
Mudell:Utent uk-4	Template:User uk-4
Mudell:Utent zh-1	Template:User zh-1
Kategorija:Poeti skont in-nazzjonalità	Category:各国诗人
Kategorija:Mużiċisti skont in-nazzjonalità	Category:各國音樂家
Kategorija:Skulturi skont in-nazzjonalità tagħhom	Category:各国雕塑家
Kategorija:Filosfi skont in-nazzjonalità	Category:各國哲學家
Kategorija:Vulkani skont il-pajjiż	Category:各国火山
Mudell:Dati pajjiż Beliże	Template:Country data Belize
Kategorija:Futbol fil-Gana	Category:加納足球
Kategorija:Futbol fl-Olanda	Category:荷蘭足球
Kategorija:Futbol fin-Norveġja	Category:挪威足球
Kategorija:Futbol fil-Ġermanja	Category:德國足球
Kategorija:Futbol fil-Bjelorussja	Category:白俄羅斯足球
Kategorija:Futbol fl-Irlanda ta' Fuq	Category:北愛爾蘭足球
Kategorija:Futbol fil-Brażil	Category:巴西足球
Kategorija:Futbol fl-Armenja	Category:亞美尼亞足球
Kategorija:Futbol fl-Ażerbajġan	Category:阿塞拜疆足球
Kategorija:Futbol fl-Awstrija	Category:奥地利足球
Kategorija:Futbol fl-Urugwaj	Category:烏拉圭足球
Kategorija:Futbol fl-Italja	Category:義大利足球
Mudell:Dati pajjiż Jugożlavja	Template:Country data SFR Yugoslavia
Kategorija:Futbol fl-Ingilterra	Category:英格蘭足球
Kategorija:Futbol fir-Repubblika Ċeka	Category:捷克足球
Kategorija:Futbol fil-Każakistan	Category:哈薩克斯坦足球
Kategorija:Futbol fil-Kolombja	Category:哥倫比亞足球
Kategorija:Futbol fit-Turkija	Category:土耳其足球
Kategorija:Futbol fil-Portugall	Category:葡萄牙足球
Kategorija:Futbol fl-Ungerija	Category:匈牙利足球
Mudell:TwoLegResult	Template:TwoLegResult
Kategorija:Festival tal-Eurovision	Category:歐洲歌唱大賽
Kategorija:Kowċis Arġentini	Category:阿根廷足球主教練
Kategorija:Kowċis Awstrijaċi	Category:奧地利足球主教練
Kategorija:Kowċis Belġjani	Category:比利時足球主教練
Kategorija:Kowċis Brażiljani	Category:巴西足球主教練
Kategorija:Kowċis Ingliżi	Category:英格兰足球领队
Kategorija:Kowċis Skoċċiżi	Category:苏格兰足球领队
Kategorija:Teatru	Category:戏剧
Kategorija:Kowċis Kroati	Category:克羅地亞足球主教練
Kategorija:Kowċis Ġermaniżi	Category:德國足球主教練
Mudell:Dati pajjiż Kosovo	Template:Country data Kosovo
Kategorija:Kantanti skont in-nazzjonalità	Category:各國歌手
Kategorija:Kowċis Rumeni	Category:羅馬尼亞足球領隊
Kategorija:Kowċis Spanjoli	Category:西班牙足球主教練
Kategorija:Futbolers Albaniżi	Category:阿尔巴尼亚足球运动员
Kategorija:Futbolers Angoliżi	Category:安哥拉足球运动员
Kategorija:Futbolers Arġentini	Category:阿根廷足球运动员
Kategorija:Futbolers Armeni	Category:亞美尼亞足球運動員
Kategorija:Futbolers Awstraljani	Category:澳洲足球運動員
Kategorija:Futbolers Awstrijaċi	Category:奧地利足球運動員
Kategorija:Plejers tal-Bundesliga Awstrijaka	Category:奧超球員
Kategorija:Futbolers Bożnijaċi	Category:波斯尼亞和黑塞哥維那足球運動員
Kategorija:Futbolers Brażiljani	Category:巴西足球运动员
Kategorija:Futbolers Ingliżi	Category:英格蘭足球運動員
Kategorija:Mudelli ta' diżambigwazzjoni u riindirizzi	Category:消歧義模板
Mudell:Dati pajjiż Abkażja	Template:Country data Abkhazia
Mudell:Newtrali	Template:Neutral
Kategorija:Kantanti Żvediżi	Category:瑞典歌手
Kategorija:Kantanti Iżlandiżi	Category:冰島歌手
Kategorija:Kantanti Iżraeljani	Category:以色列歌手
Kategorija:Kantanti Pollakki	Category:波蘭歌手
Kategorija:Kantanti Franċiżi	Category:法国歌手
Mudell:Dati pajjiż Aruba	Template:Country data Aruba
Kategorija:Utenti nl	Category:Nl 使用者
Kategorija:Ekonomisti Russi	Category:俄羅斯經濟學家
Kategorija:Utenti nn-3	Category:Nn-3 使用者
Kategorija:Utenti no-2	Category:No-2 使用者
Kategorija:Utenti no	Category:No 使用者
Kategorija:Utenti zh-1	Category:Zh-1 使用者
Kategorija:Armenja	Category:亞美尼亞
Kategorija:Fiżiċi Brittaniċi	Category:英国物理学家
Kategorija:Pajjiżi tal-Baħar Mediterran	Category:地中海國家
Mudell:Dati pajjiż Antigwa u Barbuda	Template:Country data Antigua and Barbuda
Mudell:Dati pajjiż Stati Federati tal-Mikroneżja	Template:Country data Federated States of Micronesia
Kategorija:Atturi Taljani	Category:義大利演員
Kategorija:Pajjiżi skond is-sena li ġew stabbiliti	Category:依建立年份劃分的國家
Kategorija:Finanza	Category:金融
Kategorija:Diskografiji	Category:音樂作品列表
Kategorija:Demokraziji liberali	Category:自由民主國家
Kategorija:Kompetizzjonijiet tal-futbol	Category:足球競賽
Kategorija:Sports individwali	Category:个人项目
Kategorija:Rumanziera Spanjoli	Category:西班牙小说家
Kategorija:Sports ta' ġewwa	Category:室內運動
Kategorija:Televiżjoni	Category:电视
Kategorija:Mietu fl-1945	Category:1945年逝世
Kategorija:Mietu fl-1963	Category:1963年逝世
Kategorija:1832	Category:1832年
Kategorija:Mietu fl-1930	Category:1930年逝世
Kategorija:1822	Category:1822年
Kategorija:Skulturi	Category:雕塑家
Kategorija:Seklu 14	Category:14世纪
Kategorija:Sekli	Category:世纪
Kategorija:Seklu 13	Category:13世纪
Kategorija:Seklu 16	Category:16世纪
Kategorija:Seklu 12	Category:12世纪
Kategorija:Seklu 18	Category:18世纪
Kategorija:Kompożituri Russi	Category:俄国作曲家
Kategorija:Kompożituri Franċiżi	Category:法国作曲家
Kategorija:Kompożituri Barokki	Category:巴洛克作曲家
Kategorija:Kompożituri Pollakki	Category:波兰作曲家
Kategorija:Kompożituri Ġermaniżi	Category:德国作曲家
Kategorija:Kompożituri Awstrijaċi	Category:奧地利作曲家
Kategorija:Mużiċisti Pollakki	Category:波蘭音樂家
Kategorija:Skulturi Taljani	Category:意大利雕塑家
Kategorija:Storiċi Russi	Category:俄羅斯歷史學家
Kategorija:Mużiċisti Norveġiżi	Category:挪威音樂家
Kategorija:Mużiċisti Russi	Category:俄國音樂家
Kategorija:Mużiċisti Brażiljani	Category:巴西音樂家
Kategorija:Mużiċisti Irlandiżi	Category:愛爾蘭音樂家
Kategorija:Mużiċisti Brittaniċi	Category:英國音樂家
Kategorija:Mużiċisti Taljani	Category:義大利音樂家
Kategorija:Mużiċisti Kanadiżi	Category:加拿大音乐家
Kategorija:Mużiċisti Franċiżi	Category:法國音樂家
Kategorija:1829	Category:1829年
Kategorija:Kompożituri Rumeni	Category:羅馬尼亞作曲家
Kategorija:Kompożituri Taljani	Category:意大利作曲家
Kategorija:Mużiċisti Ġermaniżi	Category:德國音樂家
Kategorija:Politiċi Maltin	Category:馬爾他政治人物
Kategorija:Politiċi Taljani	Category:義大利政治人物
Kategorija:Politiċi Franċiżi	Category:法國政治人物
Kategorija:Filosfi Griegi	Category:希腊哲学家
Kategorija:Filosfi Ġermaniżi	Category:德国哲学家
Kategorija:Filosfi Brittaniċi	Category:英國哲學家
Kategorija:Bavarja	Category:巴伐利亚州
Kategorija:Futbolers Niġerjani	Category:尼日利亞足球運動員
Kategorija:Futbolers Rumeni	Category:羅馬尼亞足球運動員
Kategorija:Futbolers Bulgari	Category:保加利亞足球運動員
Kategorija:Futbolers Żvediżi	Category:瑞典足球運動員
Kategorija:Futbolers Skoċċiżi	Category:蘇格蘭足球運動員
Kategorija:.NET	Category:.NET
Kategorija:Futbolers Ekwadorjani	Category:厄瓜多尔足球运动员
Kategorija:Futbolers Urugwajani	Category:烏拉圭足球運動員
Kategorija:Futbolers Eġizzjani	Category:埃及足球運動員
Kategorija:Futbolers Ċiniżi	Category:中国足球运动员
Kategorija:Futbolers Franċiżi	Category:法国足球运动员
Kategorija:Teorija tal-logħob	Category:博弈论
Kategorija:1789	Category:1789年
Kategorija:Mietu fl-1809	Category:1809年逝世
Kategorija:1821	Category:1821年
Kategorija:1828	Category:1828年
Kategorija:1841	Category:1841年
Kategorija:1867	Category:1867年
Kategorija:1873	Category:1873年
Kategorija:1878	Category:1878年
Kategorija:1896	Category:1896年
Kategorija:1963	Category:1963年
Kategorija:Mietu fl-1981	Category:1981年逝世
Kategorija:Mietu fl-1999	Category:1999年逝世
Kategorija:2012	Category:2012年
Kategorija:Sportivi Sud-Koreani	Category:韓國運動員
Kategorija:Imprendituri Amerikani	Category:美国企业家
Kategorija:Inventuri Brittaniċi	Category:英国发明家
Kategorija:Futbolers Torok	Category:土耳其足球運動員
Kategorija:Futbolers Montenegrini	Category:黑山足球運動員
Kategorija:Futbolers Żvizzeri	Category:瑞士足球运动员
Kategorija:Futbolers Spanjoli	Category:西班牙足球運動員
Kategorija:Futbolers Ungeriżi	Category:匈牙利足球运动员
Kategorija:Futbolers Serbi	Category:塞爾維亞足球運動員
Kategorija:Futbolers Taljani	Category:意大利足球运动员
Kategorija:Futbolers Daniżi	Category:丹麦足球运动员
Kategorija:Futbolers Galliċi	Category:威爾斯足球運動員
Kategorija:Futbolers Nord-Irlandiżi	Category:北愛爾蘭足球運動員
Kategorija:Futbolers Irlandiżi	Category:愛爾蘭共和國足球運動員
Kategorija:Futbolers Kolombjani	Category:哥倫比亞足球運動員
Kategorija:Futbolers Kroati	Category:克罗地亚足球运动员
Kategorija:Futbolers Portugiżi	Category:葡萄牙足球运动员
Kategorija:Kantanti Norveġiżi	Category:挪威歌手
Kategorija:Kantanti Brażiljani	Category:巴西歌手
Kategorija:Kantanti Russi	Category:俄罗斯歌手
Kategorija:Kantanti Daniżi	Category:丹麥歌手
Kategorija:Denominazzjonijiet Kristjani	Category:基督教教會與教派
Kategorija:Kategoriji ta' abbozzi	Category:小作品类别
Kategorija:Abbozzi tat-trasport	Category:交通小作品
Kategorija:Abbozzi tal-militar	Category:軍事小作品
Kategorija:Abbozzi tal-matematika	Category:數學小作品
Kategorija:Abbozzi tal-bijoloġija	Category:生物學小作品
Kategorija:Abbozzi tal-ġeografija	Category:地理小作品
Kategorija:Abbozzi ta' ikel u xorb	Category:饮食小作品
Kategorija:Seklu 15	Category:15世纪
Kategorija:Mietu fis-seklu 16	Category:16世纪逝世
Kategorija:Mietu fis-seklu 17	Category:17世纪逝世
Kategorija:Mietu fis-seklu 18	Category:18世纪逝世
Kategorija:Mietu fis-seklu 19	Category:19世纪逝世
Kategorija:Mietu fis-seklu 20	Category:20世纪逝世
Kategorija:Mietu fis-seklu 21	Category:21世纪逝世
Kategorija:Futbol fi New Zealand	Category:紐西蘭足球
Kategorija:Futbol fil-Messiku	Category:墨西哥足球
Kategorija:Futbol fl-Iżvezja	Category:瑞典足球
Kategorija:Futbol fl-Ukrajna	Category:烏克蘭足球
Kategorija:Futbol fil-Kroazja	Category:克羅地亞足球
Kategorija:Futbol fi Franza	Category:法國足球
Kategorija:Ġeorġja	Category:喬治亞
Kategorija:Taljani skont ix-xogħol tagħhom	Category:各職業義大利人
Kategorija:Kantanti Amerikani	Category:美国歌手
Kategorija:Bijoloġi Brittaniċi	Category:英国生物学家
Kategorija:Probabbiltà u statistika	Category:概率与统计
Kategorija:Naturalisti Brittaniċi	Category:英國博物學家
Kategorija:Mużiċisti Żvizzeri	Category:瑞士音樂家
Kategorija:Mużiċisti Ażerbajġani	Category:阿塞拜疆音樂家
Kategorija:Mużiċisti Iżraeljani	Category:以色列音乐家
Kategorija:Ġeoloġi Brittaniċi	Category:英国地质学家
Kategorija:Futbolers Ganiżi	Category:加纳足球运动员
Kategorija:1727	Category:1727年
Kategorija:1744	Category:1744年
Kategorija:1808	Category:1808年
Kategorija:1824	Category:1824年
Kategorija:Mietu fl-1835	Category:1835年逝世
Kategorija:Mietu fl-1868	Category:1868年逝世
Kategorija:Mietu fl-1888	Category:1888年逝世
Kategorija:Mietu fl-1933	Category:1933年逝世
Kategorija:Mietu fl-1961	Category:1961年逝世
Kategorija:1968	Category:1968年
Kategorija:Futbol fir-Russja	Category:俄罗斯足球
Kategorija:Futbol fl-Ekwador	Category:厄瓜多爾足球
Kategorija:Futbol fl-Eġittu	Category:埃及足球
Mudell:Dati pajjiż Repubblika Ċentru-Afrikana	Template:Country data Central African Republic
Kategorija:Plejers ta' FC Spartak Moscow	Category:莫斯科斯巴達球員
Kategorija:Futbol fl-Andorra	Category:安道爾足球
Kategorija:Nies Maltin	Category:马耳他人
Kategorija:Matematiċi Brittaniċi	Category:英国数学家
Kategorija:Futbolers Gambjani	Category:冈比亚足球运动员
Kategorija:Futbolers Griegi	Category:希臘足球運動員
Kategorija:Futbolers Sud-Afrikani	Category:南非足球運動員
Kategorija:Futbolers Litwani	Category:立陶宛足球运动员
Kategorija:Futbolers Maċedoni	Category:馬其頓足球運動員
Kategorija:Futbolers Maltin	Category:马耳他足球运动员
Kategorija:Futbolers Senegaliżi	Category:塞内加尔足球运动员
Kategorija:Futbolers Iżlandiżi	Category:冰島足球運動員
Kategorija:Futbolers Iżraeljani	Category:以色列足球運動員
Kategorija:Futbolers Kamerunjani	Category:喀麥隆足球運動員
Kategorija:1817	Category:1817年
Kategorija:1898	Category:1898年
Kategorija:1998	Category:1998年
Mudell:Klassifika tal-futbol tmiem	Template:Fb cl footer
Kategorija:Libanu	Category:黎巴嫩
Kategorija:Mietu fis-seklu 15	Category:15世纪逝世
Kategorija:Kantanti Ġermaniżi	Category:德國歌手
Kategorija:Kantanti Belġjani	Category:比利時歌手
Kategorija:Kompożituri Irlandiżi	Category:爱尔兰作曲家
Kategorija:Futbolers Messikani	Category:墨西哥足球運動員
Kategorija:2003	Category:2003年
Kategorija:Mietu fis-seklu 14	Category:14世纪逝世
Kategorija:Futbol fid-Danimarka	Category:丹麥足球
Kategorija:Xjenzati Brittaniċi	Category:英國科學家
Kategorija:Mudelli tal-klabbs tal-futbol Taljani	Category:意大利足球俱乐部名单模板
Kategorija:Mudelli ta' tħassir	Category:刪除模板
Kategorija:1971	Category:1971年
Kategorija:Mietu fis-seklu 13	Category:13世纪逝世
Kategorija:Mudelli kkumplikati	Category:精密模板
Mudell:Isem tal-lingwa	Template:ISO 639 name
Kategorija:Abbozzi tal-politika	Category:政治小作品
Kategorija:Abbozzi tal-astronomija	Category:天文小作品
Kategorija:Abbozzi tal-istorja	Category:歷史小作品
Kategorija:Abbozzi tal-arti	Category:艺术小作品
Kategorija:Abbozzi tar-reliġjon	Category:宗教小作品
Mudell:Utent de-4	Template:User de-4
Kategorija:Abbozzi tat-teknoloġija	Category:科学技术小作品
Kategorija:Abbozzi tal-ekonomija	Category:经济学小作品
Kategorija:Futbol Asjatiku	Category:亞洲足球
Kategorija:Futbol fl-Afrika	Category:非洲足球
Kategorija:Futbol fl-Amerika t'Isfel	Category:南美洲足球
Kategorija:Futbol fl-Ewropa	Category:歐洲足球
Kategorija:Futbol fl-Oċeanja	Category:大洋洲足球
Kategorija:Futbol skont il-kontinent	Category:各大洲足球
Kategorija:Plejers ta' PSV Eindhoven	Category:PSV燕豪芬球員
Kategorija:Plejers ta' Aston Villa FC	Category:阿士東維拉球員
Kategorija:Plejers ta' CA Osasuna	Category:奧沙辛拿球員
Kategorija:Plejers ta' AFC Ajax	Category:阿積士球員
Kategorija:Plejers ta' MSV Duisburg	Category:杜伊斯堡球員
Kategorija:Plejers ta' Empoli FC	Category:安玻里球員
Kategorija:Plejers ta' Eintracht Braunschweig	Category:布伦瑞克球员
Kategorija:Plejers tal-Fußball-Bundesliga	Category:德甲球員
Kategorija:Plejers ta' La Liga	Category:西甲球員
Kategorija:Plejers tal-Premier League	Category:英超球員
Kategorija:Plejers tas-Serie A	Category:意甲球員
Kategorija:Plejers tal-Primeira Liga	Category:葡超球員
Kategorija:Plejers tal-Ewwel Diviżjoni Belġjana	Category:比甲球員
Kategorija:Futbolers fil-Bulgarija skont il-klabb	Category:效力保加利亞球會的球員
Kategorija:Plejers tal-Ligue 1	Category:法甲球員
Kategorija:Plejers ta' Tippeligaen	Category:挪超球員
Kategorija:Plejers tal-Eredivisie	Category:荷甲球員
Kategorija:Plejers ta' Red Star Belgrade	Category:貝爾格萊德紅星球員
Kategorija:Plejers ta' FC Basel	Category:巴素利球員
Kategorija:Plejers ta' Bayer 04 Leverkusen	Category:利華古遜球員
Kategorija:Plejers ta' Birmingham City FC	Category:伯明翰城球員
Kategorija:Plejers ta' Blackburn Rovers FC	Category:布力般流浪球員
Kategorija:Plejers ta' VfL Bochum	Category:波琴球員
Kategorija:Plejers ta' Portsmouth FC	Category:樸茨茅夫球員
Kategorija:Plejers ta' Borussia Dortmund	Category:多蒙特球員
Kategorija:Plejers ta' Bolton Wanderers FC	Category:保頓球員
Kategorija:Plejers ta' Piacenza Calcio	Category:皮亞琴察球員
Kategorija:Plejers ta' Charlton Athletic FC	Category:查爾頓球員
Kategorija:Plejers ta' Torino FC	Category:拖連奴球員
Kategorija:Plejers ta' Genoa CFC	Category:熱拿亞球員
Kategorija:Plejers tas-Serie B	Category:意乙球员
Kategorija:Plejers ta' FC Dynamo Moscow	Category:莫斯科戴拿模球員
Kategorija:Plejers ta' Stade de Reims	Category:蘭斯球員
Kategorija:Plejers ta' Racing de Santander	Category:桑坦德球員
Kategorija:Plejers ta' Real Valladolid	Category:華拉度列球員
Kategorija:Plejers ta' R. Charleroi SC	Category:查內爾球員
Kategorija:Plejers ta' Sporting de Gijón	Category:希杭球員
Kategorija:Plejers ta' Real Sociedad	Category:皇家蘇斯達球員
Kategorija:Plejers ta' RCD Mallorca	Category:馬略卡球員
Kategorija:Plejers ta' Recreativo de Huelva	Category:維爾瓦球員
Kategorija:Plejers ta' FC Zürich	Category:蘇黎世球員
Kategorija:Plejers ta' UC Sampdoria	Category:森多利亞球員
Kategorija:Plejers ta' Santos Futebol Clube	Category:山度士球員
Kategorija:Plejers ta' São Paulo Futebol Clube	Category:聖保羅球員
Kategorija:Plejers ta' Sporting Clube de Portugal	Category:士砵亭球員
Kategorija:Plejers ta' Stoke City FC	Category:史篤城球員
Kategorija:Plejers ta' Sunderland AFC	Category:新特蘭球員
Kategorija:Plejers ta' VfB Stuttgart	Category:史特加球員
Kategorija:Plejers ta' Sheffield Wednesday FC	Category:錫周三球員
Kategorija:Plejers ta' Sheffield United FC	Category:錫菲聯球員
Kategorija:Plejers ta' Grêmio Foot-Ball Porto Alegrense	Category:甘美奧球員
Kategorija:Plejers ta' KAA Gent	Category:根特球員
Mudell:Dati pajjiż Wales	Template:Country data Wales
Kategorija:Plejers ta' Fluminense Football Club	Category:富明尼斯球員
Kategorija:Plejers ta' Fulham FC	Category:富咸球員
Kategorija:Plejers ta' FC Carl Zeiss Jena	Category:卡爾斯耶拿球員
Kategorija:Plejers ta' Cagliari Calcio	Category:卡利亞里球員
Kategorija:Plejers ta' AS Cannes	Category:康城球員
Kategorija:Plejers ta' 1. FC Kaiserslautern	Category:凱沙羅頓球員
Kategorija:Futbolers fi Spanja skont il-klabb	Category:效力西班牙球會的球員
Kategorija:Futbolers fl-Iskozja skont il-klabb	Category:效力蘇格蘭球會的球員
Kategorija:Futbolers fil-Portugall skont il-klabb	Category:效力葡萄牙球會的球員
Kategorija:Futbolers fl-Ungerija skont il-klabb	Category:效力匈牙利球會的球員
Kategorija:Futbolers fir-Russja skont il-klabb	Category:效力俄羅斯球會的球員
Kategorija:Futbolers fir-Rumanija skont il-klabb	Category:效力罗马尼亚足球俱乐部的球员
Kategorija:Plejers ta' Cruzeiro Esporte Clube	Category:高士路球員
Kategorija:Plejers ta' Queens Park Rangers FC	Category:昆士柏流浪球員
Kategorija:Imwiet skont is-sena	Category:逝世
Mudell:Dati pajjiż Papwa Ginea Ġdida	Template:Country data Papua New Guinea
Kategorija:Plejers ta' US Lecce	Category:萊切球員
Kategorija:San Marino	Category:聖馬力諾
Kategorija:Liechtenstein	Category:列支敦斯登
Kategorija:Andorra	Category:安道爾
Kategorija:Serbja	Category:塞尔维亚
Kategorija:Pajjiżi skont il-kontinent	Category:各大洲國家
Kategorija:Albanija	Category:阿爾巴尼亞
Kategorija:Pajjiżi tal-Karibew	Category:加勒比海國家
Kategorija:Pajjiżi tal-Oċeanja	Category:大洋洲国家
Kategorija:Pajjiżi tal-Amerika ta' Fuq	Category:北美洲國家
Kategorija:Klabbs tal-futbol Litwani	Category:立陶宛足球俱乐部
Kategorija:Plejers ta' Modena FC	Category:摩德納球員
Kategorija:Plejers ta' AC Monza Brianza 1912	Category:蒙扎球員
Kategorija:Plejers ta' SSC Napoli	Category:拿坡里球員
Kategorija:Plejers ta' Calcio Padova	Category:帕多瓦球員
Kategorija:Plejers ta' Perugia Calcio	Category:佩魯賈球員
Kategorija:Plejers ta' Burnley FC	Category:般尼球員
Kategorija:Plejers ta' Getafe CF	Category:基達菲球員
Kategorija:Plejers ta' Swansea City AFC	Category:史雲斯球員
Kategorija:Plejers ta' Villarreal CF	Category:維拉利爾球員
Kategorija:Plejers ta' Málaga CF	Category:馬拉加球員
Kategorija:Plejers ta' Watford FC	Category:屈福特球員
Kategorija:Plejers ta' Novara Calcio	Category:诺瓦拉球员
Kategorija:Plejers ta' Newcastle United FC	Category:紐卡素球員
Kategorija:Plejers ta' Hannover 96	Category:漢諾威球員
Kategorija:Plejers ta' Huddersfield Town FC	Category:哈德斯菲爾德球員
Kategorija:Plejers ta' Hertha BSC	Category:哈化柏林球員
Kategorija:Plejers ta' Hellas Verona FC	Category:維羅納球員
Kategorija:Plejers ta' Wolverhampton Wanderers FC	Category:狼隊球員
Kategorija:Plejers ta' Wigan Athletic FC	Category:韋根球員
Kategorija:Plejers ta' West Bromwich Albion FC	Category:西布朗球員
Kategorija:Plejers tas-Süper Lig	Category:土超球員
Kategorija:Kowċis tas-Serie A	Category:意甲主教練
Kategorija:Rebbieħa tal-Festival tal-Eurovision	Category:歐洲歌唱大賽冠軍
Kategorija:Referis tal-futbol skond in-nazzjonalita	Category:各國足球裁判
Kategorija:Referis tal-futbol Ingliżi	Category:英格蘭足球裁判
Kategorija:Referis tal-futbol Taljani	Category:意大利足球裁判
Kategorija:Plejers ta' FC Barcelona	Category:巴塞罗那球员
Kategorija:Plejers ta' Valencia CF	Category:華倫西亞球員
Kategorija:Plejers ta' Liverpool FC	Category:利物浦球員
Kategorija:Plejers ta' FC Bayern Munich	Category:拜仁慕尼黑球員
Kategorija:Plejers ta' Manchester City FC	Category:曼城球員
Kategorija:Plejers ta' Atlético Madrid	Category:馬德里體育會球員
Kategorija:Plejers ta' Arsenal FC	Category:阿仙奴球員
Kategorija:Plejers ta' FC Porto	Category:波圖球員
Kategorija:Plejers ta' AS Roma	Category:羅馬球員
Kategorija:Kampjonati tal-futbol nazzjonali	Category:國家頂級足球聯賽
Kategorija:Timijiet nazzjonali tal-futbol	Category:国家足球队
Kategorija:Immaġini b'xejn	Category:自由使用图像
Kategorija:Rivisti tal-logħob	Category:遊戲雜誌
Kategorija:Reġjuni tal-Ewropa	Category:歐洲地區
Kategorija:Oċeani	Category:远洋
Kategorija:Antropoloġija	Category:人类学
Kategorija:Kowċis tal-Primeira Liga	Category:葡超主教練
Kategorija:Pajjiżi stabbiliti fl-2006	Category:2006年建立的國家或政權
Kategorija:Pajjiżi stabbiliti fl-2010	Category:2010年建立的國家與領土
Kategorija:Pajjiżi stabbiliti fl-2011	Category:2011年建立的國家與領土
Kategorija:Bliet tal-Veneżwela	Category:委内瑞拉城市
Mudell:Tim ta' Inter Milan	Template:國際米蘭球員名單
Kategorija:Kowċis fil-Belġju skont il-klabb	Category:比利時球會主教練
Kategorija:Repubbliki	Category:共和国
Kategorija:Chelsea FC	Category:切尔西足球俱乐部
Kategorija:Arsenal FC	Category:阿森纳足球俱乐部
Kategorija:Liverpool FC	Category:利物浦足球俱乐部
Kategorija:Manchester United FC	Category:曼聯足球俱樂部
Kategorija:AC Milan	Category:AC米蘭
Kategorija:Blackburn Rovers FC	Category:布莱克本足球俱乐部
Kategorija:Klabbs tal-futbol Olandiżi	Category:荷蘭足球俱樂部
Kategorija:Tupaja	Category:樹鼩目
Kategorija:Lagomorpha	Category:兔形目
Kategorija:Proboscidea	Category:長鼻目
Kategorija:Hyracoidea	Category:蹄兔目
Kategorija:Kontestanti fil-Festival tal-Eurovision	Category:歐洲歌唱大賽參賽者
Kategorija:Pajjiżi tal-Amerika t'Isfel	Category:南美洲國家
Kategorija:Abbozzi tal-isport	Category:體育小作品
Kategorija:Timijiet nazzjonali tal-futbol Ażjatiċi	Category:亞洲足球代表隊
Kategorija:Timijiet nazzjonali tal-futbol Afrikani	Category:非洲足球代表隊
Kategorija:Timijiet nazzjonali li m'għadhomx jeżistu	Category:过去的国家足球队
Kategorija:Teoristi	Category:理论者
Mudell:Kaxxa tat-tmiem	Template:Rail end
Kategorija:Presidenti ta' Malta	Category:马耳他总统
Mudell:Utent id-4	Template:User id-4
Kategorija:Klabbs tal-futbol tal-Andorra	Category:安道爾足球會
Kategorija:Analisi matematika	Category:数学分析
Kategorija:Sirenia	Category:海牛目
Kategorija:Mitoloġija Griega	Category:希腊神话
Kategorija:Bliet kapitali	Category:首都
Kategorija:Avvenimenti	Category:事件
Kategorija:HIV/AIDS	Category:HIV/AIDS
Kategorija:Tazza Ażjatika tal-Futbol	Category:亞洲盃足球賽
Kategorija:Filatelija	Category:集邮
Kategorija:Arkeoloġija	Category:考古学
Kategorija:Astroloġija	Category:占星學
Kategorija:Logħob Olimpiku tas-sajf 2008	Category:2008年夏季奧林匹克運動會
Kategorija:Ho Chi Minh (belt)	Category:胡志明市
Kategorija:Elettriċità	Category:電學
Kategorija:Posta	Category:邮政
Kategorija:Utenti pl	Category:Pl 使用者
Kategorija:Trasport	Category:交通
Kategorija:Ir-Rivoluzzjoni Franċiża	Category:法国大革命
Kategorija:Żfin	Category:舞蹈
Kategorija:Sports tat-timijiet	Category:團隊運動
Kategorija:Teorija tal-grafi	Category:图论
Kategorija:Teorija tan-numri	Category:数论
Kategorija:Kantanti	Category:歌手
Kategorija:Futbolers	Category:足球运动员
Kategorija:Matematiċi	Category:数学家
Kategorija:Futbolers fl-Italja skont il-klabb	Category:效力意大利球會的球員
Kategorija:Futbolers fl-Olanda skont il-klabb	Category:效力荷蘭球會的球員
Kategorija:Futbolers fl-Ingilterra skont il-klabb	Category:效力英格蘭球會的球員
Kategorija:Futbolers skont il-klabb	Category:足球運動員 (按球會)
Mudell:Bandierapajjiż	Template:Flagcountry
Kategorija:Presidenti tal-Italja	Category:義大利總統
Kategorija:Kompetizzjonijiet tal-futbol fil-Ġermanja	Category:德國足球賽事
Kategorija:Sportivi	Category:运动员
Kategorija:Dermoptera	Category:皮翼目
Kategorija:Skultura	Category:雕塑
Kategorija:Montenegro	Category:黑山
Kategorija:Plejers ta' Everton FC	Category:愛華頓球員
Kategorija:Plejers ta' West Ham United FC	Category:韋斯咸球員
Kategorija:Plejers ta' Manchester United FC	Category:曼聯球員
Kategorija:Kampjonati Ewropej tal-Futbol 2008	Category:2008年歐洲足球錦標賽
Mudell:Hu	Template:Hu icon
Kategorija:Ewropa tat-Tramuntana	Category:北欧
Kategorija:Pajjiżi stabbiliti fl-1917	Category:1917年建立的國家或政權
Kategorija:Pajjiżi stabbiliti fl-1990	Category:1990年建立的行政區劃
Mudell:Utent ga-1	Template:User ga-1
Kategorija:Peramelemorphia	Category:袋狸目
Kategorija:Kultura tal-Veneżwela	Category:委內瑞拉文化
Kategorija:Bliet ta' Malta	Category:马耳他城市
Kategorija:Bliet tal-Vjetnam	Category:越南城市
Kategorija:Bliet kapitali fl-Ewropa	Category:歐洲首都
Kategorija:Partiti politiċi ta' Malta	Category:馬爾他政黨
Kategorija:Plejers ta' Djurgårdens IF Fotboll	Category:佐加頓斯球員
Mudell:Dati pajjiż Renju tal-Bulgarija	Template:Country data Kingdom of Bulgaria
Kategorija:Logħob tal-ballun	Category:球類運動
Kategorija:Ewropa tal-Punent	Category:西欧
Kategorija:Ewropa tan-Nofsinhar	Category:南欧
Kategorija:Storja tal-matematika	Category:數學史
Kategorija:Mudelli tal-klabbs tal-futbol Ingliżi	Category:英格兰足球俱乐部名单模板
Kategorija:Gwida essenzjali tal-Wikipedija	Category:维基百科使用指南
Mudell:Żoni tal-ħin	Template:Timezones
Kategorija:Plejers ta' Lille OSC	Category:里尔球员
Kategorija:Abbozzi tal-antropoloġija	Category:人类学小作品
Kategorija:Abbozzi tal-lingwistika	Category:語言學小作品
Kategorija:Plejers ta' Millwall FC	Category:米禾爾球員
Mudell:Fb-lemin	Template:Fb-rt
Kategorija:Etoloġi	Category:動物行為學家
Kategorija:Kowċis ta' Juventus FC	Category:祖雲達斯主教練
Kategorija:Kowċis ta' FC Barcelona	Category:巴塞隆拿主教練
Kategorija:Kowċis ta' Real Madrid CF	Category:皇家馬德里主教練
Kategorija:Kowċis ta' Borussia Mönchengladbach	Category:慕遜加柏主教練
Kategorija:Kowċis ta' Borussia Dortmund	Category:多蒙特主教練
Kategorija:Kowċis ta' FC Bayern Munich	Category:拜仁慕尼黑主教練
Kategorija:Klabbs tal-futbol Belġjani	Category:比利时足球俱乐部
Kategorija:L-Ewwel Diviżjoni Belġjana	Category:比利時足球甲級聯賽
Kategorija:Saħħa	Category:健康
Kategorija:Futbolers fil-Ġermanja skont il-klabb	Category:效力德國球會的球員
Mudell:Dati pajjiż Spanja	Template:Country data Spain
Mudell:PD-qadim	Template:PD-old
Kategorija:Grawnds tal-futbol skont il-pajjiż	Category:各國足球場
Mudell:Dati pajjiż Kanada	Template:Country data Canada
Mudell:Klassifika tal-futbol bidu	Template:Fb cl header
Kategorija:Klabbs tal-futbol Russi	Category:俄罗斯足球俱乐部
Mudell:Bandiera	Template:Flag
Mudell:Dati pajjiż Angwilla	Template:Country data Anguilla
Mudell:Dati pajjiż Barbados	Template:Country data Barbados
Mudell:Dati pajjiż Bermuda	Template:Country data Bermuda
Mudell:Dati pajjiż Bonaire	Template:Country data Bonaire
Mudell:Dati pajjiż Gżejjer Verġni Brittaniċi	Template:Country data British Virgin Islands
Mudell:Dati pajjiż Gżejjer Kokos	Template:Country data Cocos (Keeling) Islands
Mudell:Dati pajjiż Komunità tal-Istati Indipendenti	Template:Country data Commonwealth of Independent States
Mudell:Dati pajjiż Reġjun Fjamming	Template:Country data Flemish Region
Mudell:Dati pajjiż Renju tal-Jugożlavja	Template:Country data Kingdom of Yugoslavia
Mudell:Dati pajjiż Martinika	Template:Country data Martinique
Mudell:Dati pajjiż Antilli Olandiżi	Template:Country data Netherlands Antilles
Mudell:Dati pajjiż Singapor	Template:Country data Singapore
Kategorija:Mudelli tat-timijiet tat-Tazza tal-Konfederazzjonijiet 2009	Category:2009年聯合會盃足球賽參賽名單模板
Kategorija:Mudelli tal-klabbs tal-futbol Spanjoli	Category:西班牙足球俱乐部名单模板
Mudell:Utent pl-4	Template:User pl-4
Kategorija:Abbozzi tax-xjenza	Category:科學小作品
Kategorija:Plejers ta' US Avellino	Category:阿韋利諾球員
Kategorija:Plejers ta' Albacete Balompié	Category:阿爾巴塞特球員
Kategorija:Plejers ta' Royal Antwerp FC	Category:安特卫普球员
Kategorija:Plejers ta' FC Aarau	Category:阿勞球員
Kategorija:Plejers ta' Brighton & Hove Albion FC	Category:白禮頓球員
Kategorija:Plejers ta' Bristol City FC	Category:布里斯托城球員
Kategorija:Plejers ta' RKC Waalwijk	Category:華域克球員
Kategorija:Plejers ta' Valletta FC	Category:瓦萊塔球員
Kategorija:Plejers ta' Wellington Phoenix FC	Category:威靈頓鳳凰球員
Kategorija:Plejers ta' Chivas de Guadalajara	Category:瓜達拉哈拉球員
Kategorija:Plejers ta' KRC Genk	Category:KRC亨克球員
Kategorija:Plejers ta' Beerschot AC	Category:比斯查球員
Kategorija:Plejers ta' SV Zulte Waregem	Category:祖爾特瓦雷根球員
Kategorija:Plejers ta' FC Crotone	Category:克罗托内球员
Kategorija:Plejers ta' Lillestrøm SK	Category:利尼史特朗球員
Kategorija:Plejers ta' Luton Town FC	Category:盧頓球員
Kategorija:Plejers ta' Lierse SK	Category:利爾斯球員
Kategorija:Plejers ta' FC Lucerne	Category:盧塞恩球員
Kategorija:Plejers ta' KV Mechelen	Category:梅赫倫球員
Kategorija:Plejers ta' CD Nacional	Category:国民体育会球员
Kategorija:Plejers ta' AC Omonia	Category:奧摩尼亞球員
Kategorija:Plejers ta' SK Rapid Wien	Category:維也納迅速球員
Kategorija:Plejers ta' Rimini Calcio FC	Category:里米尼球員
Kategorija:Plejers ta' FC St. Gallen	Category:聖加侖球員
Kategorija:Plejers ta' FK Sarajevo	Category:薩拉熱窩球員
Kategorija:Plejers ta' Servette FC	Category:塞維特球員
Kategorija:Plejers ta' Cercle Brugge KSV	Category:色格拉布魯日球員
Kategorija:Plejers ta' Standard Liège	Category:標準列治球員
Kategorija:Plejers ta' FC Sion	Category:錫永球員
Kategorija:Plejers ta' KF Tirana	Category:地拉那球員
Kategorija:Plejers ta' Ferencváros TC	Category:費倫茨瓦羅斯球員
Kategorija:Plejers ta' Hibernian FC	Category:喜百年球員
Kategorija:Plejers ta' Hull City AFC	Category:侯城球員
Kategorija:Plejers ta' Chester City FC	Category:車士打球員
Kategorija:Plejers ta' Shamrock Rovers FC	Category:沙洛克流浪球員
Kategorija:Plejers ta' BSC Young Boys	Category:年輕人球員
Kategorija:Plejers ta' PFC CSKA Sofia	Category:索菲亞中央陸軍球員
Portal:Matematika	Portal:数学
Kategorija:Mużiċisti Litwani	Category:立陶宛音乐家
Kategorija:Kompożituri Iżlandiżi	Category:冰岛作曲家
Timijiet parteċipanti fit-Tazza tad-Dinja tal-Futbol 2006	2006年世界杯足球赛参赛名单
Kategorija:Lingwi Internazzjonali Awżiljari	Category:国际辅助语言
Kategorija:Template PD	Category:公有領域版權模板
Kategorija:William Shakespeare	Category:威廉·莎士比亚
Kategorija:Wolverhampton Wanderers FC	Category:伍尔弗汉普顿流浪足球俱乐部
Kategorija:Galatasaray SK	Category:加拉塔薩雷體育俱樂部
Kategorija:Plejers ta' Galatasaray SK	Category:加拉塔沙雷球員
Kategorija:Mudelli tal-mużika	Category:音樂模板
Kategorija:Mudelli ta' protezzjoni	Category:保護模板
Mudell:Infobox Kulur	Template:Infobox color
Kategorija:Kompożituri	Category:作曲家
Kategorija:Kowċis ta' CD Tenerife	Category:特內里費主教練
Kategorija:Macroscelididae	Category:象鼩
Kategorija:Futbolers f'Ċipru skont il-klabb	Category:效力塞浦路斯球會的球員
Kategorija:Pajjiżi Amerikani	Category:美洲国家
Mudell:Kampjonati tal-UEFA	Template:歐洲頂級足球聯賽
Mudell:Kimika	Template:化学分支
Mudell:Skwadra Ġermaniża Kampjonati Ewropej tal-Futbol 2012	Template:2012年欧洲足球锦标赛德国参赛名单
Mudell:Skwadra Ġermaniża Tazza tad-Dinja tal-Futbol 2006	Template:2006年世界杯足球赛德国参赛名单
Mudell:FIFA Puskás Award	Template:国际足联普斯卡什奖得主
Mudell:Plejer tas-Sena tal-FIFA	Template:國際足協世界足球先生
Kategorija:Mudelli semi-protetti	Category:被半保護的模板
Mudell:Utent scn-3	Template:User scn-3
Mudell:Utent scn-2	Template:User scn-2
Mudell:Utent hi-2	Template:User hi-2
Kategorija:Artikli li jeħtieġu aġġornament	Category:待更新条目
Mudell:Utent ga	Template:User ga
Mudell:Suboff	Template:Suboff
Mudell:Sent off	Template:Sent off
Mudell:Oc	Template:Oc icon
Mudell:Mt	Template:Mt icon
Mudell:MLT	Template:MLT
Kategorija:Plejers ta' FC Dynamo Kyiv	Category:基辅迪纳摩球员
Mudell:Dati pajjiż Prussja	Template:Country data Prussia
Mudell:Kontribuzzjonijiet utent	Template:User contrib
Kategorija:Tazza tad-Dinja tal-Futbol 2006	Category:2006年世界盃足球賽
Kategorija:Kwalifikazzjoni għat-Tazza tad-Dinja tal-Futbol 2010	Category:2010年世界盃外圍賽
Kategorija:Grawnds tal-futbol fil-Ġermanja	Category:德國足球場
Kategorija:Plejers ta' AC ChievoVerona	Category:基爾禾球員
Kategorija:Kowċis ta' AC Milan	Category:AC米蘭主教練
Kategorija:Plejers ta' AFC Bournemouth	Category:般尼茅夫球員
Kategorija:ACF Fiorentina	Category:佛羅倫薩足球俱樂部
Kategorija:Plejers ta' ACF Fiorentina	Category:費倫天拿球員
Kategorija:Plejers ta' AS Monaco FC	Category:摩納哥球員
Kategorija:Plejers ta' AS Saint-Étienne	Category:聖伊天球員
Kategorija:Abbozzi tal-agrikoltura	Category:农业小作品
Kategorija:Klabbs tal-futbol stabbiliti fl-1874	Category:1874年建立的足球俱樂部
Kategorija:Klabbs tal-futbol stabbiliti fl-1875	Category:1875年建立的足球俱樂部
Kategorija:Klabbs tal-futbol stabbiliti fl-1881	Category:1881年建立的足球俱樂部
Kategorija:Klabbs tal-futbol stabbiliti fl-1890	Category:1890年建立的足球俱樂部
Kategorija:Klabbs tal-futbol stabbiliti fl-1898	Category:1898年建立的足球俱樂部
Kategorija:Klabbs tal-futbol stabbiliti fl-1908	Category:1908年建立的足球俱樂部
Kategorija:Klabbs tal-futbol stabbiliti fl-1923	Category:1923年建立的足球俱樂部
Kategorija:Klabbs tal-futbol stabbiliti fl-1931	Category:1931年建立的足球俱樂部
Kategorija:Klabbs tal-futbol stabbiliti fl-2009	Category:2009年建立的足球俱乐部
Kategorija:Klabbs tal-futbol stabbiliti fl-1997	Category:1997年建立的足球俱樂部
Kategorija:Federazzjonijiet tal-futbol	Category:足球組織
Kategorija:Kowċis skont il-klabb	Category:依球會劃分的足球主教練
Kategorija:Futbolers fi New Zealand skont il-klabb	Category:效力新西蘭球會的球員
Kategorija:Futbolers fl-Irlanda skont il-klabb	Category:效力愛爾蘭球會的球員
Kategorija:Plejers ta' Atalanta BC	Category:亞特蘭大球員
Kategorija:Kowċis ta' Athletic Bilbao	Category:畢爾包主教練
Kategorija:Plejers ta' Barnsley FC	Category:巴恩斯利球员
Kategorija:Kowċis ta' Bayer 04 Leverkusen	Category:利華古遜主教練
Mudell:Tim ta' Valencia CF	Template:華倫西亞足球會球員名單
Kategorija:Plejers ta' Boca Juniors	Category:小保加球員
Kategorija:Borussia Dortmund	Category:多蒙特足球會
Mudell:Dati pajjiż Gwadelup	Template:Country data Guadeloupe
Kategorija:Referis tal-futbol Brażiljani	Category:巴西足球裁判
Kategorija:Pajjiżi tal-Amerika Ċentrali	Category:中美洲國家
Mudell:TOCleft	Template:TOCleft
Kategorija:Kowċis ta' Club Brugge KV	Category:布魯日主教練
Kategorija:Abbozzi tal-edukazzjoni	Category:教育小作品
Kategorija:Kowċis ta' Eintracht Frankfurt	Category:法蘭克福主教練
Kategorija:Plejers ta' Eintracht Frankfurt	Category:法蘭克福球員
Kategorija:Kowċis tal-Eredivisie	Category:荷甲主教練
Kategorija:Plejers Ewropej tas-Sena	Category:歐洲足球先生
Kategorija:Plejers ta' FC Admira Wacker Mödling	Category:艾特米拿球員
Kategorija:FC Barcelona	Category:巴塞羅那足球俱樂部
Kategorija:FC Bayern Munich	Category:拜仁慕尼黑足球俱乐部
Kategorija:Plejers ta' FC Girondins de Bordeaux	Category:波爾多球員
Kategorija:Plejers ta' FC Lausanne-Sport	Category:洛桑体育球员
Kategorija:Kowċis ta' FC Schalke 04	Category:史浩克零四主教練
Kategorija:Plejers ta' FC Schalke 04	Category:史浩克零四球員
Kategorija:Plejers ta' FC Sochaux-Montbéliard	Category:索察球員
Kategorija:Plejers ta' FC Thun	Category:圖恩球員
Kategorija:Plejers ta' FC Utrecht	Category:烏德勒支球員
Kategorija:Tazza tad-Dinja tal-Futbol tal-Klabbs	Category:世界冠軍球會盃
Kategorija:Tazza tad-Dinja tal-Futbol	Category:世界杯足球赛
Kategorija:Plejers tas-Sena tal-FIFA	Category:世界足球先生
Kategorija:Plejers ta' FK Partizan	Category:柏迪遜球員
Kategorija:Klabbs tal-futbol Awstrijaċi	Category:奧地利足球俱樂部
Kategorija:Klabbs tal-futbol Bożnijaċi	Category:波黑足球俱乐部
Kategorija:Klabbs tal-futbol Estonjani	Category:爱沙尼亚足球俱乐部
Kategorija:Klabbs tal-futbol Iżraeljani	Category:以色列足球會
Kategorija:Klabbs tal-futbol Serbi	Category:塞尔维亚足球俱乐部
Kategorija:Futbol fil-Korea t'Isfel	Category:韩国足球
Kategorija:Kowċis fil-Portugall skont il-klabb	Category:葡萄牙球會主教練
Kategorija:Kowċis fl-Olanda skont il-klabb	Category:荷蘭球會主教練
Kategorija:Grawnds tal-futbol fil-Belġju	Category:比利時足球場
Kategorija:Futbolers fl-Arġentina skont il-klabb	Category:效力阿根廷球會的球員
Kategorija:Futbolers fil-Belġju skont il-klabb	Category:效力比利時球會的球員
Kategorija:Futbolers fil-Bożnija u Ħerżegovina skont il-klabb	Category:效力波斯尼亞和黑塞哥維那球會的球員
Kategorija:Futbolers fil-Brażil skont il-klabb	Category:效力巴西球會的球員
Kategorija:Futbolers fl-Ekwador skont il-klabb	Category:效力厄瓜多爾球會的球員
Kategorija:Futbolers fi Franza skont il-klabb	Category:效力法國球會的球員
Kategorija:Futbolers fil-Greċja skont il-klabb	Category:效力希臘球會的球員
Kategorija:Futbolers fl-Iżrael skont il-klabb	Category:效力以色列球會的球員
Kategorija:Futbolers f'Malta skont il-klabb	Category:效力馬耳他球會的球員
Kategorija:Futbolers fil-Messiku skont il-klabb	Category:效力墨西哥球會的球員
Kategorija:Futbolers fin-Norveġja skont il-klabb	Category:效力挪威球會的球員
Kategorija:Futbolers fis-Serbja skont il-klabb	Category:效力塞爾維亞球會的球員
Kategorija:Futbolers fil-Korea t'Isfel skont il-klabb	Category:效力韩国俱乐部的球员
Kategorija:Futbolers fl-Iżvezja skont il-klabb	Category:效力瑞典球會的球員
Kategorija:Futbolers fl-Iżvizzera skont il-klabb	Category:效力瑞士球會的球員
Kategorija:Futbolers fit-Turkija skont il-klabb	Category:效力土耳其球會的球員
Kategorija:Futbolers fl-Urugwaj skont il-klabb	Category:效力烏拉圭球會的球員
Mudell:Preċiżjoni1	Template:Precision1
Mudell:Preċiżjoni/tz/1	Template:Precision/tz/1
Kategorija:Plejers ta' Grasshopper-Club Zürich	Category:蘇黎世草蜢球員
Kategorija:Plejers ta' Hamburger SV	Category:漢堡球員
Kategorija:Abbozzi tas-saħħa	Category:醫學小作品
Kategorija:Kowċis ta' Inter Milan	Category:國際米蘭主教練
Kategorija:Plejers ta' Inter Milan	Category:國際米蘭球員
Kategorija:Plejers ta' Ipswich Town FC	Category:葉士域治球員
Kategorija:Preżentaturi televiżivi Taljani	Category:義大利電視主持人
Għajnuna:Kronoloġija	Help:页面历史
Kategorija:Kowċis fil-Ġermanja skont il-klabb	Category:德國球會主教練
Kategorija:Kowċis fi Spanja skont il-klabb	Category:西班牙球會主教練
Kategorija:Plejers ta' Juventus FC	Category:祖雲達斯球員
Kategorija:Ordni Militari Sovran ta' Malta	Category:馬爾他騎士團
Kategorija:Logħob lingwistiku	Category:语言游戏
Kategorija:Plejers ta' Larissa FC	Category:拉里沙球員
Kategorija:Plejers ta' Legia Warszawa	Category:歷基亞球員
Portal:Kimika	Portal:化学
Kategorija:Plejers ta' Macclesfield Town FC	Category:馬爾斯菲球員
Kategorija:Abbozzi tal-letteratura	Category:文學小作品
Kategorija:Kompożituri Maltin	Category:马耳他作曲家
Kategorija:Plejers ta' Mansfield Town FC	Category:曼斯菲球員
Kategorija:Kowċis ta' RSC Anderlecht	Category:安德列治主教練
Kategorija:Plejers ta' RSC Anderlecht	Category:安德列治球員
Kategorija:Kowċis ta' R. Charleroi SC	Category:查內爾主教練
Kategorija:Plejers ta' RC Strasbourg	Category:斯特拉斯堡球員
Kategorija:Plejers ta' Racing Club	Category:競賽會球員
Kategorija:Mikelanġlu	Category:米开朗基罗
Kategorija:Plejers ta' Real Madrid CF	Category:皇家馬德里球員
Kategorija:Plejers ta' Real Zaragoza	Category:薩拉戈薩球員
Kategorija:Plejers ta' NEC Nijmegen	Category:奈梅亨球員
Kategorija:Plejers ta' River Plate	Category:河床球員
Kategorija:Kompożituri Romantiċi	Category:浪漫主義作曲家
Kategorija:Plejers ta' Rosario Central	Category:羅沙里奧中央球員
Kategorija:Kowċis ta' SL Benfica	Category:賓菲加主教練
Kategorija:Plejers ta' SS Lazio	Category:拉素球員
Kategorija:Abbozzi tas-sesswalità	Category:性愛與生育小作品
Kategorija:Abbozzi tal-filosofija	Category:哲学小作品
Kategorija:Plejers ta' SC Heerenveen	Category:海倫芬球員
Kategorija:SK Rapid Wien	Category:維也納迅速足球俱樂部
Kategorija:Plejers ta' SV Werder Bremen	Category:雲達不來梅球員
Kategorija:Ortografija	Category:正寫法
Kategorija:Plejers ta' PFC CSKA Moscow	Category:莫斯科中央陸軍球員
Kategorija:Pitturi ta' Pablo Picasso	Category:畢加索畫作
Kategorija:Plejers ta' Parma FC	Category:帕爾馬球員
Kategorija:Lingwi Semitiċi	Category:闪米特语族
Kategorija:Futbolers fl-Istati Uniti skont il-klabb	Category:效力美國球會的球員
Kategorija:Grawnds tal-futbol fl-Afrika t'Isfel	Category:南非足球場
Kategorija:Plejers ta' Sociedade Esportiva Palmeiras	Category:彭美拉斯球員
Kategorija:Referis tal-futbol Spanjoli	Category:西班牙足球裁判
Kategorija:Mużewijiet sportivi	Category:體育博物館
Kategorija:Ludwig van Beethoven	Category:贝多芬
Kategorija:Ateiżmu	Category:无神论
Kategorija:Plejers ta' Stade Rennais FC	Category:雷恩球員
Kategorija:Kowċis ta' Standard Liège	Category:標準列治主教練
Kategorija:Artikli fi traduzzjoni	Category:正在翻譯的條目
Kategorija:Pajjiżi skond is-sena li spiċċaw	Category:每年終結的國家或政權
Kategorija:Pajjiżi li spiċċaw fl-1964	Category:1964年終結的國家或政權
Kategorija:Pajjiżi stabbiliti fl-2008	Category:2008年建立的国家与领土
Kategorija:Plejers ta' Swindon Town FC	Category:史雲頓球員
Kategorija:Edizzjonijiet tal-Kampjonati Ewropej tal-Futbol	Category:歐洲足球錦標賽
Kategorija:Kompożituri Klassiċi	Category:古典音樂作曲家
Mudell:Dati pajjiż Repubblika Għarbija Magħquda	Template:Country data United Arab Republic
Kategorija:Didelphimorphia	Category:负鼠目
Kategorija:Bolol	Category:邮票
Kategorija:Xjenza Applikati	Category:应用科学
Kategorija:Għall-kontroll	Category:准确性有争议的作品
Kategorija:Ewropa Ċentrali	Category:中欧
Kategorija:Trattati tal-Unjoni Ewropea	Category:歐盟條約
Kategorija:Futbol fil-Maċedonja	Category:馬其頓足球
Kategorija:Football League	Category:英格蘭足球聯賽
Kategorija:Logħob tat-tfal	Category:儿童游戏
Kategorija:Provinċja ta' Bergamo	Category:貝爾加莫省
Kategorija:Kantanti Bulgari	Category:保加利亞歌手
Mudell:Xjenzi soċjali	Template:社會科學
Kategorija:Kantanti Żvizzeri	Category:瑞士歌手
Kategorija:Plejers ta' Beşiktaş JK	Category:比錫達斯球員
Kategorija:Plejers ta' Chelsea FC	Category:車路士球員
Kategorija:Plejers ta' Club Brugge KV	Category:布魯日球員
Kategorija:Plejers ta' Coventry City FC	Category:高雲地利球員
Kategorija:Plejers ta' Neuchâtel Xamax	Category:納沙泰爾球員
Kategorija:Plejers ta' Nottingham Forest FC	Category:諾定咸森林球員
Kategorija:Plejers ta' Panathinaikos	Category:帕纳辛奈科斯球员
Kategorija:Plejers ta' Paris Saint-Germain FC	Category:巴黎聖日門球員
Kategorija:Plejers ta' Tottenham Hotspur FC	Category:熱刺球員
Kategorija:Plejers ta' VfL Wolfsburg	Category:禾夫斯堡球員
Kategorija:Plejers ta' Wrexham FC	Category:域斯咸球員
Kategorija:Plejers ta' 1. FC Köln	Category:科隆球員
Kategorija:Plejers ta' OGC Nice	Category:尼斯球員
Kategorija:Plejers ta' Olympique Lyonnais	Category:里昂球員
Kategorija:Pedagoġija	Category:教育學
Serie A 2013–14	2013年至2014年意大利足球甲级联赛
Kategorija:Sports ta' preċiżjoni	Category:精確性運動
Kategorija:Preistorja	Category:史前史
Kategorija:Drammi ta' William Shakespeare	Category:莎士比亞戲劇作品
Kategorija:Mużiċisti Torok	Category:土耳其音乐家
Kategorija:Mużiċisti Bjelorussi	Category:白俄羅斯音樂
Kategorija:Artikli fi bżonn ta' analiżi grammatikali	Category:需要校對的頁面
Kategorija:Xogħol għaddej	Category:正在编辑的条目
Kategorija:Abbozzi tal-arkitettura	Category:建築小作品
Għajnuna:Gwida essenzjali/Sorsi	Wikipedia:使用指南/外部链接
Mudell:Infobox Gazzetta	Template:Infobox Newspaper
Mudell:IMSLP	Template:IMSLP
Kategorija:Abbozzi ta' organizzazzjonijiet	Category:組織小作品
Kategorija:Utenti en-1	Category:En-1 使用者
Kategorija:Twieldu fl-1930	Category:1930年出生
Kategorija:Twieldu fl-1946	Category:1946年出生
Kategorija:Utenti de-1	Category:De-1 使用者
Kategorija:Twieldu fl-1920	Category:1920年出生
Kategorija:Twieldu fl-1956	Category:1956年出生
Kategorija:Twieldu fl-1933	Category:1933年出生
Kategorija:Twieldu fl-1911	Category:1911年出生
Kategorija:Twieldu fl-1937	Category:1937年出生
Kategorija:Twieldu fl-1948	Category:1948年出生
Kategorija:Mudelli protetti	Category:被保護的模板
Kategorija:Mietu fl-1978	Category:1978年逝世
Kategorija:Twieldu fl-1921	Category:1921年出生
Kategorija:Twieldu fl-1924	Category:1924年出生
Kategorija:Twieldu fl-1926	Category:1926年出生
Kategorija:Twieldu fl-1950	Category:1950年出生
Kategorija:Twieldu fl-1964	Category:1964年出生
Kategorija:Atturi Amerikani	Category:美国演员
Kategorija:Mietu fl-1979	Category:1979年逝世
Kategorija:Mietu fl-2010	Category:2010年逝世
Kategorija:Mużiċisti Rumeni	Category:羅馬尼亞音樂家
Mudell:Fb cl2 header navbar	Template:Fb cl2 header navbar
Mudell:Nowrap begin	Template:Nowrap begin
Mudell:Soccerbase	Template:Soccerbase
Mudell:Tim ta' Sunderland AFC	Template:新特蘭球員名單
Mudell:Tim ta' Borussia Dortmund	Template:多蒙特球員名單
Mudell:Tim ta' VfL Wolfsburg	Template:禾夫斯堡球員名單
Mudell:Tim ta' SS Lazio	Template:拉素球員名單
Mudell:Fbf	Template:Fbw
Mudell:Traduzzjoni	Template:NotMandarin
Mudell:Kwalifikazzjoni għat-Tazza tad-Dinja tal-Futbol 2010	Template:2010年世界盃外圍賽
Għajnuna:Żbalji komuni fl-użu tal-Wikipedija	Wikipedia:避免常见错误
Għajnuna:Medja	Wikipedia:媒體幫助
Mudell:Coord/negzeropad	Template:Coord/negzeropad
Wikipedija:Ċaħda medika	Wikipedia:医学声明
Mudell:Kunsill Nordiku	Template:Nordic Council
Kategorija:Premier League	Category:英格蘭足球超級聯賽
Mudell:Tim ta' Real Madrid CF	Template:皇家马德里
Dasykaluta	西澳袋鼬属
Dasyuroides	蓬尾袋鼬属
Għajnuna:Gwida essenzjali/Diskussjoni	Wikipedia:新手入門/討論
Għajnuna:Gwida essenzjali/Linji gwida	Wikipedia:新手入門/方針指引
Mudell:Tim ta' Wigan Athletic FC	Template:韋根球員名單
Mudell:Userbox-livell	Template:Userbox-level
Wikipedija:Traduzzjoni tal-ġimgħa	Wikipedia:每周翻译
Mudell:Nat fs g player	Template:Nat fs g player
Mudell:...	Template:Empty section
Mudell:Skwadra Spanjola Tazza tal-Konfederazzjonijiet 2009	Template:2009年聯合會盃足球賽西班牙參賽名單
Mudell:Skwadra Taljana Tazza tal-Konfederazzjonijiet 2009	Template:2009年聯合會盃足球賽意大利參賽名單
Mudell:Amerika ta' Fuq	Template:北美洲主題
Għajnuna:Gwida essenzjali/Konklużjoni	Wikipedia:新手入門/總結
Mudell:Ifeq	Template:Ifequal
Mudell:Tim ta' Manchester City FC	Template:曼城球員名單
Mudell:Infobox kompetizzjoni sportiva	Template:Infobox sports league
Mudell:MSAPI	Template:Microsoft APIs
Mudell:Utent scn	Template:User scn
Mudell:Federazzjonijiet tal-UEFA	Template:歐洲足聯國家足球協會
Mudell:Skwadra Slovena Tazza tad-Dinja tal-Futbol 2010	Template:2010年世界盃足球賽斯洛文尼亞參賽名單
Għajnuna:Paġna kwalunkwe	Help:随机页面
Mudell:Utent mt-1	Template:User mt-1
Mudell:Utent mt-2	Template:User mt-2
Mudell:Superliga Albaniża	Template:阿爾巴尼亞超級足球聯賽
Mudell:Tim ta' Liverpool FC	Template:利物浦球員名單
Mudell:Tim ta' Birmingham City FC	Template:伯明翰球員名單
Mudell:Tim ta' Hull City AFC	Template:侯城球員名單
Mudell:Tim ta' Aston Villa FC	Template:阿士東維拉球員名單
Wikipedija:Ċaħda fuq il-kontenut	Wikipedia:内容声明
Mudell:Lfpfr	Template:Lfpfr
Mudell:Tim ta' Tottenham Hotspur FC	Template:熱刺球員名單
Mudell:Tim ta' Villareal CF	Template:維拉利爾足球會
Murexia	林袋鼬属
Wikipedija:VisualEditor	Wikipedia:可视化编辑器
Mudell:Tim ta' Paris Saint-Germain FC	Template:巴黎聖日耳門球員名單
Mudell:Skwadra Taljana Kampjonati Ewropej tal-Futbol 2012	Template:2012年欧洲足球锦标赛意大利参赛名单
Mudell:Utent mt-3	Template:User mt-3
Premier League 2013–14	2013年至2014年英格兰足球超级联赛
Kategorija:Abbozzi ta' logħob	Category:游戏小作品
Mudell:Tim ta' Olympique Lyonnais	Template:里昂足球俱乐部
Mudell:Tim ta' Fulham FC	Template:富咸球員名單
Mudell:Transfermarkt	Template:Transfermarkt
Mudell:Fb-kbira	Template:Fb-big
Mudell:Skwadra Brażiljana Tazza tal-Konfederazzjonijiet 2013	Template:2013年聯合會盃足球賽巴西參賽名單
Mudell:Utent mt	Template:User mt
Birdman (film)	鳥人 (2014年電影)
Mudell:Skwadra Ġermaniża Kampjonati Ewropej tal-Futbol 2004	Template:2004年欧洲足球锦标赛德国参赛名单
Mudell:Hs	Template:Hs
Mudell:Infobox weather/line	Template:Infobox Weather/line
Mudell:Infobox Temp/kolp	Template:Infobox weather/colp
Mudell:Infobox Temp/kolt	Template:Infobox weather/colt
Mudell:Skwadra Taljana Tazza tal-Konfederazzjonijiet 2013	Template:2013年聯合會盃足球賽意大利參賽名單
Edward Snowden	爱德华·斯诺登
Mudell:Rawnd16	Template:Round16
Mudell:VisualEditor	Template:VisualEditor navbox
Microbiotheria	微獸目
Mudell:Dati pajjiż Kamerun	Template:Country data Cameroon
Coreca	科雷卡
Speċjali:TibdilRiċenti	Special:最近更改
Neophascogale	长爪袋鼬属
Kategorija:Utenti ja-4	Category:Ja-4 使用者
Module:Navbox	模块:Navbox
Kategorija:Mietu fl-1976	Category:1976年逝世
Kategorija:Mietu fl-1975	Category:1975年逝世
Kategorija:Mietu fl-1974	Category:1974年逝世
Krimea	克里米亞共和國
Kategorija:Pajjiżi stabbiliti fl-2014	Category:2014年建立的國家或政權
