افريقا	非洲
جاپان	日本
سوېلي امريکا	南美洲
ناروې	挪威
د آيرلېنډ جمهوريت	爱尔兰共和国
هنگري	匈牙利
اسپانیا	西班牙
د امریکا متحده ایالتونه	美国
بلجیم	比利时
لوگزامبورگ	卢森堡
ځمکه	地球
ژوند	生命
انسان	人
فېنلانډ	芬兰
سويډن	瑞典
ډېنمارک	丹麦
پولنډ	波兰
لېتوانيا	立陶宛
اېټاليا	意大利
سويس	瑞士
اتريش	奥地利
يونان	希腊
تورکيه	土耳其
بير	啤酒
پرتگال	葡萄牙
اروپا	欧洲
آسيا	亚洲
شمالي امريکا	北美洲
انټارکټيکا	南极洲
ويکيپېډيا	维基百科
هالنډ	荷兰
نيويارک (ښار)	纽约
واشنگټن ډي سي	华盛顿哥伦比亚特区
برلين	柏林
سولگر	電子計算機
څوریخ	苏黎世
انټرنټ	互联网
باراک حسين اوباما	贝拉克·奥巴马
لندن	伦敦
قاهره	开罗
مڼه	苹果
پاريس	巴黎
گووگل	Google
اتلانتيک سمندر	大西洋
غلی سمندر	太平洋
کالېفورنیا	加利福尼亚州
دونۍ	星期一
جنوري	1月
فبروري	2月
مارچ	3月
مريخ	火星
کېنيا	肯尼亚
اېتوپیا	埃塞俄比亚
گانا	加纳
اپرېل	4月
مې	5月
جون	6月
جولای	7月
اگسټ	8月
سپټمبر	9月
اکتوبر	10月
نومبر	11月
ډيسمبر	12月
درې نۍ	星期二
شورو	星期三
زيارت	星期四
جمعه	星期五
خالي	星期六
يونۍ	星期日
زمری	狮
فرانسه	法国
سپی	犬
بريتانيا	英国
پيشو	猫
چين د خلکو جمهوريت	中华人民共和国
فرانسوي ژبه	法语
اېتنول	乙醇
برازیل	巴西
روسیه	俄罗斯
نهنگ	鯨目
څلوريځ (مېچپوهنه)	正方形
بوینگ ۷۴۷	波音747
ويکيمېډيا بنسټ	维基媒体基金会
آلمان	德国
بېلاروس	白俄罗斯
آلماني ژبه	德语
آيسلېنډ	冰岛
الله	神 (一神教)
اېسټونيا	爱沙尼亚
زحل	土星
الوتکه	固定翼飛機
جگړه	战争
جورج واکر بوش	乔治·沃克·布什
اوکراین	乌克兰
چېک جمهوريت	捷克
سلواکيا	斯洛伐克
سلووانیا	斯洛文尼亚
مولدوا	摩尔多瓦
رومانیا	羅馬尼亞
بلغاریا	保加利亚
د مقدونيې ولسمشريزه	馬其頓共和國
البانیا	阿尔巴尼亚
کروواسيا	克罗地亚
آزربايجان	阿塞拜疆
اندورا	安道尔
گرجستان	格鲁吉亚
قزاقستان	哈萨克斯坦
مالټا	马耳他
مانتېنېگرو	蒙特內哥羅
واټيکان ښار	梵蒂冈
سان مارینو	圣马力诺
بروکسل	布鲁塞尔-首都大区
بېلیز	伯利兹
باربادوس	巴巴多斯
اندونيزيا	印度尼西亚
ولفگانگ امادیوس موزارت	沃尔夫冈·阿马德乌斯·莫扎特
لیودویگ وان بیتهووین	路德维希·范·贝多芬
تورکي ژبه	土耳其语
سویلي افریقا	南非
الجزاير	阿尔及利亚
اوزبکستان	乌兹别克斯坦
تاشکند	塔什干
اوبه	水
تلويزون	电视
چېلي	智利
عيسی	耶稣
گاليليو گاليلی	伽利略·伽利莱
عطارد	水星
پېښليک	历史
ژبه	語言
زورواکي	獨裁政體
مشتري	木星
میشل باشله	蜜雪兒·巴切萊
ستورپوهنه	天文學
سينگاپور	新加坡
پوهنه	科学
تکړښت	体育运动
اډولف هټلر	阿道夫·希特勒
فېس بوک	Facebook
ويکيلېکس	維基解密
لومړنۍ نړېواله جگړه	第一次世界大战
دويمه نړېواله جگړه	第二次世界大战
گړيال	時鐘
شچېچېن	什切青
شمېرپوهنه	数学
لاتين ژبه	拉丁语
بحرین	巴林
ارمنستان	亞美尼亞
مېخي ليکدود	楔形文字
هیگزبوسون	希格斯玻色子
سربيا	塞尔维亚
سپوږمۍ	月球
استنبول	伊斯坦堡
آسټراليا	澳大利亚
پنځپوهنه	物理学
ارجنټاین	阿根廷
مخابرات	电信
پيرو	秘鲁
ژونپوهنه	生物学
شمالي کوريا	朝鲜民主主义人民共和国
کمبودیا	柬埔寨
قرآن	古兰经
ډانگسر	恐龙
ژوپوهنه	动物学
اسلام	伊斯兰教
ناک	梨
بوټپوهنه	植物学
لېخ والېسا	莱赫·瓦文萨
اروپايي اتحاديه	欧洲联盟
WWW	万维网
شعر	诗歌
کمپيوټري ويروس	计算机病毒
ليمو	柠檬
گل	花
ناپليون بوناپارت	拿破仑一世
لمر	太阳
آسمان	天空
وېکټور هوگو	维克多·雨果
اقيانوسيه	大洋洲
لمريز غونډال	太阳系
هايډروجن	氢
انگېلا مېرکل	安格拉·默克爾
لوړغږی	揚聲器
ورځ	日
شپه	晚上
کال	年
پېړۍ	世纪
اوسلو	奥斯陆
جنسي اړيکې	人类性行为
دوبۍ	杜拜
آکسيجن	氧
سياره	行星
سندارا	音乐
مسکو	莫斯科
چاډ	乍得
الومېنيم	铝
هند	印度
اوسپنه	铁
لوېديځ	西
گوگړ	硫
ساموا	萨摩亚
ختيځ	東
وېليم شېکسپيير	威廉·莎士比亚
نكل	寓言
مارشال ټاپووان	馬紹爾群島
مغولستان	蒙古国
سترنج	國際象棋
چنگېز خان	成吉思汗
آس	马
امسټرډام	阿姆斯特丹
وسله	武器
ژوي	动物
سورينام	蘇利南
گويانا	圭亚那
اېکوادور	厄瓜多尔
ځمکني توتان	草莓属
بوديزم	佛教
بولېویا	玻利維亞
تامبه	铜
بوټی	植物
سېنټ لوسیا	圣卢西亚
ليونارډو ډاوېنچي	列奥纳多·达·芬奇
چڼاس	真菌
جمايکا	牙买加
گرېنادا	格林纳达
گواتمالا	危地马拉
هندوراس	洪都拉斯
ډومنيکان جمهوريت	多明尼加
اهلي خوگ	家豬
شمالي قطبي سمندر	北冰洋
هایتي	海地
اېلسلوادور	萨尔瓦多
ايران	伊朗
عراق	伊拉克
کوسټاریکا	哥斯达黎加
اسرائيل	以色列
پاناما	巴拿马
يمن	也门
اردن	约旦
نیکاراگوا	尼加拉瓜
قرغزستان	吉尔吉斯斯坦
کوېټ	科威特
لاووس	老挝
لېبنان	黎巴嫩
مالديپ	马尔代夫
امريکا لويه وچه	美洲
ميانمار	缅甸
نيپال	尼泊尔
عمان	阿曼
پاکستان	巴基斯坦
قطر	卡塔尔
سعودي عربستان	沙特阿拉伯
سریلانکا	斯里蘭卡
جوزف سټالين	斯大林
سوريه	叙利亚
اپلاتون	柏拉图
تاجيکستان	塔吉克斯坦
د چين جمهوريت	中華民國
يوټيوب	YouTube
ارستو	亚里士多德
تايلنډ	泰国
اورگاډی	鐵路列車
آرسېنيک	砷
راډيو	无线电
تورکمنستان	土库曼斯坦
عربي متحده امارات	阿拉伯联合酋长国
چارلس چاپلين	查理·卓别林
سوېلي کوريا	大韩民国
سمپسنز	辛普森一家
افغانستان	阿富汗
بنگله دېش	孟加拉国
فرانتس کافکا	弗朗茨·卡夫卡
مالي	马里共和国
سوقرات	苏格拉底
آنگولا	安哥拉
بوتان	不丹
ټويټر	Twitter
برونای	文莱
تانزانیه	坦桑尼亚
پاره	汞
فلېپين	菲律宾
د منځنی افريقا ولسمشريزه	中非共和國
آيزاک نيوټن	艾萨克·牛顿
آلبرټ آينشټاين	阿尔伯特·爱因斯坦
تونس	突尼西亞
زېمبيا	赞比亚
زېمبابوې	辛巴威
بېجنگ	北京市
سوېلي سوډان	南蘇丹
بېنين	贝宁
بوتسوانا	波札那
بورکینا فاسو	布吉納法索
بروندي	蒲隆地
کانگو جمهوريت	刚果共和国
جېبوتي	吉布提
پولونيم	钋
باډن ورټمبرگ	巴登-符腾堡
اریتره	厄立特里亚
فيودور ميخايلوويچ داستاېفسکي	費奧多爾·米哈伊洛維奇·陀思妥耶夫斯基
گابن	加蓬
مهاتما گاندي	圣雄甘地
گامبيا	冈比亚
عاج ساحل	科特迪瓦
کامرون	喀麦隆
لايبېريا	利比里亚
لېبيا	利比亚
مادغاسکر	马达加斯加
مالاوي	马拉维
موریتانيا	毛里塔尼亚
ماوریتوس	毛里求斯
مراکش	摩洛哥
موزمبيق	莫桑比克
نېمبیا	纳米比亚
نایجېر	尼日尔
نايجېريا	奈及利亞
راونډا	卢旺达
سېنېگال	塞内加尔
سیشل	塞舌尔
سېرالیون	塞拉利昂
سومالیا	索马里
سوډان	苏丹共和国
سوازيلانډ	斯威士兰
شنه زرغونه	彩虹
استقلاب	代谢
ملگري ملتونه	联合国
دانتې الیگيري	但丁·阿利吉耶里
ځمکپېژندنه	地质学
ځمکپوهنه	地理学
زړه	心臟
ماغزه	脑
پراگ	布拉格
شين	藍色
سپين زر	銀
يورانيم	鈾
پلوتونيم	钚
ممبای	孟买
گوا	果阿邦
مهاراشترا	马哈拉施特拉邦
زارلاند	薩爾蘭
براندنبورگ	勃兰登堡
برېمن (ايالت)	不來梅州
بيت المقدس	耶路撒冷
هندي سمندر	印度洋
کلراډو	科羅拉多州
ژمی	冬季
پسرلی	春季
دوبی	夏季
منی	秋季
اسامه بن لادن	奥萨马·本·拉登
اوپرا	歌剧
کلکته	加尔各答
ډېلي	德里
بند پایان	节肢动物
اسلام آباد	伊斯兰堡
پيسې	貨幣
خوځندکې	昆虫
ولادمير ايليچ لېنين	列宁
نېكولو مكياوېلې	尼可罗·马基亚维利
مايکروسافټ وېنډوز	Microsoft Windows
مانيلا	马尼拉
توکيو	東京都
استانه	阿斯塔納
بغداد	巴格达
هندي ژبه	印地语
اوردو ژبه	乌尔都语
واليبال	排球
وين	維也納
ډبلن	都柏林
بوډاپسټ	布达佩斯
د مسيح حقيقي کليسا	真耶稣教会
انگرېزي ژبه	英语
بانگکوک	曼谷
کوالالامپور	吉隆坡
ديپلوماسي	外交
کيېف	基輔
كونسكوولا	孔斯科沃拉
2012	2012年
2013	2013年
خواړه	食物
اېلېکټرون	电子
رغاويز اوښتون	工业革命
د روم ټولواکمني	羅馬帝國
مايکروسافټ	微软
پروټون	質子
کوروف	库鲁夫
کيميا	化學
نيوټرون	中子
صنعا	萨那
آرنولد شوارزنېگر	阿诺·施瓦辛格
فوټبال	足球
آيفون	IPhone
مايکل جېکسن	迈克尔·杰克逊
انتوان دي سينت اکسيوپيري	安托万·德圣埃克絮佩里
سور	红色
هوا	地球大气层
پېرى	鎮尼
ربات	拉巴特
الجزيره	阿爾及爾
ترابلس	的黎波里
تهران	德黑兰
جکارتا	雅加达
انقره	安卡拉
رياض	利雅德
فوټ	英尺
وېشنيزه:د ويکيپېډيا کينډۍ	Category:維基百科模板
د مشق	大马士革
لوم	洛美
دوها	多哈
دودوما	多多马
ښوونځی	学校
پوهنتون	大學
د پوهنغونډ په اړه	Wikipedia:新手入門/主頁
آسټراليا (لويه وچه)	澳大利亞洲
ورونپاسی	筆記型電腦
الجبر	代数
دونگ هوی هوايي ډگر	同海機場
آر دړه	主板
كوريتيبا	庫里奇巴
پنجاب (پاکستان)	旁遮普省
وېشنيزه:د افغانستان پېښليک	Category:阿富汗历史
توماس شېن کانېري	肖恩·康纳利
كنفيوشيوس	孔子
کوربن بليو	柯賓·布魯
وېشنيزه:شمېرپوهنه	Category:数学
کينډۍ:د هېواد مالومات ایران	Template:Country data Iran
وېشنيزه:د ایران تاریخ	Category:伊朗歷史
امريکايي ډالر	美元
عيسويت	基督教
لويه وچه	洲
مرغه	鸟
پلازمېنه	首都
کينډۍ:اسلام	Template:伊斯兰教
مياشت (موده)	月
مصطفی کمال اتاتورک	穆斯塔法·凯末尔·阿塔蒂尔克
کينډۍ:تانبه	Template:Portal
هوانگ شيان فان	黄现璠
بقراط	希波克拉底
الماس	钻石
پوهنغونډ	百科全书
RAM	随机存取存储器
لومړی مخ	Wikipedia:首页
کانډنسر	电容器
باسکټبال	篮球
کرېکټ	板球
اوراسيا	歐亞大陸
د هېتیانو واکمنۍ	赫梯
وينه لږی	贫血
کېپ ټاون	開普敦
قراقرم	喀喇昆仑山脉
هندوکش	興都庫什山脈
ميترو	地鐵
کنځری	栒子属
پيکاسو	巴勃羅·畢卡索
بس	公共汽車
ټرام	有軌電車
بابل	巴比伦
آنتون پاولوف چيخوف	安东·帕夫洛维奇·契诃夫
چارلېز ډيکېنز	查尔斯·狄更斯
سپارتا	斯巴达
موينجو دېړو	摩亨佐-达罗
سمرقند	撒馬爾罕
بخارا	布哈拉
چې گوارا	切·格瓦拉
کابل	喀布尔
گوېټه	约翰·沃尔夫冈·冯·歌德
مهبل	阴道
فلسفه	哲学
د مقدس ویټوس کليسا	圣维特主教座堂
چای	茶
کمونيزم	共产主义
انارشيزم	无政府主义
پانگولي	资本主义
لېبراليزم	自由主义
فاشېزم	法西斯主义
ولسپالنه	民族主義
حافظ شېرازي	哈菲兹 (诗人)
هېوادپالنه	愛國主義
هیواد	国家
ولس	民族
هيلري کلنټن	希拉里·罗德姆·克林顿
د برتانيې موزيم	大英博物馆
ژان ژاک روسو	让-雅克·卢梭
هومر	荷马
الكساندر هومبولدت	亚历山大·冯·洪堡
کوارک	夸克
اېډوارډ ټېللر	愛德華·泰勒
تور زېړی	乙型肝炎
اتيزم	无神论
نيلز بوهر	尼尔斯·玻尔
ژونکيميا	生物化学
ژونپنځپوهنه	生物物理学
چاپېريالپوهنه	生态学
بارسلونا فوټبال کلب	巴塞罗那足球俱乐部
واگ	政治
ووبپوهنه	组织学
عربي ټولنه	阿拉伯国家联盟
ولسواکي	民主
نجيب محفوظ	納吉布·馬哈福茲
د سره صليب او سرې مياشتې نړيوال غورځنگ	国际红十字与红新月运动
نړيوالتوب	全球化
ناټو	北大西洋公约组织
جين	基因
حکومت	政府
نوبل جايزه	诺贝尔奖
چېن شي هوانگ	秦始皇
منځنی ختيځ	中东
رنځپوهنه	病理学
رابندرانات ټاگور	罗宾德拉纳特·泰戈尔
لېو نيكولايوويچ تولستوى	列夫·托爾斯泰
مارک ټوېن	马克·吐温
ايډيالوژي	意識形態
ادا لولېس	愛達·勒芙蕾絲
مارکسيزم	马克思主义
ولسمشريزه	共和制
دولت	國 (政治)
گوند	政党
بډمنټن	羽毛球
يوري الکسويچ گاگارين	尤里·阿列克谢耶维奇·加加林
ابن بطوطه	伊本·白图泰
اباسين (سيند)	印度河
فرانز جوزیف هایدن	约瑟夫·海顿
غوږ	耳
سترگه	眼
سندره	歌曲
اوښ	骆驼
تی لرونکی ځناوران	哺乳动物
مېږی	蚂蚁
مارگريت تاچر	玛格丽特·撒切尔
ډي آکسي رايبونيوکليک اسيد	脱氧核糖核酸
ژباړه	翻译
ښامار	龙 (西方)
مور	母親
پلار	父親
لېږدچارې	运输
روسي ژبه	俄语
ولادمير پوتين	弗拉基米尔·弗拉基米罗维奇·普京
حقوق	法律
اساسي قانون	宪法
د بشري حقونو نړېواله اعلاميه	世界人权宣言
د روغتيا نړيوال سازمان	世界卫生组织
د سوداگرۍ نړيوال سازمان	世界贸易组织
پرېولنځی	馬桶
طبيعت	自然
سادرملنه	精神病学
ژونکه	细胞
وينه	血液
هډوانه	骨骼系統
سږي	肺
ساييز غونډال	呼吸系統
رومانيايي ژبه	羅馬尼亞語
بلغاريايي ژبه	保加利亚语
روزنپوهنه	教育学
يمال	雪崩
رېږدله	地震
طبيعي پوهنې	自然科学
ابن سينا بلخي	伊本·西那
وېنسټون چرچل	温斯顿·丘吉尔
نېلسن مانډېلا	纳尔逊·曼德拉
انزايم	酶
امينو اسيد	氨基酸
ورېځ	云
سولپوهنه	逻辑
مېچپوهنه	几何学
وټپوهنه	经济学
پانگه (وټپوهنه)	资本
ارز	通貨
رغاوه	产业
ورکړېنه	稅
ژبپوهنه	语言学
يوناني ابېڅې	希腊字母
ادبپوهنه	文學
وېشنيزه:فرانسه	Category:法国
ناول	長篇小說
سره گيدړه	赤狐
اوستراوا	俄斯特拉发
کوروش ۲	居鲁士二世
ټولنه	社会
تمدن	文明
زده کړه	教育
هوگو چاوېز	烏戈·查維茲
واده	婚姻
وگړنيز حقوق	人权
توکمپالنه	种族主义
گوډ تېمور	帖木儿
عمر بن خطاب	欧麦尔·本·赫塔卜
پوځ	軍事
سلیمان ۱	苏莱曼一世 (奥斯曼帝国)
قهوه	咖啡
د آمو سيند	阿姆河
شيدې	乳
غر	山
هري رود	哈里河
هلمند رود	赫爾曼德河
توكبنسټ	数据库
کابل سيند	喀布尔河
صلاح الدين ايوبي	萨拉丁
اشوک	阿育王
جلال الدين محمد اکبر	阿克巴
هانگ کانگ	香港
کراچۍ	卡拉奇
د ريال مادريد فوټبال کلب	皇家马德里足球俱乐部
سيول	首爾
شانگهای	上海市
د ماد واکمني	米底王国
اقليدس	欧几里得
بايټ	字节
محمد بن موسی خوارزمي	花拉子米
ناروېژي ژبه	挪威语
نوم چومسكي	诺姆·乔姆斯基
چيکی ژبه	捷克语
کارل مارکس	卡尔·马克思
موسی	摩西
پوهه	知识
هندويزم	印度教
اټوم	原子
يوناني ژبه	希腊语
چليز غونډال	操作系统
تاج محل	泰姬陵
بنسټپالنه	原教旨主義
برېښليک	电子邮件
پاړسي ژبه	波斯语
مذهب	宗教
اېمپاير سټېټ ودانۍ	帝国大厦
سېگمونډ فرايډ	西格蒙德·弗洛伊德
جاينيزم	耆那教
گيورگ ويلهېلم فرېدرېش هېگل	格奥尔格·威廉·弗里德里希·黑格尔
باکو	巴库
تاجکي ژبه	塔吉克语
اوزبکي ژبه	乌孜别克语
تورکمني ژبه	土库曼语
يهوديت	犹太教
آزربايجاني ژبه	阿塞拜疆语
ابن خلدون	伊本·赫勒敦
امانوېل کانت	伊曼努尔·康德
سکيزم	锡克教
فرېدرېک وېلهېلم نېتشي	弗里德里希·尼采
بشکیک	比什凯克
دوشنبه	杜尚别
اينه	肝臟
پښتورگی	腎
ادم سمېت	亚当·斯密
احساس	情绪
ساپوهنه	心理学
آند	思想
مهاوېرا	笩駄摩那
سمندر	洋
ملکه وېکټوريا	维多利亚 (英国君主)
محمد	穆罕默德
اخلاق	伦理学
پوهنپوهنه	知识论
سچين رمېش ټنډولکر	沙奇·德鲁卡
عبدالکلام	阿卜杜尔·卡拉姆
بي بي سي	英国广播公司
شاهرخ خان	沙·魯克·罕
سلمان خان	薩爾曼·汗
محمد الغزالي	安薩里
عامر خان	阿米爾·罕
اميتاببچن	阿米塔布·巴沙坎
شيعه	什叶派
گېډه	腹
زرتشتيت	琐罗亚斯德教
تصوف	蘇非主義
ژبه (اناتومي)	舌
پانکراس	胰脏
غاړه	頸
کمزوره شوي یورانیم	貧鈾
هولي	侯丽节
زړه پوهنه	心臟病學
ډېوېډ بکهم	大卫·贝克汉姆
کيم جونگ ايل	金正日
وېشنيزه:وېنزوېلا	Category:委内瑞拉
روبېرت موگابي	羅伯·穆加貝
خاپوړن	爬行动物
کوتره	鸠鸽科
باکټريا	细菌
ونه	树
دوه ژوندوي	两栖动物
اوښتون	革命
انگور	葡萄
گبين	蜂蜜
کچالو	马铃薯
سابه	蔬菜
ټکنالوجي	技术
انجينري	工程学
خبريالي	新闻学
ورځپاڼه	報紙
غږلېږدی	电话
هڅوب	文化
سانسکریت ژبه	梵语
د زړه او رگونو غونډال	循环系统
د پارکېنسون ناروغي	帕金森氏症
گارډيان	衛報
انډيپېنډنټ	獨立報
درملگري	医学
مقننه قوه	立法机构
مالگه	食盐
مايکروسافټ آفېس	Microsoft Office
وېشنيزه:رومانیا	Category:罗马尼亚
کيمياوي توکی	化學元素
ابن باجه	伊本·巴哲
هورمون	激素
اپارتايد	南非種族隔離
لوبه	游戏
جودو	柔道
مقناطيس	磁鐵
فلم	电影
ساهيالي	动画
کرنه	农业
غږ	声音
نانو تکنالوژي	纳米技术
ښيښه	玻璃
وخت	时间
ليکپاڼه	纸
کازمېکي وړانگې	宇宙線
جوار	玉米
انځورکښنه	绘画
تشیالیونی	宇航员
انځوراخيستنه	摄影
برېښنايي ټېکنالوژي	电子学
فريکونسي	頻率
خوړنځی	餐馆
د لودیانو ټولواکمني	洛迪王朝
لاهور	拉合爾
د خپلواکو هېوادونو لړليک	世界政區索引
ابوريحان بيروني	比魯尼
څېړۍ	栎属
سرطان	癌症
کولرا	霍亂
غنم	小麦
ناروغي	疾病
گرېگوري کليز	公历
نیکوتین	尼古丁
روغتيا	健康
ملاريا	疟疾
انټيبايوټيک	抗细菌药
پنسلين	青霉素
نېمونيا	肺炎
گوزڼ	脊髓灰質炎
اېډز	艾滋病
نری رنځ	結核
ډايبېټېز مېلېټوز	糖尿病
صليبي جگړې	十字軍東征
منځنۍ پېړۍ	中世纪
عثماني پېر	奥斯曼帝国
د کورنيو توليداتو ټوليز ارزښت	国内生产总值
برېښنا	電
یان آموس کمېنسکي	约翰·阿摩司·夸美纽斯
اټومي برېښناکوټ	核動力
د بړاس ماشين	蒸汽机
توره (وسله)	劍
هستوي وسلې	核武器
شوبله	坦克
هرمان ون رومپوې	赫尔曼·范龙佩
غرني توت	藍莓
تورتوت	黑莓
ناريال	椰
انار	石榴
مالټه	橙
A New Etymological Vocabulary of Pashto	奇異果
گراڅ	格拉茨
ډېبټ کارډ	借记卡
انجلينا جولي	安吉丽娜·朱莉
عربي ژبه	阿拉伯语
کانډوم	避孕套
تيرانوسور	暴龍屬
تریسراتوپس	三角龍屬
ستگوسور	劍龍屬
کارکارودونتوسور	鲨齿龙属
وچکښ	铅笔
برنو	布爾諾
هوجينتاو	胡锦涛
د شوروي سوسياليستي جمهوريتونو اتحاد	苏联
انځورۍ	照相機
اېچ آی وي	人類免疫缺陷病毒
يومکی	肩胛骨
ځاني سولگر	个人电脑
بروس لي	李小龙
هايپوتايرايډيزم	甲狀腺機能低下症
نړۍ	世界
د روم جمهوريت	罗马共和国
ټریلوبیټ	三葉蟲
گردکه	圆
گرځنده غږلېږدی	移动电话
اوښمرغه	鸵鸟
ويټامين اې	維生素A
بغ	鹭科
پيونگيانگ	平壤
د لور موندنې نړيوال غونډال	全球定位系统
د هېوادونو لړليک د کورنيو توليداتو د ټوليز ارزښت له مخې	各国国内生产总值列表 (国际汇率)
جگتورن	上尉
سمندري غڼې	海蜘蛛
لړم	蠍子
ما اينگ جيو	馬英九
سمندري لړمان	广翅鲎
انټرنټ لټوونکی ماشين	搜索引擎
بخارست	布加勒斯特
لوور	卢浮宫
تیرانا	地拉那
ويکټوريا بېکهم	维多利亚·贝克汉姆
درېڅنډی	三角形
سټيف جوبز	史蒂夫·乔布斯
معمر القذافي	穆阿迈尔·卡扎菲
پړانگ	虎
لومړی خوان کارلوس	胡安·卡洛斯一世
لمسنالۍ	触摸板
سامسونگ	三星集团
سولگرپوهنه	计算机科学
ټولنپوهنه	社会学
گاگره	混凝土
جغرافي کوراډينېټونو سيستم	经纬度
پڼې	鞋
بهايي	巴哈伊信仰
بانک	銀行
د وينا ازادي	言論自由
اډېل	愛黛兒
د نش ميزان	納什均衡點
هوږه	蒜
وگړپوهنه	人类学
بادرنگ	黄瓜
ارنېست مېلر هېمېنگوې	欧内斯特·海明威
عشق آباد	阿什哈巴德
ټاپو	島嶼
تور (رنگ)	黑色
پياز	洋蔥
رسمي ژبه	官方语言
لرغونپوهنه	考古学
بالکان	巴尔干半岛
سلاوي ژبې	斯拉夫语族
سر	头
ولسي لاره	国歌
تماسي عدسيه	隱形眼鏡
الفرېډ نوبل	阿尔弗雷德·诺贝尔
ږمنځ	梳篦
لیلا داونز	利拉·唐斯
موسم	季节
راولپنډۍ ولسوالۍ	拉瓦尔品第县
ډبرين سکاره	煤
يارمخچۍ	大短趾百灵
نينورشک	新挪威語
بوکمول	書面挪威語
کونگ	貓頭鷹
شمزۍ لرونکي ژوي	脊椎动物
نړېوال تشيال تمځای	国际空间站
ISO 3166-1	ISO 3166-1
کجوره	海枣
څټک	槌
اروپايي کاغۍ	喜鹊
چابکۍ	蟑螂
كوچنى شاهزاده	小王子 (小说)
شمالي باز	蒼鷹
غضروفی کبان	軟骨魚綱
ځنگلي سار	普通鵟
سيلاني کارغه	秃鼻乌鸦
لويديځي کاغۍ	寒鸦
شودپۍ	白鹡鸰
اېشېريکيا کولي	大腸桿菌
توتکۍ	家燕
گنگو	番紅花
ترکاڼک	啄木鸟科
شامتوره	紫翅椋鸟
کوشانيان	貴霜帝國
کومکۍ	斑尾林鸽
جوک	赤胸朱顶雀
آتروپين	阿托品
شين شارک	大青鲨
اورني سمندر	火蠑螈
سپوږمکۍ	人造衛星
شينغاړی	蓝点颏
تورياڼۍ	雨燕科
لونگ	丁香
زيره	葛縷子
وژونکی نهنگ	虎鯨
سپېرکونده	凤头百灵
منځنۍ آسيا	中亚
شمالي افريقا	北部非洲
مرکزي افريقا	中部非洲
ختيځه اروپا	东欧
لوېديځه اروپا	西欧
افريقايي اوراسيا	歐亞非大陸
د فلسفې تاريخ	哲學史
زي نړیواله جگړه (فلم)	地球末日戰
مړز	鹌鹑
مروری	德國洋甘菊
چې زېټ ۸۰۵ برېن توپک	CZ-805 Bren突擊步槍
کمول (مارغه)	鹳科
اوبدانه	纺织品
توکي	商品
سپوږميز ليږديز کليز	伊斯兰历
ميلوش زېمان	米洛什·泽曼
اېف-۱۵	F-15鷹式戰鬥機
ليوکېمي	白血病
ديموکراتيک گوند ( د امريکا متحده ایالتونه)	民主党 (美国)
ټيکاله	百灵科
شاتو مچی	西方蜜蜂
شړشم	芥菜类蔬菜
خاورين چينجی	普通蚯蚓
ولسمشر	總統
باشه	游隼
رودولف کلاوزيوس	魯道夫·克勞修斯
تورغوږی	獰貓
ډېل	戴爾
شمېرنی	计算器
شاه محمود هوتک	馬哈茂德·霍塔克
امير عبدالرحمان خان	阿布杜爾·拉赫曼汗
د عربستان ټاپووزمه	阿拉伯半岛
امير دوست محمد خان	多斯特·穆罕默德汗
بېریف بې-۲۰۰	Be-200飛艇
پهلوي ژبه	中古波斯语
وری	白羊宮
جېهلم ولسوالۍ	杰赫勒姆县
ملاله يوسفزۍ	马拉拉·优素福扎伊
جومات	清真寺
بلوڅی ژبه	俾路支语
د کتاب نړيواله کره شمېره	国际标准书号
د کندهار نړيوال هوايي ډگر	坎大哈国际机场
د مغولو پاچايي	莫卧儿帝国
گړدود	方言
ایرانی ژبی	伊朗语支
لاس	手
خلکو شمېر	人口
پاڼه	葉
لوبگر	演員
هاليووډ	好莱坞
محمد حسنی مبارک	穆罕默德·胡斯尼·穆巴拉克
دينپوهنه	神學
پابلو نرودا	巴勃罗·聂鲁达
زیوس	宙斯
موساد	以色列情報及特殊使命局
انجيل	福音书
الېکسانډر گراهام بېل	亚历山大·格拉汉姆·贝尔
ستورپېژندنه	占星学
ساز	乐器
ويټني هيوسټن	惠特妮·休斯顿
سابون	肥皂
موشوفتسی	莫绍夫采
شکيرا	夏奇拉
محمود احمدي نژاد	马哈茂德·艾哈迈迪内贾德
كېښكلى ټيكلى (CD)	CD
چورلکه	直升機
القاعده	基地组织
محمد فاتح	穆罕默德二世 (奥斯曼帝国)
اناستاسيا	安娜塔西亚
فرات	幼发拉底河
البېرټ کامو	阿尔贝·加缪
د فارس خليج	波斯湾
قطب نما	指南针
ټولنيزې پوهنې	社会科学
ټاپووزمه	半岛
اېف-۱۴	F-14雄貓式戰鬥機
ويټامين	维生素
تورات	妥拉
كرم	捲心菜
متل	谚语
هينداره	鏡子
لرغونې پاړسي	古波斯語
عربان	阿拉伯人
براډ پېت	畢·彼特
کړکۍ	窗
اکدي ژبه	阿卡德語
څارندوی	警察
ولسي جرگه	议会
اوساکا	大阪市
د کېمبرېج پوهنتون	剑桥大学
اجرايي قوه	行政机构
تعمید غسل	洗禮
ډډون	通货膨胀
سابندي	哮喘
عمر خيام	欧玛尔·海亚姆
وله	柳树
محمد علي کلي	穆罕默德·阿里
خاوره	土壤
اينځر	無花果
ليکوال	作家
د توهوکو سونامي او رېږدله ۲۰۱۱	2011年日本东北地方太平洋近海地震
واتسلاف هاول	瓦茨拉夫·哈维尔
د ورېښم لار	丝绸之路
جېن آسټن	简·奥斯汀
کوردي ژبه	庫爾德語
زرۍ	千纪
علمی نوم	二名法
هنرېک ايبسن	亨里克·易卜生
ماموت	猛犸象
څلورڅنډی	四邊形
د سرکوزي والگی	豬流感
اوزون	臭氧
جذام	麻风病
مخ (اناتومي)	臉
خپلواکي	独立
ښوون	橄欖 (木樨科)
سليمان	所羅門
یاهو!	雅虎
کرښه (مېچپوهنه)	直线
فرعون	法老
کلاشېنکوف اې کې ۴۷	AK-47突击步枪
څپه	波
د وینې سره کرویات	红血球
سند	信德省
فرانسېس بیکن	弗兰西斯·培根
معمولي مندته	杏
نيکول کېډمېن	妮可·基嫚
هايکو	俳句
عثمان بن عفان	奥斯曼·本·阿凡
وگړشمېرنه	人口学
ځمکواکي	封建制度 (歐洲)
اوبړۍ	藻類
نتالي پورټمېن	娜塔莉·波特曼
هېرټا مولر	赫塔·米勒
مکډونالډز	麦当劳
يوکوهوما	横滨市
گړپوهنه	词法学
ويليم فاکنر	威廉·福克納
هندواڼه	西瓜
پخلی	烹饪
بادي ژرنده	風車 (動力機)
د حماس اسلامي غورځنگ	哈马斯
آيت الله روح الله خميني	鲁霍拉·穆萨维·霍梅尼
ليزر	激光
تبه	发热
تيد	泰德峰
کوچنی وټه	微观经济学
رجب طيب اردوغان	雷杰普·塔伊普·埃尔多安
خزدکپوهنه	昆虫学
تبر	斧
علي بن ابي طالب	阿里·本·阿比·塔利卜
لویه وټه	宏观经济学
انسولين	胰岛素
بازارموندنه	市场营销
سرشمېرنه	人口普查
ابن رشد	伊本·魯世德
لسيزه	年代
بادام	扁桃
څښاک	饮料
نيانډرټال	尼安德特人
الهي کمېډي	神曲
ووب	组织 (生物学)
پروېز مشرف	佩尔韦兹·穆沙拉夫
لوط	羅得
دهاډرونو ستر تعجیل کوونکي ماشین	大型強子對撞機
يحيی	聖若翰洗者
دیلما روسف	迪爾瑪·羅塞夫
ساندرا بللاک	珊卓·布拉克
جراحي	外科学
بياتي	剪刀
نفرتيتي	娜芙蒂蒂
لمونځ	祷告
سکايپ	Skype
غږپوهنه	音位學
هارولډ پينټر	哈罗德·品特
د حزب الله اسلامی غورځنگ	真主党
باو	梅毒
د آشور واکمني	亚述
ودانۍ	建筑物
سوني	索尼
باريس ولاديميروويچ پاسترناک	鮑里斯·帕斯捷爾納克
کونستانتين اېدواردوويچ تسيولکوفسکي	康斯坦丁·齐奥尔科夫斯基
سينما	電影院
بودجه	財政預算案
څپواټن	波长
داوود	大衛
کنگل هاکي	冰球
کوردستان	庫爾德斯坦
د موس مقياس	摩氏硬度
بواسيرونه	痔疮
هېنريک سېنکېويچ	亨利克·显克微支
ککرۍ پتنگ	赭带鬼脸天蛾
كوكايين	可卡因
فینیکیان	腓尼基
شهادت	清真言
د بابل ځوړند بڼ	空中花园
حاکميت	主權
خديجه بنت خويلد	海迪彻
نیلي نهنگ	蓝鲸
څېړنه	研究
سولي پرودممه	苏利·普吕多姆
اوبپوهنه	水文学
بوکر	圆锥
د مورنۍ ژبې نړيواله ورځ	國際母語日
سهيونېزم	錫安主義
د طالبانو اسلامي غورځنگ	塔利班
اناکزیمېنډر	阿那克西曼德
کورکمن	薑黃
ځنگلي پيشو	丛林猫
عبدالله گل	阿卜杜拉·居尔
ختيځپوهنه	东方主义
کرېشنا	黑天
ساباوري	泛靈論
ليکچه	筆記本
مالیه	金融
وچکالي	干旱
تور مرچ	黑胡椒
ياقوت	红宝石
کشمير	克什米尔
ټولپوښتنه	公民投票
كپېړ	鱷科
مولانا جلال الدين محمد بلخي	鲁米
کارغه	乌鸦
پلزن	比尔森
توکمپوهنه	民族学
مټ	臂
زمرد	祖母綠
وحشي پيشو	斑貓
شکرخوره	蜂鸟
فدراسيون	联邦制
شونډکيز چرگ	火雞
انسلم	坎特伯雷的安瑟莫
حامد کرزی	哈米德·卡尔扎伊
یان هوس	扬·胡斯
کورني آلو	欧洲李
اندرس بېرينگ برېويک	安德斯·贝林·布雷维克
شينټاغی	佛法僧科
احمد سلمان رشدي	薩爾曼·魯西迪
افسانه	传说
داریوش ۱	大流士一世
توت	桑树
لسبېله ولسوالۍ	拉斯贝拉县
اېنټروپي	熵
گجرات ولسوالۍ	古杰拉特县
هرات	赫拉特
کودتا	政變
کندهار	坎大哈
تړمه ييزه پراختیا	热膨胀系数
غشی	箭
غږتاندی	麦克风
توراڼه	黑卷尾
اپيم	鸦片
اوسيريس	欧西里斯
ازاد بازار	自由市場
اوکاړه ولسوالۍ	奥卡拉县
احمد شاه دراني	艾哈迈德沙·杜兰尼
اسراييل لرغونتون	以色列博物館
جي اس ام	全球移动通信系统
اېشواريه رای	艾西瓦娅·巴克罕
نوغپوهنه	系譜學
مېلټون فرايډمېن	米爾頓·佛利民
بانکنوټ	紙幣
نړيواله جنايي محکمه	国际刑事法院
رادار	雷达
د اسلامي همکاريو سازمان	伊斯兰合作组织
سياسي وټه	政治经济学
د بابل واکمني	巴比倫尼亞
جبران خليل جبران	纪伯伦·哈利勒·纪伯伦
خټکی	白兰瓜
روبي وېليمز	罗比·威廉斯
د سږو سرطان	肺癌
مهايانا	大乘佛教
امريتسر	阿姆利则
اس ـ ۳۰۰	S-300导弹
مير تشيال تمځی	和平号空间站
خانيوال ولسوالۍ	卡内瓦尔县
لنډه کيسه	短篇小说
د لبنان جگړه ۲۰۰۶	2006年以黎衝突
گرځندويي	旅游
شاعر	诗人
بادي توربین	風力發動機
يو گونديز حکومت	一党制
مصري ژبه	埃及语
هارون	亞倫
ایبولا ناروغۍ	埃博拉出血热
ژونځمکپوهنه	生物地理学
غونډ	團 (軍隊)
سور كانگرو	紅大袋鼠
هارپي	角雕
ابسيډين	黑曜岩
وېشنيزه:حکومت	Category:政府
د کيلو کلاس اوبتل	基洛级潜艇
سپايس گرلز	辣妹合唱團
مېزپاسی سولگر	桌上型電腦
پاراستامول	对乙酰氨基酚
عبدالله بن عبدالعزیز آل سعود	阿卜杜拉·本·阿卜杜勒-阿齐兹·阿勒沙特
سيد على خامنه‌اى	阿里·哈梅內伊
امام علي رحمانوف	埃莫马利·拉赫蒙
اسلام کريموف	伊斯蘭·卡里莫夫
راجا پروېز اشرف	拉贾·佩尔韦兹·阿什拉夫
گيودو ويسترويلي	基多·威斯特威勒
پښتو ژبه	普什图语
عرب سمندرگی	阿拉伯海
گرمټ	电钻
دیو جانس کلبی	锡诺普的第欧根尼
کورنت توغندی	9M133短號反坦克导弹
هېرويين	海洛因
کوفین	咖啡因
اندروجن	雄激素
سيمټيکس	塞姆汀炸药
راوړنې	進口
ببرک کارمل	巴布拉克·卡尔迈勒
حفيظ الله امين	哈菲佐拉·阿明
تريخی	胆囊
انتوني هوپکينز	安東尼·霍普金斯
مرکزي بانک	中央银行
جيپور	齋浦爾
سيبري پړانگ	东北虎
القلويد	生物鹼
آدم	亞當
ترور	姑母
یوسيف ۲	约瑟夫二世 (神圣罗马帝国)
کریستوف والڅ	克里斯托弗·瓦尔兹
ښاري انجنيري	土木工程
وړانگپوهنه	影像诊断学
اليگارشي	寡头政治
زړه گراف	心电图
د افغانستان رپی	阿富汗国旗
ايسيس	伊西斯
ځوانکې	粉刺
اېترنټ	以太网
چکوتره	柚子
بشري پوهنې	人文学科
ټپوس	黑鸢
نهنگی شارک	鯨鯊
بېنډۍ	秋葵
د سلطان احمد جومات	蘇丹艾哈邁德清真寺
اټومي بټۍ	核反应堆
مايکروسافټ اوټلوک	Microsoft Outlook
بنگالي پړانگ	孟加拉虎
مالداري	畜牧业
معمولي کپر (کب)	鯉
اولوموڅ	奧洛穆克
مورفين	嗎啡
د صرافی ماشین	自動櫃員機
نخود	鹰嘴豆
نوح	挪亞
والټ وايټمېن	沃尔特·惠特曼
غاښۍ	餐叉
چوپسټېک	筷子
د خوړو او کرهڼې سازمان	联合国粮食及农业组织
براشوف	布拉索夫
زنه	頷
قطبي گيدړ	北極狐
سياستوال	政治人物
شپږڅنډی	六边形
د افغانستان جگړه (۱۹۷۹-۱۹۸۹)	阿富汗战争 (1979年)
ختيځ هند کمپنۍ	不列颠东印度公司
الكساندر نيكولاېويچ رومانوف	亚历山大二世 (俄国)
اسکلېپيوس	阿斯克勒庇俄斯
ژان اېف کوستو	雅克-伊夫·库斯托
وزير (حکومت)	部長
گرو نانک	拿那克
کانپوهنه	矿物学
شېنگن تړون	申根公约
سابه خوړونکي	素食主義
امپيدوکلېس	恩培多克勒
اوېستا	波斯古经
شاه جهان	沙贾汗
شېر شاه سوري	舍尔沙
د الله نومونه	真主的九十九個尊名
د ساسانيانو واکمني	萨珊王朝
هوروس	荷鲁斯
پولنډبال	波兰球
راټکو مېلادېچ	拉特科·姆拉迪奇
انځورگري	素描
پرېژه	离婚
باليووډ	宝莱坞
اېف – ۱۶	F-16戰隼戰鬥機
عبدالله کلا ولسوالۍ	基拉阿布杜拉县
کلوژ-ناپوکا	克卢日-纳波卡
مرزا حسين علي بهاالله	巴哈欧拉
نېغ انسان	直立人
ماهر انسان	能人
هاډرون	强子
سوسن	鈴蘭
اينو	阿伊努人
تسپود	炎症
بايوم	生物群系
لروين	双筒望远镜
گبين مچۍ	蜜蜂屬
آوسټرالوپیتهېکوس	南方古猿
نړېواله جگړه	世界大戰
روي شنکر	拉维·香卡
چندرۍ	蛇麻
کرښی	尺子
قضايي قوه	司法機構
ماگنوس کارلسن	馬格努斯·卡爾森
مرزا اسد الله خان غالب	米尔扎·迦利布
ايالت	联邦制国家成员
کندوز	昆都士
انجه	阿魏
مارشال	元帅
انټيکولينرجيک	抗膽鹼劑
مالي کړکېچ	金融危机
هزاره گان	哈扎拉族
کريم خليلي	卡里姆·哈利利
سليكان ډای اکسايډ	二氧化硅
کورکورکه	珠颈斑鸠
د وېلسن ناروغي	肝豆狀核變性
د پاني پت جگړه	帕尼帕特战役
الكساندر الكساندروويچ رومانوف	亚历山大三世 (俄国)
بلخ ولايت	巴尔赫省
مشهد	馬什哈德
رنځورپالنه	护理学
پاکپتن ولسوالۍ	帕克帕坦县
ټولنیزه ولسواکي	社會民主主義
د ستنې طب	针灸
سفارت	大使
کجير	禿鷲
عقيق	瑪瑙
اپلاتون او دولت	理想国
ارستوکراسي	贵族政治
زکات	天課
گيورگې ژوکوف	格奥尔基·康斯坦丁诺维奇·朱可夫
د اوبو چينه	泉
بڼ پالنه	园艺
وېليم جېمز	威廉·詹姆士
غوڅندۍ	鋸
سورلنډی	胡狼
د موسم بدلون	氣候變化
واټن	距离
کوباني	艾因阿拉伯
پراگماتيزم	实用主义
وړکتون	幼稚園
ابن ميمون	邁蒙尼德
شين یاقوت	蓝宝石
پينځڅنډی	五边形
ټوټالېټر	極權主義
کوچيان	遊牧民族
درملپوهنه	药理学
د زیات شوي ارزښت ورکړېنه	增值税
خټنه	黏度
لوي سپين شارک	大白鲨
د جمشید پلاز	波斯波利斯
انتراکس	炭疽病
خشايارشا	薛西斯一世
مزار شريف	马扎里沙里夫
مېگ ۲۹	米格-29戰鬥機
د ذرو تعجيل کوونکي ماشين	粒子加速器
ډیمېټروډون	异齿龙
سپاینوسور	棘龍屬
بېیپیاوساوروس	北票龍屬
خلافت	哈里發國
معمولي آلوبالو	欧洲酸樱桃
زغوپرواژی	农药
ډومنيک ډي وېلپين	多米尼克·德维尔潘
د قم ولايت	庫姆省
گڼرسنۍ	多媒体
کوروند	剛玉
سریښ	黏合剂
والي	省长
توکمکښنه	民族誌
کرما په هندويزم کې	業
آيورويدا	阿育吠陀
د جال تړونونه	网络传输协议
جوليوس روبرټ اوپنهايمر	罗伯特·奥本海默
باختر	巴克特里亞
هېروگليف	圣书体
ولاديمير ولاديميروويچ ماياکوفسکي	弗拉基米尔·弗拉基米罗维奇·马雅可夫斯基
د هند پېښليک	印度历史
مستعمره	殖民地
ملخوزه	胡芦巴
اخوان المسلمون	穆斯林兄弟會
الياس	以利亞
طاعون	鼠疫
د سېټريک اسيد څرخ	三羧酸循环
دهرما	法 (印度哲學)
ټاسماني شيطان	袋獾
توپاز	黄玉
۹×۱۹ مرمی	9×19mm魯格彈
براخاوخېنیوس	短頸龍屬
آندروختونوس اوسترالیس	黃肥尾蠍
د ايران ولسوالۍ	县 (伊朗)
ابد	永恆
عبدالعلي مزاري	阿布杜勒·阿里·馬扎里
زابل ولايت	扎布尔省
مسراشمیت مې-۲۶۲	Me 262戰鬥機
شگموښی	砂纸
ايليوشين-۷۶	伊留申76
فرایشتات	弗賴施塔特
هربرټ سپېنسر	赫伯特·斯宾塞
زلمی رسول	扎尔迈·拉苏尔
سارک	南亚区域合作联盟
يوسف	約瑟 (舊約聖經)
د لويديځ سلاوي ژبې	西斯拉夫语支
اروپايي صنوبر	歐洲雲杉
چمبل	堇菜属
پولي ونيل کلورايډ	聚氯乙烯
نانگه	紅加侖
قبطيان	科普特人
ټاټرا ۸۱۷	太拖拉 817
نارنج	苦橙
اناناس	凤梨属
کاجول	卡約兒·德烏根
ايگلا	SA-18防空飛彈
مېگ ۳۱	米格-31戰鬥機
پښيميسل اوتاکار ۲	普热米斯尔·奥托卡二世
رودلف ۲ هابسبورگ	鲁道夫二世 (神圣罗马帝国)
عبد العزيز بن عبدالرحمن بن فيصل آل سعود	阿卜杜勒-阿齐兹·本·阿卜杜拉赫曼·本·费萨尔·阿勒沙特
دېوالي	破產
بوغمه	水肿
محمد ظاهر شاه	穆罕默德·查希尔沙
ډگر جنرال	中將
بريد جنرال	准將
سيف الله کلا ولسوالۍ	基拉赛福拉县
البرخت فون والدشتاین	阿尔布雷赫特·冯·华伦斯坦
امير امان الله خان	阿曼諾拉汗
عمران خان	伊姆蘭·罕
یان لوگزامبورگ	约翰一世 (波希米亚)
جيارډيا لامبليا	兰氏贾第鞭毛虫
ميل می ۸	Mi-8直升機
مېسرشمېت بي اف ۱۰۹	Bf 109戰鬥機
مسراشمیت بي اف ۱۱۰	Bf 110戰鬥機
یوزي	烏茲衝鋒槍
ريچارډ هولبروک	理查德·霍布魯克
ميل می ۲۴	Mi-24雌鹿直升機
ايساف	駐阿富汗國際維和部隊
ټې-۷۲	T-72主戰坦克
یونکرس یو ۸۸	Ju 88轟炸機
کارل ۴	查理四世 (神圣罗马帝国)
مېگ ۲۳	米格-23战斗机
ارهنډه	蓖麻
اېرو ال-۳۹ الباتروس	L-39信天翁
نېښ لرونکي بوټي	异株荨麻
د آلمان ملي دموکراتیک گوند	德國國家民主黨
رشقه	紫花苜蓿
سره غوړیانه	欧洲百合
فيض آباد (بدخشان)	法扎巴德 (阿富汗)
ځريځه	红花
تورن جنرال	少将
گزک بوټي	长叶车前
ال – ۴۱۰	Let L-410
تبو	塔布 (女演員)
غوماشی	瘧蚊
د افغانستان ولايتونه	阿富汗行政區劃
تاووس پتنگ	孔雀蛱蝶
جوهي چاولا	菊希·曹拉
پريانکا چوپړا	佩麗冉卡·曹帕拉
ويديا بالان	瑋焍婭·芭蘭
لاکهيډ مارتين آر کيو ۱۷۰ سېنټينل	RQ-170偵查機
ناصر الدين شاه قاجار	納賽爾丁·沙
سپما گڼون	存款
د اس وې ډې دراگونوف ټوپک	SVD狙擊步槍
وټه	经济
د ځمکې گړۍ	地球一小时
رام	羅摩
محمد علی جناح	穆罕默德·阿里·真納
وچکۍ تبه (محرقه)	斑疹傷寒
اتره	軀幹
توت خوره	燕雀科
شاتوت	黑桑
سنځله	胡颓子属
ښاريتوب	城市化
غونجېدنه (وټپوهنه)	通货紧缩
خپلپالنه	裙帶關係
باور کارټ	信用卡
پامير	帕米爾高原
وېلنی	欧薄荷
سيسۍ	雷鸟属
سرطانپوهنه	肿瘤学
گلايکوليسېز	糖酵解
شکودا فابيا	斯柯达晶锐
گایوس واليریوس کاتولوس	卡图卢斯
بلوچستان (پاکستان)	俾路支省
غالۍ	地毯
موزيکپوهنه	音乐学
ليندۍ	摩羯宮
ابسه	膿瘍
کدو	南瓜
د کرمان ولايت	克爾曼省
بدخشان ولايت	巴达赫尚省
لیکاڼۍ	筆
اتڅنډی	八边形
مچ	家蠅
وړانديز (وټپوهنه)	供给和需求
پارلماني حکومت	議會制
برغټ	兔猻
نگوس	刻板印象
نورستان ولايت	努尔斯坦省
محمد قسيم فهيم	穆罕默德·法希姆
ډولومیت	白云石
جابر بن حیان	贾比尔
بورقه	波卡
کرايووا	克拉約瓦
کورکوری	欧斑鸠
روحانيت	靈性
انافلاکسي	全身型過敏性反應
د اسلام انبیاء	伊斯蘭教的先知
لاسپېله	手套
محمد زکريا رازي	拉齐
گرافېن	石墨烯
رنځېږن	病原体
ليکپاکټ	封套
کانفدراسيون	邦联制
ټي اېن ټي	三硝基甲苯
چېکيان	捷克人
بغلان ولايت	巴格兰省
ابټ آباد	阿伯塔巴德
بدن	身體
يزد ولايت	亞茲德省
قم	库姆
توماس اېډورډ لارېنس	托马斯·爱德华·劳伦斯
بيولوژيکي وسلې	生物武器
ټېغکه	伯劳科
عباس ۱	阿拔斯一世 (波斯)
باميان ولايت	巴米扬省
ای اچ ۶۴ آباچی	AH-64阿帕契直升机
لمرگلی	向日葵
د سهېلي خراسان ولايت	南呼羅珊省
پېښه	意外事故
کرمان	克尔曼
احمديت	阿赫迈底亚
د اگرې کلا	阿格拉堡
د مذهب خپلواكي	宗教自由
تيتر	珠雞
ځانگړواله	个人主义
بادغيس ولايت	巴德吉斯省
قبة الصخرة جومات	圆顶清真寺
اشرف غني احمدزی	阿什拉夫·加尼·艾哈迈德扎伊
رېبز	帚
ټوپولف ټو-۱۵۴	圖-154
نړیواله پېغله	世界小姐
آټوکراسي	独裁
خواړه ساتنه	食品保存
مارگريت ميتچېل	玛格丽特·米切尔
آرگېنين	精氨酸
سوخوی سو ٢٧	苏-27战斗机
ام۱ آبرامس	M1艾布蘭主力戰車
غزني	加兹尼
وختتېری	娛樂
کندهار ولايت	坎大哈省
کاپيسا ولايت	卡比萨省
هلمند ولايت	赫尔曼德省
فارياب ولايت	法利亚布省
محراب	米哈拉布
د الازهر پوهنتون	艾資哈爾大學
بوتل پزی څوڅ	宽吻海豚
اوسېلوسکوپ	示波器
توحيد	認主學
بي-٥٢ سټراټوفورټرېس	B-52同溫層堡壘轟炸機
کوډيين	可待因
فتح علي شاه قاجار	法特赫-阿里沙·卡扎爾
بېديانۍ پيشو	沙漠猫
تانبه:تاریخ	Portal:历史
واتسلاف ۱	瓦茨拉夫一世
د اسلام پنځه بنسټونه	五功
زوی	兒子
سکاره	木炭
شنقار	海东青
د ژونکې تيوري	细胞学说
فولېرېن	富勒烯
نېکروسېز	壞死
د واشنگټن څلی	華盛頓紀念碑
آنتونوف-۲۲۵	An-225運輸機
وييپوهنه	词汇学
ننگرهار ولايت	楠格哈尔省
درونکښ	起重机
روژه	齋戒 (伊斯蘭教)
کاني اوبه	礦泉水
نولۍ	矇眼貂
لگښت ساتنې تگلاره	贸易保护主义
آنتیستنس	安提西尼
مرکزي حکومت	单一制
د پاکستان په شمال لویدیځ کې جگړه	巴基斯坦西北部战争
اسماني کتابونه او صحيفې	宗教經典
ژبساپوهنه	心理语言学
اوبزمکپوهنه	水文地质学
د مزلو د اړتیاوو د مرتبو سلسله	需求层次理论
د بازار وټه	市场经济
اپیکوریزم	伊比鳩魯學派
اورمازده	阿胡拉·馬茲達
درملنه	疗法
اريايان	雅利安人
يعقوب کندي	肯迪
گورجېس	高爾吉亞
سياسي فلسفه	政治哲学
جوهر دوداییف	焦哈尔·杜达耶夫
ايوب	约伯
د افغانستان ولسي لاره	阿富汗国歌
ستورمزلي	太空探索
اېکونومېسټ	经济学人
تورگوت اوزال	图尔古特·厄扎尔
نورتورپ گرومان بي ۲ سپېريټ	B-2幽灵战略轰炸机
لمريز لېږديز کليز	伊朗曆
فراه ولايت	法拉省
غزني ولايت	加兹尼省
وړانگدرملنه	放射線療法
کوټه	房間
شاپ	栓剂
پوهنځی	學院 (大學)
نکوټي يانا ټیبېکم	烟草
بلوچستان	俾路支斯坦
سيد حسن نصرالله	哈桑·纳斯鲁拉
دايکندي ولايت	代孔迪省
پنجشېر ولايت	潘傑希爾省
زړه نابری	心臟衰竭
ټوپولف ټو-۹۵	Tu-95轟炸機
د جانسي راني	詹西女王
بلخ	巴尔赫
امونيم نايټرېټ	硝酸铵
آسيايي زمري	亞洲獅
کامبوجيه ۲	冈比西斯二世
سرپل ولايت	薩爾普勒省
پکتيا ولايت	帕克蒂亚省
خوارزم	花剌子模
بهرونه	出口贸易
ايټا جېمز	伊特·珍
كنسرټ	音樂會
هرات ولايت	赫拉特省
سمنگان ولايت	萨曼甘省
نيمروز ولايت	尼姆鲁兹省
روزگان ولايت	乌鲁兹甘省
جوزجان ولايت	朱兹詹省
ميدان وردگ ولايت	瓦尔达克省
کورکوړۍ	蜂虎科
شننيزه فلسفه	分析哲學
سېموېل کولټ	塞缪尔·柯尔特
جلالکوټ	賈拉拉巴德 (阿富汗)
خيبر پښتونخوا	开伯尔-普什图省
سينوسايټس	鼻竇炎
موکشا	解脫
اسماعيل	以实玛利
نسخوږی	腹痛
لسڅنډی	十边形
چينايي فلسفه	中国哲学
بوينگ بي ۲۹	B-29超級堡壘轟炸機
کرينه کپور	卡琳娜·卡浦爾
بوينگ بي ۱۷ فلاينگ فورټرېس	B-17轟炸機
واسلين	凡士林
فلېپيني عقاب	食猿鵰
لغمان ولايت	拉格曼省
مولتان	木爾坦
کوټه (ښار)	奎達
پکتيکا ولايت	帕克蒂卡省
خوست ولايت	霍斯特省
کيفيت	品质
د لوی اختر مياشت	都爾黑哲月
بريدمن	中尉
علي اکبر هاشمي رفسنجاني	阿克巴尔·哈什米·拉夫桑贾尼
ايمن الظواهري	艾曼·扎瓦希里
رنځورپاله	護理人員
غور ولايت	古爾省
تخار ولايت	塔哈尔省
کندوز ولايت	昆都士省
د پاکستان د خلکو گوند	巴基斯坦人民党
د اتریش د خلک ګوند	奥地利人民党
ايبوپروفېن	布洛芬
کارسک گيدړ	沙狐
ابهيشېک بچچن	阿彼锡·巴克罕
سالنډي	呼吸困难
کونړ ولايت	库纳尔省
پروان ولايت	帕尔旺省
آيت	阿亞
قول اردو	军 (军队)
ايمفيسېما	肺氣腫
احمد ياسين	艾哈迈德·亚辛
برهان الدين رباني	布爾漢努丁·拉巴尼
پريټي زېنتا	普丽缇·泽塔
صحابه	薩哈巴
سمایلوډون	斯劍虎
مېرمن	妻子
اوڅنډی	七边形
د افغانستان پېښليک	阿富汗历史
کابل ولايت	喀布尔省
ټېډ	TED大会
آندری کاراطايف	安德烈·科罗塔耶夫
سلطان محمود غزنوي	伽色尼的马哈茂德
د زړه ارېتميا	心律不整
پینټریټ	季戊四醇四硝酸酯
اسلامي هنر	伊斯蘭藝術
اسلامپالنه	伊斯兰主义
پوښتنه	疑問句
هیکسوجن	黑索金
ميناتو	港區 (東京都)
اوښلن لوگی	催淚彈
کوستا کونکورديا	歌詩達協和號
د زړه ناروغۍ	心脏病
ابو حنيفه (امام اعظم)	阿布·哈尼法
مرکاوا شوبله	梅卡瓦主战坦克
جوهر	本质
ټوپولف ټو-۱۶۰	Tu-160海盗旗战略轰炸机
شيطاني آيات	撒旦诗篇
خيبر دره	开伯尔山口
شاپور ۱	沙普尔一世
سيلدينافيل	西地那非
تکبیر	大赞辞
مالي کال	財政年度
سوخوی سو-۲۵	Su-25攻擊機
پرولاکټين	催乳素
ټانگتوره	曼陀罗属
تیسفون	泰西封
ډېلي ټيليگراف	每日电讯报
سټرېپټومايسين	鏈黴素
هندي څمڅه منگور	印度眼鏡蛇
ټې-۹۰	T-90主戰坦克
نادر شاه افشار	纳迪尔沙
د بوټي هورمون	植物激素
ټېټراسايکلين	四環黴素
اسلامي فلسفه	伊斯兰哲学
سبسيډي	補貼
د پراگ کلا	布拉格城堡
آنتونوف-۱۲۴	安托諾夫An-124
هود	呼德
خړانکه	鹨属
ملا محمد عمر	穆罕默德·奥马尔
کړنی سېک	动作电位
سوخوی پک فا	T-50戰鬥機
شاهرخ افشار	沙魯克·阿夫沙爾
ام کيو-۱ پرېډاټور	MQ-1捕食者无人攻击机
زيډووډين	齐多夫定
افغانۍ	阿富汗尼
مېگ ۲۵	米格-25战斗机
د سږو اوندنه خنډيزه ناروغي	慢性阻塞性肺病
احمد شاه مسعود	艾哈迈德·沙阿·马苏德
داسو میراژ- ۲۰۰۰	幻影2000战斗机
نهڅنډی	九邊形
آزاد کشمير	自由克什米爾
اوبسپی	水獺
چينايي دوديزه درملگري	中医学
گېلگېت بالتستان	吉尔吉特-巴尔蒂斯坦
بلوڅان	俾路支人
کېټ وېنسلېټ	凱特·溫斯蕾
نيوموتوراکس	氣胸
اورو لانکاسټر	蘭開斯特轟炸機
رمضان بشردوست	拉马赞·巴沙里德斯特
لرغونې فلسفه	古典哲学
زين العابدين بن علي	宰因·阿比丁·本·阿里
يوني ماشين	离子推力器
نېټه	日期
ایزو ۹۰۰۰	ISO 9000
اليسع	以利沙
معمولي څوڅ	真海豚
ترچ مير	蒂里杰米尔峰
مطبوعاتي اعلاميه	新聞稿
محمد نجيب الله	穆罕默德·纳吉布拉
قونسلگري	领事
فدرالي قبايلي سيمې	联邦直辖部落地区
د مذهب فلسفه	宗教哲学
ډايازيپم	地西泮
سوخوی سو-۲۴	Su-24戰鬥轟炸機
کورټيکوسټېرويډ	皮質類固醇
غوږور ښاپېرک	普通长耳蝠
چندړ	檀香
سيد قطب	赛义德·库特布
بوکو حرام	博科圣地
السلام عليکم	色兰
خسرو پرويز	霍斯劳二世
اېنډوسکوپي	內視鏡
مېړه	丈夫
غونډل	捕鳥蛛科
گندهارا	健馱邏國
يان ژيژکا	揚·傑式卡
ستره لوبه	大博弈
لاجورد	青金石
مقتدی الصدر	穆克塔达·萨德尔
چت	地板
يزيد بن معاويه	耶齐德一世
آلانين	丙氨酸
ښکلي هنرونه	美術
افدرين	麻黃鹼
ای اچ ۱ کبرا	AH-1眼鏡蛇直升機
سورة الفاتحة	開端章
سورة البقرة	黃牛章
جنگسالار	军阀
د سږو امبولي	肺栓塞
ښي لاسی او کيڼ لاسی ترافيک	道路通行方向
برات	舍爾邦月
سورة النمل	螞蟻章
De Havilland Mosquito	蚊式轟炸機
کيشپ	龜
شکودا اوکټاويا	斯柯达明锐
سټېنگر FIM-92	FIM-92刺針飛彈
دماغي مړينه	脑死
د وټيزو همکاريو سازمان	经济合作组织
شوننېزم	沙文主义
امريکا غږ	美国之音
درې بعدي چاپگر	3D打印
مامولکه	鹡鸰属
حسن البنا	哈桑·班納
سورة الزخرف	金飾章
سورة الدخان	煙霧章
سورة الجاثية	屈膝章
سورة الأحقاف	沙丘章
سورة محمد	穆罕默德章
سورة الفتح	勝利章
ډېل کارنېگي	戴尔·卡耐基
روح الله نېکپا	鲁胡拉·尼帕伊
سورة المجادلة	辯訴者章
مېتی	鶴嘴鋤
مادهوري ډکشټ	瑪都麗·荻西特
جامنو	閻浮樹
سورة التكوير	黯黮章
سورة الفجر	黎明章
د ماغزو تومور	脑肿瘤
د پاني پت دوهمه جگړه	第二次帕尼帕特战役
د افغان-انگرېز دويمه جگړه	第二次英国-阿富汗战争
سار	棕尾鵟
اکشې کمار	阿克夏·庫馬
مکه معظمه	麥加省
سپين توت	檄樹
سورت	蘇拉
د هند کمونیست گوند (مارکسیست)	印度共产党（马克思主义）
مکي سورتونه	麥加篇章
مدني سورتونه	麥地那篇章
حديث	聖訓
شاپور ۲	沙普尔二世
حج	朝觐 (伊斯兰教)
ټې-۸۰	T-80主戰坦克
ميل مي - ۲۸	Mi-28攻擊直升機
ديکلوفيناک	双氯芬酸钠
سوخوی سو ۳۵	Su-35戰鬥機
پيچکاري	注射
د غزنويانو ټولواکمني	伽色尼王国
اواران ولسوالۍ	阿瓦兰县
بارخان ولسوالۍ	巴尔汗县
فيفا	国际足球联合会
سوشميتا سېن	苏丝米塔·森
ريشي کپور	里希·卡普尔
۳۹×۷،۶۲ مرمی	7.62×39mm
ږدن	杂谷
حاد مايلوييد ليوکېمي	急性骨髓性白血病
حاد کرونري ساينډروم	急性冠状动脉综合症
د کارلشتین کلا	卡尔什特因城堡
بلنځه	梭梭属
پلسيوسور	蛇頸龍亞目
کاموف کا ٥٠	Ka-50攻擊直升機
گڼ پوهيال	博学家
شري دېوي	詩麗黛瑋·阿雅潘
د سپاه پاسداران انقلاب اسلامی ځواک	伊斯兰革命卫队
آنتونوف-۱۲	安-12
نوشاخ	诺沙克峰
خبري غونډه	記者會
ايليوشين-۹۶	伊留申-96
خټگري	砌体结构
بسم الله الرحمن الرحيم	太斯米
دويمه خور	赖比尔·阿色尼月
کلورامفينيکول	氯霉素
انټر سرويس انټېلېجنس (ISI)	巴基斯坦三軍情報局
کيچ ولسوالۍ	科奇县
چاغي ولسوالۍ	查盖县
اېسټروجن	雌激素
HACCP	危害分析重要管制點
مچواژی	苍蝇拍
غزل	加扎勒
سوابۍ ولسوالۍ	斯瓦比县
مېگانېورا	巨脈蜻蜓
دېره اسماعيل خان ولسوالۍ	德拉伊斯梅尔汗县
د پاکستان د انصاف غورځنگ	巴基斯坦正義運動黨
اېرېسوس موراویکوس	摩拉维亚瓢虫蜘蛛
د ډيورنډ کرښه	杜兰线
يعقوب	雅各 (舊約聖經)
لارا دتا	拉腊·杜塔
سيد جمال الدين افغاني	贾迈勒丁·阿富汗尼
نور محمد ترکی	努尔·穆罕默德·塔拉基
عافيه صديقي	阿菲亚·西迪基
د راديوايزوټوپونو ترموبريښنایی جنريټر	放射性同位素熱電機
آلانين ټرانس امينېز	谷丙转氨酶
ايبټ اباد ولسوالۍ	阿伯塔巴德县
ختيځي مچۍ	東方蜜蜂
ختيځه فلسفه	東方哲學
لور	女兒
ميمنه ولسوالۍ	迈马纳
الشباب	青年党 (索马里)
سردار محمد داود خان	穆罕默德·达乌德汗
ماخۍ	骆驼刺属
عبدالقدير خان	阿卜杜勒·卡迪尔·汗
سلطان قطب الدين ايبک	庫特布丁·艾伊拜克
بيټالکټمېز	Β-内酰胺酶
پلازموډيم فالسيپارم	恶性疟原虫
رودکي	鲁达基
غزی	长脚鹬属
عبدالصبور فريد کوهستاني	阿卜杜勒·萨布尔·法里德
عبدالله عبدالله	阿卜杜拉·阿卜杜拉
جرمېن جېکسن	傑曼·傑克森
والېري ولاديميروويچ پولياکوف	瓦列里·波利亚科夫
احمد شاه قاجار	艾哈邁德沙·卡扎爾
مېلبورن پوهنتون	墨尔本大学
داسو میراژ اف‌۱	幻象F1型戰鬥機
آر پي جي-۷	RPG-7
آغا محمد خان قاجار	阿迦·穆罕默德汗
صالح	撒立哈
گڼونکی	會計師
د ۲ کا ۱۲ کوب راکټی سیستم	SA-6导弹
د افغانستان جگړه (۲۰۰۱)	持久自由军事行动
اس-۲۰۰	S-200导弹
قانوني لاسوندونه	法律行為
ويي جوړښت	造词法
تايروکسين	三碘甲腺原氨酸
ادريس	易德立斯
د سولې نړيواله ورځ	国际和平日
د بهرنيو اړيکو او څارگرۍ اداره	国外事务情报处
پادشاهی جومات	巴德夏希清真寺
عبدالرشيد دوستم	阿布都·拉希德·杜斯塔姆
کريم خان زند	卡里姆汗
اپورتونېزم	投機主義
بيت الله محسود	贝图拉·马哈苏德
ابوبکر	阿布·伯克尔
ابو مسلم خراساني	阿布·穆斯林
جيورج ايډېن	乔治·伊登，第一代奥克兰伯爵
کاشي	釉
راجپوت	拉其普特人
صليبي غڼه	十字园蛛
ناوې	新娘
محمد علي شاه قاجار	穆罕默德·阿里·沙
محمد نادر شاه	穆罕默德·纳第尔·沙阿
سلمان ابن عبدالعزیز آل سعود	萨勒曼·本·阿卜杜勒-阿齐兹·阿勒沙特
پټه لرونکی ژگاگ	臭鼬
اردشیر پاپاکان	阿尔达希尔一世
هېماټويوريا	血尿
د سوریانو ټولواکمني	苏尔王朝
جده	吉达
د چين نړيواله راډيو	中国国际广播电台
هندي فلسفه	印度哲学
د ايران هوايي ځواک	伊朗空军
لوييس سلوتين	路易斯·斯洛廷
صبغت الله مجددي	西卜加图拉·穆贾迪迪
آر کیو - ۱۱ ړاوېن	RQ-11渡鴉式無人偵察機
ال-۱۵۹ الکا	L-159 ALCA
ولاديمير الېکساندروويچ کريوچکوف	弗拉基米尔·亚历山德罗维奇·克留奇科夫
لمن لگښت	边际成本
د افغانستان د فوټبال فدراسيون	阿富汗足球協會
کارلوی واری	卡罗维发利
خوست	霍斯特
سوات ولسوالۍ	斯瓦特县
د هخامنشیانو ټولواکمني	阿契美尼德王朝
شکودا سوپرب	斯柯达昊锐
معیاري ژبه	标准语
سايکلوفوسفمايډ	环磷酰胺
ایندومټاسین	吲哚美辛
هېکزامېتيلين ټرايپرآکسيډايامين	六亚甲基三过氧化二胺
اوکټوجن	奥克托今
اوميپرازول	奥美拉唑
بودېسونايد	布地奈德
فېنواکسيمېتيل پېنيسيلين	青霉素V钾
ديجوکسين	地高辛
ډيلټيازيم	地尔硫䓬
مېټوټرکسات	氨甲蝶呤
دوكسيسايكلين	多西环素
جنټامايسين	庆大霉素
ډيډانوسين	地达诺新
لاميووډين	拉米夫定
رانيتيدين	雷尼替丁
وانکومايسين	萬古黴素
الاقصی جومات	阿克萨清真寺
د افغانستان اسلامي امارت	阿富汗伊斯蘭酋長國
مسجد الحرام	禁寺
الخالد شوبله	MBT-2000主战坦克
منبر	敏拜爾
اسلامي بانکوالی	伊斯蘭銀行
سوخوی سو ٣٧	Su-37戰鬥機
کرېشما کپور	卡麗詩瑪·卡浦爾
ملکه رضيه	拉齊婭
رېکها	瑞卡
شرميلا تاگور	莎米拉·泰戈
وحيده رحمان	凡伊芳妲·李曼
ديا مرزا	迪雅·梅莎
آلماني چابکۍ	德國蟑螂
لخدر ابراهيمي	拉赫达尔·卜拉希米
فرېدرېک بارټ	弗雷德里克·巴特
غياث الدين کيخسرو بن کيقباد	凱霍斯魯二世
مظفر الدين شاه قاجار	穆扎法爾丁·沙
د درانيانو ټولواکمني	杜蘭尼王朝
گردېز	加德兹
ملټيپل ميولوما	多發性骨髓瘤
بوينگ بي ۴۷ سټراټوجېټ	B-47轟炸機
اسکاريس لومبريکويډېس	蛔虫
ابن زهر	伊本·蘇爾
لومړۍ خور	赖比尔·敖外鲁月
لښکرگاه	拉什卡尔加
تالقان	塔卢坎
دوشکا (د الوتکو ويشتونکي ماشيندار)	DShK重機槍
شريعت	伊斯蘭教法
اوزبکان	乌孜别克族
ازمېښتون	实验室
جيروسكوپ	陀螺儀
تاجکيان	塔吉克族
سني اسلام	遜尼派
آزربايجاني منات	阿塞拜疆马纳特
بې پيلوټه الوتکه	無人航空載具
محمد اقبال	穆罕默德·伊克巴勒
فقه	伊斯蘭教法學
چنگېز ايتمانوف	钦吉斯·艾特玛托夫
مۍ	绿豆
د باميانو بودايي پژۍ	巴米揚大佛
تورکمنان	土庫曼族
نړیوال سازمان	国际组织
د ژبې فلسفه	语言哲学
شانگهای د همکاريو سازمان	上海合作组织
کلبيان	犬儒學派
د آزادۍ راډيو	自由欧洲电台／自由电台
اورنگزیب عالمگیر	奥朗则布
راني موکېرجي	拉妮·穆科吉
مسجد نبوي	先知寺
اسلاموفوبيا	伊斯兰恐惧症
ازبکستاني سوم	烏茲別克索姆
صفره	色法尔月
بولندوی	中校
د افغانستان ولسوالۍ	县 (阿富汗)
مېټامتريال	超材料
الوتکه (فلم)	空前绝后满天飞
د شاه فیصل جومات	費薩爾清真寺
د اوبو ښاپېرک	水鼠耳蝠
نېفروټېک ساينډروم	腎病症候群
انځور خبريالي	攝影記者
د افغانستان د لارښودانو لړليک	阿富汗君主列表
سنتره	瓯柑
تومانچه مادل ۵۲	CZ-52手槍
د الماني ژبې گرامر	德语语法
ټريپانوسوما	锥虫
ماشین گڼ ماډل ۵۹	Vz. 59通用機槍
پېښور ولسوالۍ	白沙瓦县
څاڅکي	眼藥水
محمد شاه قاجار	穆罕默德沙·卡扎爾
ميرويس هوتک	米爾維斯·霍塔克
محمد عالم خان	穆罕默德·阿里木
شاه اشرف هوتک	阿什拉夫·漢達基
ډانگ لکۍ	寿带鸟
پروټينيوريا	蛋白尿
رضوي خراسان ولايت	礼萨呼罗珊省
بفر سټېټ	緩衝國
تومانچه مادل ٧٥	CZ-75手槍
سکن ایگل	扫描鹰无人机
جعفر اباد ولسوالۍ	贾法拉巴德县
څارنوال	檢察官
ټرانس امينېشن	转氨基作用
د پاني پت لومړۍ جگړه	第一次帕尼帕特战役
بوکان	布坎
آنتونوف-۱۴۸	安-148
کلات ولسوالۍ (بلوچستان)	喀拉特县
ابهيدا	阿毘曇
امير ډنډ	班達米爾國家公園
ټوپولف ټو-۳۳۴	圖-334
ډئيزم	自然神论
دگماتېزم	教條
گلسر	金额丝雀
اوبدرملنه	水療
برېښنامېچ	電度錶
ښځه په اسلام کې	婦女與伊斯蘭教
ملي گټې	国家利益
د هوتکيانو ټولواکمني	漢達基王朝
جان گرين	約翰·葛林
د تودوخې د لېږد وړتیا	传热系数
اسلامي تاريخ	伊斯兰教历史
آريانا افغان هوايي شرکت	阿里亚纳阿富汗航空
شهاب ۳	流星3型飛彈
اسحاق	以撒
بانکي گڼون	銀行帳戶
د کوچني اختر مياشت	閃瓦魯月
اسد آباد	阿萨达巴德 (阿富汗)
زو – ۲۳ – ۲	ZU-23-2雙管高射炮
ټاټرا ۸۱۵	太拖拉 815
اېف ۱ لاسي بم	蘇聯F-1手榴彈
ارسلا رحماني	阿尔萨拉·拉赫马尼
د اسيايي هېوادونو لړليک	亚洲国家和地区列表
اجاره	贌
درملپېژندنه	药效学
ريگويدا	梨俱吠陀
کوهستان ولسوالۍ (پښتونخوا)	科伊斯坦县
طيبه لښکر	虔誠軍
د غشی زهر آبي چونگښه	天蓝丛蛙
جي اېف ۱۷ تهنډر	梟龍戰機
حامد کرزی نړيوال هوايي ډگر	喀布尔国际机场
وزلوبه	布玆卡兹
آية الکرسي	寶座經文
تپندۍ	灰匙
معمولي وامبټ	塔斯馬尼亞袋熊
تور-ام۱	SA-15导弹
بوټځمکپوهنه	植物地理学
امام حسين جومات	伊玛目侯赛因圣陵
لېیوروس قوینقوېستریاتوس	以色列金蠍
ملتون	公司
اسلامي ساينس	中世紀伊斯蘭世界的科學
ظهير الدين محمد بابر	巴卑尔
پاکستان مسلم لیگ ن	巴基斯坦穆斯林联盟（谢里夫派）
درېيځ (مېچپوهنه)	立方體
آتريال فېبرېلېشن	心房顫動
چاپېريال ساتنه	环境保护
ماشيندار مادل ٦١	Vz.61蠍式衝鋒槍
جنت	天堂 (伊斯蘭教)
فيزيکي کتنه	体格检查
يهودي فلسفه	猶太教哲學
اومان	麻黃屬
امام علي آرام ځاي	伊玛目阿里清真寺
لوېديځه فلسفه	西方哲学
لويه جرگه	支尔格大会
اسلامي زده کړې	伊斯蘭研究
2G	2G
آئیسو 639-3	ISO 639-3
ټوپک مادل ٥٨	Vz.58突擊步槍
کومييز سرطان	喉癌
پېرودونکی	顧客
د استخباراتو امنيتي اداره	安全情报服务
عيسوي فلسفه	基督教哲学
دوه څنډی	二角形
زوم	新郎
د ناروغيو لړليک	疾病列表
يوناني درمل	草藥醫學
د مهدي پوځ	迈赫迪军
ليکتوکي	文具
د اکولا اوبتل	971型核潜艇
د بازار جوړښت	市场形式
چترال ولسوالۍ	奇特拉尔县
ډانا مادل ۷۷ لیري ویشتونکي توپ	152mm SpGH 自走加農砲
دارالامان ماڼۍ	达鲁尔·阿曼宫
توردلی	石䳭屬
د رېږدلې انجنيري	地震工程
ماليکولي ننوونی	分子筛
هندو (ورځپاڼه)	印度教徒報
گجرات	古傑拉特
سجده	蘇朱德
ميدان ښار ولسوالۍ	迈丹城
د سيستان او بلوچستان ولايت	錫斯坦－俾路支斯坦省
اورشلیمی کنيسه	禧年会堂
ايراني هڅوب	伊朗文化
بژېونوف صومعه	布雷诺夫修道院
ستراهوف صومعه	斯特拉霍夫修道院
ډانا ټايرون روهراباکر	达纳·罗拉巴克
د افغانستان د تاريخ پېښليک	阿富汗历史年表
اېکزېما	湿疹
د افغان-انگرېز لومړۍ جگړه	第一次英阿战争
مردان	馬爾丹
لرغونې يوناني فلسفه	古希腊哲学
يشناټکی	沸点
د فارس ولايت	法爾斯省
د نړۍ برحاله هېوادمشران	各国领导人列表
مستونگ ولسوالۍ	马斯吞县
هالي بېري	荷莉·貝瑞
1G	1G
د روسيې دولتي کتابتون	俄罗斯国立图书馆
اندخوی ولسوالۍ	安德胡伊
اسيا پېسفيک	亚太地区
يوڅنډی	一角形
گڼيال رسنۍ	数字媒体
لادا اوبتل	拉达级潜艇
پېښور	白沙瓦
کرک ولسوالۍ	喀拉克县
آر پي جي – ۲۹	RPG-29
څېړنيزه خبريالي	调查报导
جرمنۍ غومبسه	德国黄胡蜂
د افغانستان ولسمشر	阿富汗总统
د مخترعینو لړليک	发明家列表
د افغانستان حکومت	阿富汗政治
خروشتي	佉卢文
جل وهنه	熱病
مشرانو جرگه	长老院 (阿富汗)
اپولینارېزم	亚玻里拿留派
ونډه (وټپوهنه)	股票
لافايټ جنگي بېړۍ	拉法葉級巡防艦
گڼيه	房地產抵押
ناپروکسين	萘普生
شکوڼ	豪豬
ويکيپېډيا:نړيواله غږيزه ابېڅې	Wikipedia:國際音標
تعبیه شوی چاودیدونکی وسیله	簡易爆炸裝置
کوهاټ ولسوالۍ	科哈特县
د پاني پت دريمه جگړه	第三次帕尼帕特战役
د افغان-انگرېز درېمه جگړه	第三次英国-阿富汗战争
کرج ولسوالۍ	卡拉季县
سولگریز جال	计算机网络
د حکومت بڼې	政体
قارون	可拉
اسلامي هڅوب	伊斯兰文化
اسلامي وټه	伊斯兰经济
کابل پوهنتون	喀布尔大学
موسکيټ	P-270蚊子导弹
ویرا غیر فعال څارونکی سیستم	维拉无源跟踪系统
د کاربن ډای اکسایډ ليزر	二氧化碳激光器
د اصفهان ولايت	伊斯法罕省
ويکيپېډيا:وييپانگه	Wikipedia:术语表
وېشنيزه:د امريکا متحده ايالات	Category:美国
وېشنيزه:روسيه	Category:俄罗斯
وېشنيزه:کاناډا	Category:加拿大
وېشنيزه:برطانيه	Category:英国
وېشنيزه:چين	Category:中国
وېشنيزه:هندوستان	Category:印度
وېشنيزه:سعودي عربستان	Category:沙烏地阿拉伯
وېشنيزه:ايران	Category:伊朗
پښتونولي	普什圖瓦里
لامبوځنه ښیښه	浮法玻璃
ابدالي	阿卜达里
د مقدس جورج کلیسا	圣乔治圣殿 (布拉格)
وېشنيزه:افغانستان	Category:阿富汗
وېشنيزه:الجېريا	Category:阿爾及利亞
وېشنيزه:عراق	Category:伊拉克
وېشنيزه:نېدرلانډ/هالېنډ	Category:荷兰
وېشنيزه:نايجېريا	Category:奈及利亞
وېشنيزه:پاکستان	Category:巴基斯坦
وېشنيزه:د روم امپراطوری	Category:罗马帝国
وېشنيزه:مارغان	Category:鸟类
وېشنيزه:بوټي	Category:植物
وېشنيزه:ژونپوهنه	Category:生物学
وېشنيزه:پېښليک	Category:历史
وېشنيزه:ځمکپوهنه	Category:地理
وېشنيزه:ټولنه	Category:社会
وېشنيزه:مذهب	Category:宗教
وېشنيزه:ورزښت	Category:体育
وېشنيزه:اروپايي اتحاديه	Category:欧盟
وېشنيزه:ټوليزې رسنۍ	Category:大眾媒體
وېشنيزه:ځمکه	Category:地球
بر دير ولسوالۍ	上第尔县
رڼايي سپڼسيزې اړيكې	光纖通訊
د الضرار ټانک	阿茲拉主戰坦克
خواږه مرچ	菜椒
گوند مشر	政党领袖
نوښار ولسوالۍ	瑙谢拉县
د پاکستان هوايي ځواک	巴基斯坦空軍
رباب	热瓦甫
سرپل	萨尔普勒
پښتونستان	普什图尼斯坦
اورمکۍ	蛾
کينډۍ:/بکس-پايليک	Template:Box-footer
ابراهيم	易卜拉欣
نړيواله ټولنه	国际社会
ملهم	软膏剂
کاربون نانو نل	碳纳米管
د افغانستان هوايي ځواک	阿富汗空軍
د ۰۵۲ بي جنگي بېړۍ	052B型导弹驱逐舰
کيشکره	星鸦属
د حسن او حسين مياشت	穆哈兰姆月
د ملي دفاع پوهنتون	美国国防大学
د افغانستان وټه	阿富汗经济
وېشنيزه:فلسفه	Category:哲学
وېشنيزه:عيسويت	Category:基督教
وېشنيزه:اسلام	Category:伊斯兰教
وېشنيزه:يهوديت	Category:犹太教
پارت	安息帝國
تاکتيک	战术
لکي مروت ولسوالۍ	拉基玛瓦县
بونير ولسوالۍ	布内尔县
شريا گوشل	舒蕾亞·戈沙爾
گوادر ولسوالۍ	瓜达尔县
گوربت	鵰
د افغانستان ولسي جرگه	人民院 (阿富汗)
تخنيکي خبريالي	技术新闻学
چسکی کروملوف (ماڼۍ)	捷克克鲁姆洛夫城堡
اسلام او عيسويت	伊斯蘭教與基督教
وړانگه	Ray
مولتان ولسوالۍ	木尔坦县
پشين ولسوالۍ	皮辛县
فيصل آباد ولسوالۍ	费萨拉巴德县
حافظ آباد ولسوالۍ	哈费扎巴德县
گوجرانواله ولسوالۍ	古杰兰瓦拉县
بهاولپور ولسوالۍ	巴哈瓦尔布尔县
لوره لايي ولسوالۍ	洛拉莱县
بولان ولسوالۍ	波伦县
ژوب ولسوالۍ	佐布县
اټک ولسوالۍ	阿特克县
بکتر شکن	红箭-8反坦克导弹
زيارت ولسوالۍ	加拉特县
نصير اباد ولسوالۍ	纳希拉巴德县
دېره غازي خان ولسوالۍ	德利加兹汗县
موسی خېل ولسوالۍ (بلوچستان)	穆萨克尔县
چکوال ولسوالۍ	恰夸尔县
بهکر ولسوالۍ	巴卡尔县
لاهور ولسوالۍ	拉合尔县
کوټه ولسوالۍ	奎达县
ډېره بگټي ولسوالۍ	德拉布提县
سيالکوټ ولسوالۍ	锡亚尔科特县
کوهلو ولسوالۍ	寇卢县
خراسان	大呼罗珊
لر دير ولسوالۍ	下第尔县
مانسهره ولسوالۍ	曼瑟拉县
مردان ولسوالۍ	马尔丹县
چارسده ولسوالۍ	恰尔萨达县
هنگو ولسوالۍ	汉古县
شنگله ولسوالۍ	香拉县
ساهيوال ولسوالۍ	萨希瓦尔县
راجنپور ولسوالۍ	拉詹普尔县
ويهاړي ولسوالۍ	维哈里县
ليه ولسوالۍ	莱亚县
نارووال ولسوالۍ	诺罗瓦尔县
منډي بهاوالدين ولسوالۍ	曼迪巴豪丁县
ميانوالي ولسوالۍ	缅瓦利县
تولید (سوداگري)	产品
پنجگور ولسوالۍ	旁吉古尔县
د عراق او شام اسلامي دولت	伊斯兰国
يونس	約拿
وټيز څېړندود	经济学方法
سبي ولسوالۍ	锡比县
د فيلسوفانو لړليک	哲学家列表
لودهران ولسوالۍ	罗德兰县
ننکانه صاحب ولسوالۍ	嫩加纳胡沙布县
چنيوټ ولسوالۍ	吉尼奥德县
شېخپوره ولسوالۍ	谢胡布尔县
قصور ولسوالۍ	卡苏尔县
ویدانتا	吠檀多
د کيميا فلسفه	化学哲学
پښتانه	普什圖人
شرن	沙兰
خوشاب ولسوالۍ	库沙布县
پانډور زره پوښ موټر	潘德2型裝甲車
جهل مگسي ولسوالۍ	贾尔马格希县
رحيميار خان ولسوالۍ	拉希姆亚尔汗县
خضدار ولسوالۍ	胡兹达尔县
مخابرات په افغانستان کې	阿富汗通讯
کندهار ولسوالۍ	坎大哈县
چامبېلي	素馨花
شهرک ولسوالۍ	沙赫拉克区
پراناف مېستري	明泊霖
رسنۍ	平均数
سمبالښت	管理学
وېشنيزه:هڅوب	Category:文化
وېشنيزه:لويې وچې	Category:大洲
وېشنيزه:ځمکپېژنده	Category:地质学
وېشنيزه:الوتکې	Category:航空器
ثريا طرزي	索拉亚·塔齐
بنو ولسوالۍ	本努县
فيض محمد کاتب هزاره	法伊茲·穆罕默德·哈提卜
ايشوبی	锅炉
بټگرام ولسوالۍ	巴塔格兰县
مالاکنډ ولسوالۍ	马拉坎县
تانبه:ځمکپوهنه	Portal:地理学
مماڼه	窄叶雀梅藤
جلغوزه	西藏白皮松
تانبه:فلسفه	Portal:哲学
د کوکا کولا شرکت	可口可乐公司
ويکيپېډيا:غونډال ته څنګه ورننوځو	Help:登录
هريړه	诃子
کيمياوي وسلې	化学武器
وېشنيزه:د پوهنغونډ روباټان	Category:維基百科機器人
وېشنيزه:د افغانستان توکمونه	Category:阿富汗民族
بخت خان	巴克德·汗
څلوريځ	对句
تانبه:هنرونه	Portal:艺术
شاه حسين هوتک	侯賽因·漢達基
کينډۍ:دوراشې کامه	Template:Quote
د وينې رېفرانسي حدود	血液检验项目正常参考值范围
ويکيپېډيا:د نن ورځې انځور	Wikipedia:特色圖片評選
وېشنيزه:هېوادونه	Category:国家
وېشنيزه:وټپوهنه	Category:经济学
ويکيپېډيا:پازوالان	Wikipedia:管理员
ويکيپېډيا:روباټان	Wikipedia:机器人
وېشنيزه:وخت	Category:时间
وېشنيزه:انټرنټ	Category:互联网
وېشنيزه:پیسې	Category:货币
وېشنيزه:بوټپوهنه	Category:植物學
وېشنيزه:اناتومي	Category:解剖学
وېشنيزه:طب	Category:医学
وېشنيزه:سياست	Category:政治
گڼنه	会计学
مصر	埃及
اسلامي نظام	伊斯兰国 (政权形式)
وېشنيزه:فيلسوفان	Category:哲学家
کينډۍ:Bot	Template:Bot
خپگان	情绪抑郁
کاناډا	加拿大
وېشنيزه:هنګري	Category:匈牙利
وېشنيزه:د اروپایي اتحادیې غړي هیوادونه	Category:欧盟成员国
وېشنيزه:چېک جمهوريت	Category:捷克
وېشنيزه:سلواکيا	Category:斯洛伐克
ويکيپېډيا:نيوليک	Wikipedia:分類索引
اکدي واکمنۍ	阿卡德帝国
وېشنيزه:مايکروسافټ	Category:微軟
تانبه:پوهنه	Portal:科學
کينډۍ:Flagicon	Template:Flagicon
وېشنيزه:د اروپا هېوادونه	Category:欧洲国家
وېشنيزه:اروپا	Category:欧洲
تانبه:تازه پېښې	Portal:新聞動態
کينډۍ:لاسوند	Template:Documentation
ويکيپېډيا:د ټولنې تانبه	Wikipedia:社群首页
وېشنيزه:User languages	Category:用户语言
ويکيپېډيا:کارن-نوم	Wikipedia:用户名
عايشه بنت ابي بکر	阿伊莎
سوداگري	企业
تانبه:ټکنالوجي	Portal:技術
کينډۍ:Softredirect	Template:軟重定向
کينډۍ:ړنگول	Template:Delete
ليکبڼه	字型
وېشنيزه:ژبې	Category:语言
ويکيپېډيا:General disclaimer	Wikipedia:免责声明
وېشنيزه:د چېک جمهوريت ښارونه	Category:捷克城市
ماشیندار اېوو - ۳	CZ蠍式EVO 3 A1衝鋒槍
کينډۍ:Navbox	Template:Navbox
ويکيپېډيا:Shortcut	Template:Shortcut
وېشنيزه:د ایران ښارونه	Category:伊朗城市
خيميران	银鲛目
کينډۍ:Citation needed	Template:Fact
تانبه:ژوندليکونه	Portal:人物
کينډۍ:Tnavbar	Template:Navbar
ايمان	信仰
کينډۍ:Clear	Template:Clear
کينډۍ:Col-begin	Template:Col-begin
کينډۍ:Col-end	Template:Col-end
کينډۍ:Anchor	Template:Anchor
کينډۍ:Babel	Template:Babel
کينډۍ:Commons	Template:Commons
کينډۍ:لړسرچينې	Template:Reflist
کينډۍ:AFG	Template:AFG
کينډۍ:نابشپړ	Template:Stub
کينډۍ:User de	Template:User de
کينډۍ:User en-3	Template:User en-3
کينډۍ:User en-1	Template:User en-1
کينډۍ:User en-2	Template:User en-2
کينډۍ:User en	Template:User en
کينډۍ:User fa	Template:User fa
وېشنيزه:افغاني هڅوب	Category:阿富汗文化
کينډۍ:User ja	Template:User ja
کينډۍ:User ja-1	Template:User ja-1
وېشنيزه:امريکايي لرغونپوهان	Category:美国考古学家
کينډۍ:د هېواد مالومات تاجکستان	Template:Country data Tajikistan
وېشنيزه:آسيا	Category:亚洲
کينډۍ:Esoteric	Template:Esoteric
کينډۍ:د هېواد مالومات کویټ	Template:Country data Kuwait
کينډۍ:Mod	Template:Mod
کينډۍ:ISO639-3Documentation	Template:SIL
کينډۍ:د هېواد مالومات بلجيم	Template:Country data Belgium
کينډۍ:د هېواد مالومات سلواکيا	Template:Country data Slovakia
کينډۍ:د هېواد مالومات اېل سلوادور	Template:Country data El Salvador
کينډۍ:د هېواد مالومات پاناما	Template:Country data Panama
کينډۍ:د هېواد مالومات اېکوادور	Template:Country data Ecuador
کينډۍ:د هېواد مالومات اېتوپيا	Template:Country data Ethiopia
کينډۍ:د هېواد مالومات تونېسيا	Template:Country data Tunisia
کينډۍ:د هېواد مالومات د چېک جمهوريت	Template:Country data Czech Republic
کينډۍ:د هېواد مالومات تايلنډ	Template:Country data Thailand
کينډۍ:د هېواد مالومات کيوبا	Template:Country data Cuba
کينډۍ:د هېواد مالومات اندونېزيا	Template:Country data Indonesia
کينډۍ:د هېواد مالومات کمبوډيا	Template:Country data Cambodia
کينډۍ:د هېواد مالومات سېنېگال	Template:Country data Senegal
کينډۍ:د هېواد مالومات ماداګاسکر	Template:Country data Madagascar
کينډۍ:د هېواد مالومات البانيا	Template:Country data Albania
وېشنيزه:درملپوهنه	Category:藥理學
کينډۍ:د هېواد مالومات پېرو	Template:Country data Peru
کينډۍ:د هېواد مالومات پاراګوای	Template:Country data Paraguay
کينډۍ:د هېواد مالومات کېنيا	Template:Country data Kenya
کينډۍ:د هېواد مالومات نيکاراګوا	Template:Country data Nicaragua
کينډۍ:د هېواد مالومات هندوراس	Template:Country data Honduras
کينډۍ:د هېواد مالومات ازبکستان	Template:Country data Uzbekistan
کينډۍ:د هېواد مالومات بولېويا	Template:Country data Bolivia
کينډۍ:د هېواد مالومات د ډومينيکان جمهوريت	Template:Country data Dominican Republic
کينډۍ:د هېواد مالومات توگو	Template:Country data Togo
کينډۍ:د هېواد مالومات ګواتمالا	Template:Country data Guatemala
وېشنيزه:ژبپوهنه	Category:语言学
کينډۍ:د هېواد مالومات هايېتي	Template:Country data Haiti
کينډۍ:د هېواد مالومات مالي	Template:Country data Mali
کينډۍ:د هېواد مالومات مولدووا	Template:Country data Moldova
کينډۍ:د هېواد مالومات لاتويا	Template:Country data Latvia
کينډۍ:د هېواد مالومات مالټا	Template:Country data Malta
کينډۍ:د هېواد مالومات ډېنمارک	Template:Country data Denmark
کينډۍ:د هېواد مالومات آيسلېنډ	Template:Country data Iceland
کينډۍ:د هېواد مالومات پولنډ	Template:Country data Poland
کينډۍ:د هېواد مالومات کېپ وردا	Template:Country data Cape Verde
کينډۍ:Click	Template:Click
کينډۍ:د هېواد مالومات بلغاريه	Template:Country data Bulgaria
کينډۍ:د هېواد مالومات بوسنيا او هېرزگوينا	Template:Country data Bosnia and Herzegovina
کينډۍ:د هېواد مالومات ګايانا	Template:Country data Guyana
کينډۍ:Wikivar	Template:Wikivar
کينډۍ:د هېواد مالومات ناروې	Template:Country data Norway
کينډۍ:د هېواد مالومات سوېلي افريقا	Template:Country data South Africa
کينډۍ:د هېواد مالومات جمايکا	Template:Country data Jamaica
کينډۍ:د هېواد مالومات ګورجستان	Template:Country data Georgia
کينډۍ:د هېواد مالومات ارجنټاين	Template:Country data Argentina
کينډۍ:د هېواد مالومات يوروګوای	Template:Country data Uruguay
کينډۍ:Country showdata	Template:Country showdata
کينډۍ:د هېواد مالومات ټرېنېډاډ او توباګو	Template:Country data Trinidad and Tobago
کينډۍ:د انځور نښه	Template:Image label
کينډۍ:د هېواد مالومات برونای	Template:Country data Brunei
کينډۍ:د هېواد مالومات سريلانکا	Template:Country data Sri Lanka
کينډۍ:د هېواد مالومات مکسيکو	Template:Country data Mexico
کينډۍ:د هېواد مالومات یونان	Template:Country data Greece
کينډۍ:د هېواد مالومات لوکسېمبورگ	Template:Country data Luxembourg
کينډۍ:د هېواد مالومات سعودي عربستان	Template:Country data Saudi Arabia
کينډۍ:د هېواد مالومات بهاماس	Template:Country data Bahamas
کينډۍ:د هېواد مالومات کرواتيا	Template:Country data Croatia
کينډۍ:د هېواد مالومات عراق	Template:Country data Iraq
کينډۍ:ليکوال-مالوماتبکس/لاسوند	Template:Infobox Writer
کينډۍ:د هېواد مالومات متحده عرب امارات	Template:Country data United Arab Emirates
کينډۍ:د هېواد مالومات ماروکو	Template:Country data Morocco
کينډۍ:د هېواد مالومات سربيا	Template:Country data Serbia
کينډۍ:د هېواد مالومات آسټراليا	Template:Country data Australia
کينډۍ:د هېواد مالومات فرانسه	Template:Country data France
کينډۍ:Ambox	Template:Ambox
کينډۍ:DorlandsDict	Template:DorlandsDict
کينډۍ:دکارنبکس-بېخ	Template:Userboxbottom
کينډۍ:هېواد-مالوماتبکس	Template:國家基礎資訊
کينډۍ:د هېواد مالومات لاووس	Template:Country data Laos
کينډۍ:د هېواد مالومات اتريش	Template:Country data Austria
کينډۍ:د فلسفې څنگپټه	Template:Philosophy-sidebar
کينډۍ:د هېواد مالومات نيپال	Template:Country data Nepal
کينډۍ:ترسره شو	Template:完成
کينډۍ:لاسوند/دلاسوندنوم	Template:Documentation/docname
کينډۍ:د هېواد مالومات فېنلاند	Template:Country data Finland
کينډۍ:Audio	Template:Audio
کينډۍ:د هېواد مالومات مصر	Template:Country data Egypt
کينډۍ:د هېواد مالومات لېتوانيا	Template:Country data Lithuania
ويکيپېډيا:ځان زده کړه (د ويکيپېډيا تړنې)	Wikipedia:新手入門/維基文本
کينډۍ:Used in system	Template:Used in system
کينډۍ:د هېواد مالومات جاپان	Template:Country data Japan
کينډۍ:د هېواد مالومات نېدرلنډ	Template:Country data Netherlands
کينډۍ:Start box	Template:Start
کينډۍ:ساينسپوه-مالوماتبکس	Template:Infobox Scientist
کينډۍ:پوهنتون مالوماتبکس/لاسوند	Template:Infobox university
کينډۍ:د هېواد مالومات آذربايجان	Template:Country data Azerbaijan
کينډۍ:د فايرفاکس کارن	Template:User Firefox
کينډۍ:Ar	Template:Lang-ar
کينډۍ:د هېواد مالومات وېتنام	Template:Country data Vietnam
کينډۍ:Featured article	Template:Featured article
کينډۍ:د هېواد مالومات لېبيا	Template:Country data Libya
کينډۍ:د هېواد مالومات روسیه	Template:Country data Russia
وېشنيزه:User en	Category:En 使用者
وېشنيزه:User en-2	Category:En-2 使用者
کينډۍ:مالوماتبکس	Template:Infobox
کينډۍ:Navy	Template:Navy
کينډۍ:د هېواد مالومات اېکواټوريال گوينا	Template:Country data Equatorial Guinea
کينډۍ:User zh	Template:User zh
کينډۍ:Colorbox	Template:Colorbox
وېشنيزه:دوتر توکي	Category:办公设备
کينډۍ:د هېواد مالومات اټاليا	Template:Country data Italy
کينډۍ:د المان ايالتي نقشه	Template:德國聯邦
کينډۍ:User ru-4	Template:User ru-4
کينډۍ:Pp-template	Template:Pp-template
کينډۍ:د هېواد مالومات سويډن	Template:Country data Sweden
وېشنيزه:کرهڼه	Category:农业
کينډۍ:Infobox settlement	Template:Infobox Settlement
کينډۍ:User ru	Template:User ru
کينډۍ:نغا	Template:IPA
وېشنيزه:سياستوال	Category:政治人物
وېشنيزه:لمريز نظام	Category:太阳系行星
وېشنيزه:امريکا	Category:美洲
کينډۍ:د هېواد مالومات کوسټاريکا	Template:Country data Costa Rica
کينډۍ:د هېواد مالومات هند	Template:Country data India
کينډۍ:د هېواد مالومات الجېريا	Template:Country data Algeria
کينډۍ:د هېواد مالومات وېنېزوېلا	Template:Country data Venezuela
کينډۍ:د هېواد مالومات فيجي	Template:Country data Fiji
کينډۍ:Infobox Officeholder	Template:Infobox Officeholder
کينډۍ:د هېواد مالومات انډورا	Template:Country data Andorra
کينډۍ:د هېواد مالومات آنگولا	Template:Country data Angola
کينډۍ:د هېواد مالومات بوټسوانا	Template:Country data Botswana
کينډۍ:د هېواد مالومات اروپايي اتحاديه	Template:Country data European Union
کينډۍ:Border	Template:Border
کينډۍ:د هېواد مالومات ډومنيکا	Template:Country data Dominica
کينډۍ:د هېواد مالومات پارتوګال	Template:Country data Portugal
کينډۍ:د هېواد مالومات آيرلېنډ	Template:Country data Ireland
کينډۍ:د هېواد مالومات واټيکان ښار	Template:Country data Vatican City
کينډۍ:Fmbox	Template:Fmbox
کينډۍ:د هېواد مالومات چین	Template:Country data China
کينډۍ:د هېواد مالومات بېنين	Template:Country data Benin
کينډۍ:د هېواد مالومات د کانگو جمهوريت	Template:Country data Republic of the Congo
کينډۍ:ويکيسازنه	Template:Wikify
کينډۍ:د هېواد مالومات ترکيه	Template:Country data Turkey
وېشنيزه:ليکوال	Category:作家
کينډۍ:د هېواد مالومات قبرس	Template:Country data Cyprus
کينډۍ:د هېواد مالومات سويتزرلاند	Template:Country data Switzerland
کينډۍ:د هېواد مالومات فلېپين	Template:Country data Philippines
کينډۍ:د هېواد مالومات نايجېريا	Template:Country data Nigeria
کينډۍ:د هېواد مالومات آيرلنډ	Template:Country data Belarus
کينډۍ:د هېواد مالومات مالېزيا	Template:Country data Malaysia
کينډۍ:د هېواد مالومات ارمنستان	Template:Country data Armenia
کينډۍ:د هېواد مالومات زېمبابوې	Template:Country data Zimbabwe
کينډۍ:د هېواد مالومات ختيځ تېمور	Template:Country data East Timor
وېشنيزه:تومانچې	Category:手枪
کينډۍ:د هېواد مالومات ماينامار	Template:Country data Myanmar
کينډۍ:د هېواد مالومات قزاقستان	Template:Country data Kazakhstan
کينډۍ:د هېواد مالومات چېلي	Template:Country data Chile
کينډۍ:د هېواد مالومات سلووېنيا	Template:Country data Slovenia
کينډۍ:د هېواد مالومات لبنان	Template:Country data Lebanon
کينډۍ:د کتاب مالوماتبکس-1	Template:Infobox Book
کينډۍ:د هېواد مالومات بهوټان	Template:Country data Bhutan
کينډۍ:Booland	Template:Both
وېشنيزه:څارګرې ادارې	Category:情報機構
کينډۍ:سورت	Template:Sura
کينډۍ:لطفاً په دې مخ کې بدلون مه راولۍ	Wikipedia:新手入門/介紹
کينډۍ:Tlx	Template:Tlx
کينډۍ:Lang-la	Template:Lang-la
کينډۍ:Lang-el	Template:Lang-el
وېشنيزه:اخلاق	Category:倫理學
د سره صليب نړيواله ټولنه	红十字国际委员会
وېشنيزه:چاودېدونكى مواد	Category:爆炸物
کينډۍ:Pp-meta	Template:Pp-meta
کينډۍ:IPA-en	Template:IPA-en
کينډۍ:Mergefrom	Template:Mergefrom
وېشنيزه:سولګر	Category:電腦
وېشنيزه:توکي	Category:设备
کينډۍ:مالوماتبکس لويه وچه	Template:Infobox Continent
وېشنيزه:پخوانی ژبې	Category:已灭亡语言
وېشنيزه:User ja-N	Category:Ja 母语使用者
تانبه:اسلام	Portal:伊斯兰教
کينډۍ:دشريان-مالوماتبکس	Template:Infobox artery
کينډۍ:Polytonic	Template:Script/Greek
کينډۍ:تانبې گرځښتپټه	Template:Browsebar
کينډۍ:Familytree/start	Template:Familytree/start
کينډۍ:نامبهمېدنه	Template:Disambig
وېشنيزه:اسرائیلي جوماتونه	Category:以色列清真寺
وېشنيزه:د ایران امپراتورۍ او پاچاهۍ	Category:波斯歷史
وېشنيزه:پوځي الوتکې	Category:军用飞机
کينډۍ:Lang-grc	Template:Lang-grc
کينډۍ:د هېواد مالومات کوموروس	Template:Country data Comoros
کينډۍ:د فلسفې سرليکونه	Template:哲学
کينډۍ:Lang-pt	Template:Lang-pt
کينډۍ:د هېواد مالومات قطر	Template:Country data Qatar
کينډۍ:FRA	Template:FRA
کينډۍ:د هېواد مالومات اسرایل	Template:Country data Israel
کينډۍ:د هېواد مالومات اوکراين	Template:Country data Ukraine
کينډۍ:د هېواد مالومات کولمبيا	Template:Country data Colombia
کينډۍ:د هېواد مالومات پاکستان	Template:Country data Pakistan
کينډۍ:د هېواد مالومات ګانا	Template:Country data Ghana
کينډۍ:د هېواد مالومات رومانیا	Template:Country data Romania
کينډۍ:د هېواد مالومات سوېلي کوريا	Template:Country data South Korea
کينډۍ:د لومړي مخ منځ-ويکي	Template:Mainpage-iw
کينډۍ:Npov	Template:POV
کينډۍ:Afghanistan-stub	Template:Afghanistan-stub
کينډۍ:د هېواد مالومات بحرين	Template:Country data Bahrain
کينډۍ:بوديزم	Template:佛教
وېشنيزه:User ja	Category:Ja 使用者
وېشنيزه:User ur	Category:Ur 使用者
وېشنيزه:User ko-N	Category:Ko 母語使用者
وېشنيزه:User ru-N	Category:Ru 母語使用者
وېشنيزه:وختتېری	Category:娱乐
کينډۍ:قرآن-ته-اړونده	Template:QuranRelated
وېشنيزه:افغاني ټولنه	Category:阿富汗社会
وېشنيزه:چینی الوتکې	Category:中国战斗机
وېشنيزه:تاريخپوهان	Category:历史学家
وېشنيزه:User de	Category:De 使用者
وېشنيزه:User de-N	Category:De 母語使用者
کينډۍ:د افغانستان ولايتونه	Template:阿富汗一级行政区
وېشنيزه:User en-3	Category:En-3 使用者
وېشنيزه:User en-N	Category:En 母语使用者
آلو	李亚属
وېشنيزه:User fa	Category:Fa 使用者
کينډۍ:N/A	Template:N/A
وېشنيزه:د اسلام پيغمبران	Category:伊斯蘭教先知
کينډۍ:د هېواد مالومات برونډي	Template:Country data Burundi
کينډۍ:د هېواد مالومات جرمني	Template:Country data Germany
کينډۍ:د هېواد مالومات بريتانيه	Template:Country data United Kingdom
وېشنيزه:مېچپوهنه	Category:几何学
کينډۍ:د سورة مالوماتبکس	Template:Infobox Sura
کينډۍ:د هېواد مالومات اېسټونيا	Template:Country data Estonia
کينډۍ:د هېواد مالومات مانټېنېګرو	Template:Country data Montenegro
کينډۍ:Weather box	Template:Infobox weather
وېشنيزه:هنرمندان	Category:艺术家
وېشنيزه:User ja-1	Category:Ja-1 使用者
کينډۍ:نستعليق	Template:Script/Nastaliq
وېشنيزه:ژمنۍ لوبې	Category:冰雪运动
وېشنيزه:User ko	Category:Ko 使用者
وېشنيزه:د امريکا د متحده ايالاتو ايالتونه	Category:美国州份
کينډۍ:Smallsup	Template:Smallsup
کينډۍ:وټپوهنه	Template:Economics sidebar
کينډۍ:د ژغورنې کينډۍ	Wikipedia:模板消息/保護模板
وېشنيزه:بانکوالی	Category:银行业
کينډۍ:د هېواد مالومات د عاج ساحل	Template:Country data Côte d'Ivoire
وېشنيزه:د ایران ولایتونه	Category:伊朗省份
وېشنيزه:User ru-1	Category:Ru-1 使用者
کينډۍ:د لارښود نيوليک پر شا تگ	Template:Help contents back
کينډۍ:وپ دلارښود-مخونه (سرپټه)	Template:维基百科帮助页 (页眉栏)
وېشنيزه:مخدره مواد	Category:药物文化
کينډۍ:ويکيپېډيا-ډ-ځ-پ	Template:WikipediaFAQ
وېشنيزه:اند	Category:思想
وېشنيزه:سياسي هڅوب	Category:政治文化
وېشنيزه:لمريز غونډال	Category:太阳系
کينډۍ:د هېواد مالومات برازیل	Template:Country data Brazil
وېشنيزه:مخترعين	Category:發明家
وېشنيزه:سر او غاړه	Category:頭頸
کينډۍ:د هېواد مالومات سوازيلاند	Template:Country data Swaziland
وېشنيزه:ژوپوهنه	Category:動物學
وېشنيزه:د رضوي خراسان ولايت	Category:呼羅珊省
تانبه:دين	Portal:宗教
وېشنيزه:هلیکوپترونه	Category:直升机
وېشنيزه:ټولنيزې پوهنې	Category:社会科学
کينډۍ:د هېواد مالومات هنګري	Template:Country data Hungary
وېشنيزه:د آفریقاهیوادونه	Category:非洲国家
وېشنيزه:د هخامنشیانو حکمرانان	Category:阿契美尼德王朝
کينډۍ:Template reference list	Template:Template reference list
وېشنيزه:حزب الله	Category:真主黨
کينډۍ:د هېواد مالومات نيوزيلاند	Template:Country data New Zealand
وېشنيزه:القاعده	Category:基地组织
وېشنيزه:User ro-3	Category:Ro-3 使用者
وېشنيزه:User ru	Category:Ru 使用者
وېشنيزه:User ru-2	Category:Ru-2 使用者
وېشنيزه:User ru-3	Category:Ru-3 使用者
وېشنيزه:User ru-4	Category:Ru-4 使用者
وېشنيزه:User ur-2	Category:Ur-2 使用者
کينډۍ:انبيا په قرآن كې	Template:伊斯蘭教先知
کينډۍ:د افغانستان تاريخ	Template:阿富汗历史
کينډۍ:Lang	Template:Lang
کينډۍ:د هېواد مالومات د امريکا متحده ايالات	Template:Country data United States
کينډۍ:د هېواد مالومات ترکمنستان	Template:Country data Turkmenistan
وېشنيزه:د ۱۹۵۷ کال زېږېدنې	Category:1957年出生
کينډۍ:د هېواد مالومات سهېلي کوريا	Template:Country data North Korea
کينډۍ:د هېواد مالومات افغانستان	Template:Country data Afghanistan
کينډۍ:د هېواد مالومات بنگله دېش	Template:Country data Bangladesh
لوگر ولايت	洛加尔省
کينډۍ:د پاکستان سياسي جغرافي وېش	Template:Pakistan
کينډۍ:د افغانستان سرليکونه	Template:阿富汗專題
کينډۍ:امينواسيدونه	Template:氨基酸
وېشنيزه:افغانان	Category:阿富汗人
وېشنيزه:بي بي سي	Category:英國廣播公司
کينډۍ:Biochemical families	Template:生物化学物质种类
د آلمان دپاره آلترناتیف	德國新選項黨
کينډۍ:د هېواد مالومات د کانگو ډيموکراتيک جمهوريت	Template:Country data Democratic Republic of the Congo
کينډۍ:Elementbox isotopes stable	Template:Infobox element/isotopes stable
کينډۍ:ICDO	Template:ICDO
وېشنيزه:اوبتلونه	Category:潛艇
وېشنيزه:ماشیندارونه	Category:冲锋枪
وېشنيزه:د افریقایي اتحادیه غړي هیوادونه	Category:非洲联盟成员国
کينډۍ:شريط-تصفح كتب-دين	Template:宗教浏览条
وېشنيزه:ليبيا	Category:利比亞
وېشنيزه:په وچې پورې تړلي هیوادونه	Category:內陸國家
وېشنيزه:د افغانستان وټه	Category:阿富汗经济
کينډۍ:Infobox Language/family-color	Template:Infobox Language/family-color
کينډۍ:User ru-1	Template:User ru-1
کينډۍ:د هېواد مالومات بېلاز	Template:Country data Belize
وېشنيزه:بلوچستان	Category:俾路支地區
کينډۍ:دا وخت	Template:日曆
کينډۍ:د هېواد مالومات کوسووا	Template:Country data Kosovo
کينډۍ:د هېواد مالومات ماورېتانيا	Template:Country data Mauritania
کينډۍ:د هېواد مالومات ګابون	Template:Country data Gabon
کينډۍ:د هېواد مالومات جبوتي	Template:Country data Djibouti
کينډۍ:د هېواد مالومات آروبا	Template:Country data Aruba
کينډۍ:د هېواد مالومات سوډان	Template:Country data Sudan
کينډۍ:د هېواد مالومات چاډ	Template:Country data Chad
وېشنيزه:روسي ساينسپوهان	Category:俄罗斯科学家
وېشنيزه:طالبان	Category:塔利班
وېشنيزه:بازارموندنه	Category:市场营销
وېشنيزه:د نړۍ هېوادونه	Category:國際關係
کينډۍ:د هېواد مالومات انټيگ او بربودا	Template:Country data Antigua and Barbuda
کينډۍ:د هېواد مالومات ګامبيا	Template:Country data Gambia
وېشنيزه:غږپوهنه	Category:音韻學
کينډۍ:د هېواد مالومات نامېبيا	Template:Country data Namibia
کينډۍ:Tnavbar-header	Template:Tnavbar-header
وېشنيزه:مالیه	Category:金融
وېشنيزه:د افغانستان ولايتونه	Category:阿富汗省份
وېشنيزه:د چېک خلک	Category:捷克人
وېشنيزه:آلمانی الوتکې	Category:德國軍用機
وېشنيزه:مرکزي بانکونه	Category:中央银行
وېشنيزه:کيمياوي توکي	Category:化学元素
وېشنيزه:امريکايي فيلسوفان	Category:美国哲学家
وېشنيزه:ساينسپوهان	Category:科学家
وېشنيزه:سولګر ملتونونه	Category:電腦公司
وېشنيزه:د افغانستان پوځ	Category:阿富汗軍事
وېشنيزه:سهېلي کوريا	Category:朝鮮民主主義人民共和國
وېشنيزه:د ليبيا خلک	Category:利比亞人
وېشنيزه:د آسيا ارزونه	Category:亚洲货币
وېشنيزه:ايراني سیاستوال	Category:伊朗政治人物
وېشنيزه:د پاکستان سياستوال	Category:巴基斯坦政治人物
کينډۍ:د هېواد مالومات بورکينا فاسو	Template:Country data Burkina Faso
کينډۍ:د هېواد مالومات د منځنۍ افريقا جمهوريت	Template:Country data Central African Republic
وېشنيزه:خبريالي	Category:新闻学
وېشنيزه:اوزبکستان	Category:烏茲別克
وېشنيزه:مغولو پاچايي	Category:莫卧儿帝国
وېشنيزه:عثماني پېر	Category:奥斯曼帝国
وېشنيزه:افغاني ليکوال	Category:阿富汗作家
کينډۍ:د هېواد مالومات سېچېلېس	Template:Country data Seychelles
کينډۍ:د هېواد مالومات پاپوا نيوګوينا	Template:Country data Papua New Guinea
وېشنيزه:پاکستاني هېوادمشران	Category:巴基斯坦总统
وېشنيزه:مېوې	Category:水果
وېشنيزه:زهرلرونکي نباتونه	Category:有毒植物
وېشنيزه:د اروپا سيمې	Category:歐洲地區
وېشنيزه:د آسیا جغرافیا	Category:亚洲地理
وېشنيزه:جوماتونه	Category:清真寺
وېشنيزه:د ترکیې جوماتونه	Category:土耳其清真寺
وېشنيزه:دانټي رېټرووايرل درملونه	Category:抗逆转录病毒药物
وېشنيزه:انتي بيوتيکونه	Category:抗生素
وېشنيزه:مسکنونه	Category:止痛药
وېشنيزه:ميترو	Category:城市轨道交通
وېشنيزه:ددرمل شکل	Category:剂型
وېشنيزه:خبري اژانس	Category:通訊社
وېشنيزه:بشرِی حقوق	Category:人權
تورن	Captain
وېشنيزه:ناټو	Category:北大西洋公约组织
وېشنيزه:پوځي وييونه	Category:军事术语
وېشنيزه:غړي	Category:器官
وېشنيزه:وسلې	Category:武器
وېشنيزه:امريکايي سندرغاړي	Category:美国男歌手
وېشنيزه:بم غورځونکي الوتکې	Category:轰炸机
وېشنيزه:د بېټا-لاکټاماز انتي بيوتيکونه	Category:Β-内酰胺类抗生素
وېشنيزه:پاړسي ژبه	Category:波斯語
وېشنيزه:اېډز	Category:HIV/AIDS
وېشنيزه:قران	Category:古蘭經
وېشنيزه:ناروغۍ	Category:疾病
وېشنيزه:ترافيک ترانسپورت	Category:交通
وېشنيزه:لوبې	Category:各类体育运动
وېشنيزه:کورنۍ	Category:家庭
وېشنيزه:قضاء	Category:公平正義
وېشنيزه:سندرغاړي	Category:歌手
وېشنيزه:وټپوهان	Category:经济学家
کينډۍ:Flagcountry	Template:Flagcountry
کينډۍ:د ژبې مالوماتبکس	Template:Infobox Language
وېشنيزه:ځمکپوهان	Category:地理学家
وېشنيزه:ولسواکي	Category:民主
وېشنيزه:درمل	Category:药物
وېشنيزه:ټانکونه	Category:坦克
وېشنيزه:د آفریقا د هېوادونو پلازمېنې	Category:非洲首都
وېشنيزه:ايراني هڅوب	Category:伊朗文化
وېشنيزه:د رومانیا ښارونه	Category:罗马尼亚城市
وېشنيزه:کابل	Category:喀布爾
وېشنيزه:د آسیا د هېوادونو پلازمېنې	Category:亞洲首都
وېشنيزه:پښتانه	Category:普什圖人
وېشنيزه:چېکي واکمنان	Category:捷克君主
وېشنيزه:نړۍ	Category:世界
وېشنيزه:د مسراشمیت الوتکې	Category:梅塞施密特
وېشنيزه:د افغانستان ژبې	Category:阿富汗语言
وېشنيزه:هندوکش	Category:兴都库什山脉
وېشنيزه:هزاره ګان	Category:哈扎拉族
سيد انور رحمتي	薩伊迪·安瓦爾·拉赫馬蒂
وېشنيزه:د بانکوالی وییونه او اوزار	Category:銀行術語
وېشنيزه:شوبلې ضد وسلې	Category:反坦克导弹
کينډۍ:Dmbox	Template:Dmbox
وېشنيزه:مرکزي قبایلي سیمې	Category:聯邦直轄部落地區
وېشنيزه:معمر القذافي	Category:穆阿邁爾·格達費
کينډۍ:WPFCevent	Template:WPFCevent
وېشنيزه:کندهار	Category:坎大哈
وېشنيزه:د قاجاريانو حکمرانان	Category:卡扎爾王朝
وېشنيزه:افغاني ګوندونه	Category:阿富汗政党
کينډۍ:د هېواد مالومات اسپانيا	Template:Country data Spain
کينډۍ:د هېواد مالومات کاناډا	Template:Country data Canada
کينډۍ:د درملو لويې ډلې	Template:解剖学治疗学及化学分类系统
کينډۍ:د هېواد مالومات بربادوس	Template:Country data Barbados
کينډۍ:د هېواد مالومات ګرېنادا	Template:Country data Grenada
کينډۍ:د هېواد مالومات اردن	Template:Country data Jordan
کينډۍ:د هېواد مالومات قرغزستان	Template:Country data Kyrgyzstan
کينډۍ:د هېواد مالومات لېسوتو	Template:Country data Lesotho
کينډۍ:د هېواد مالومات لايبېريا	Template:Country data Liberia
کينډۍ:د هېواد مالومات ملاوي	Template:Country data Malawi
کينډۍ:د هېواد مالومات مالديپ	Template:Country data Maldives
کينډۍ:د هېواد مالومات ماورېشوس	Template:Country data Mauritius
کينډۍ:د هېواد مالومات مغولستان	Template:Country data Mongolia
کينډۍ:د هېواد مالومات نايجېر	Template:Country data Niger
کينډۍ:د هېواد مالومات فلسطين	Template:Country data Palestine
کينډۍ:د هېواد مالومات پورټو ريکو	Template:Country data Puerto Rico
کينډۍ:د هېواد مالومات راوانډا	Template:Country data Rwanda
کينډۍ:د هېواد مالومات سېراليون	Template:Country data Sierra Leone
کينډۍ:د هېواد مالومات سورينام	Template:Country data Suriname
کينډۍ:د هېواد مالومات سوريه	Template:Country data Syria
کينډۍ:د هېواد مالومات سېنگاپور	Template:Country data Singapore
کينډۍ:د هېواد مالومات يوگانډا	Template:Country data Uganda
کينډۍ:د هېواد مالومات ونواتو	Template:Country data Vanuatu
کينډۍ:د هېواد مالومات يمن	Template:Country data Yemen
کينډۍ:د هېواد مالومات زېمبيا	Template:Country data Zambia
کينډۍ:د هېواد مالومات اېرېتېريا	Template:Country data Eritrea
کينډۍ:Free media	Template:Free media
کينډۍ:رنگ مالوماتبکس	Template:Infobox color
وېشنيزه:د آسیا هېوادونه	Category:亚洲国家
کينډۍ:اسلامي ولسمشریزې	Template:伊斯兰共和国
کينډۍ:آډولف هېټلر	Template:希特勒
کينډۍ:پښتانه	Template:普什圖人
کينډۍ:پوځي رتبې	Template:MilitaryRank
کينډۍ:سياسي اندونه	Template:Ideologies
کينډۍ:Sw icon	Template:Sw icon
کينډۍ:د هېواد مالومات عربي ټولنه	Template:Country data Arab League
وېشنيزه:د القلوید مواد	Category:生物碱
وېشنيزه:خيبر پښتونخوا	Category:開伯爾普赫圖赫瓦省
وېشنيزه:باليووډ	Category:宝莱坞
کينډۍ:د هېواد مالومات لوېديځه سحارا	Template:Country data Western Sahara
کينډۍ:د هېواد مالومات د فالکلاند ټاپوان	Template:Country data Falkland Islands
نومونپوهنه	术语学
کينډۍ:د هېواد مالومات ګونې	Template:Country data Guinea
کينډۍ:د هېواد مالومات ګوينې بېساو	Template:Country data Guinea-Bissau
کينډۍ:وسله مالوماتبکس	Template:Infobox Weapon
کينډۍ:د هېواد مالومات آذربايجان-SSR	Template:Country data Azerbaijan SSR
کينډۍ:غوږ شه	Template:聽
کينډۍ:Duck	Template:Duck
وېشنيزه:سنډ	Category:信德省
وېشنيزه:د افغانستان لومړي وزيران	Category:阿富汗总理
وېشنيزه:امريکايي بم غورځونکي الوتکې	Category:美国轰炸机
کينډۍ:د هېواد مالومات مقدونيه	Template:Country data Republic of Macedonia
وېشنيزه:ليکتوکي	Category:文具
وېشنيزه:بسونه	Category:巴士型號
وېشنيزه:تصوف	Category:蘇非主義
وېشنيزه:ورکړېنې	Category:財稅
روژه (مياشت)	賴買丹月
وېشنيزه:امریکایی الوتکې	Category:美国军用飞机
وېشنيزه:امريکايي سندرغاړې	Category:美国女歌手
کينډۍ:د هېواد مالومات تانزانيا	Template:Country data Tanzania
وېشنيزه:ټراکټورونه	Category:拖拉機
کينډۍ:د هېواد مالومات سوماليا	Template:Country data Somalia
وېشنيزه:پاکستاني جوماتونه	Category:巴基斯坦清真寺
کينډۍ:Pp-dispute	Template:Pp-dispute
وېشنيزه:د چیک ولسمشران	Category:捷克总统
وېشنيزه:قراني سورتونه	Category:蘇拉
وېشنيزه:د لويديځ سلاوي ژبې	Category:西斯拉夫语支
کينډۍ:Infobox Language/IPA notice	Template:Infobox Language/IPA notice
وېشنيزه:User en-1	Category:En-1 使用者
وېشنيزه:د پاکستان ښارونه	Category:巴基斯坦省會
وېشنيزه:اسلامپوهان	Category:伊斯蘭研究學者
کينډۍ:نيمگړي کينډۍ	Template:Asbox
کينډۍ:Hlist	Template:Hlist
کينډۍ:Half done	Template:Half done
ويکيپېډيا:ځان زده کړه (د بحث مخونه)	Wikipedia:新手入門/討論
ويکيپېډيا:ځان زده کړه (په ياد ولره)	Wikipedia:新手入門/方針指引
کينډۍ:Userbox-level	Template:Userbox-level
دويم بريدمن	少尉
کينډۍ:User zh-min-nan-3	Template:User nan-3
ټنک ولسوالۍ	坦克县
کينډۍ:Tim	Template:Tim
کينډۍ:Supranational European Bodies	Template:Supranational European Bodies
ويکيپېډيا:ځان زده کړه (تړل او نور مالومات)	Wikipedia:新手入門/總結
ويکيپېډيا:ځان زده کړه (ثبتونه)	Wikipedia:新手入門/權限
ويکيپېډيا:ډ-ځ-پ/مخليدنه	Wikipedia:基本常见问题解答
د افغانستان پوځ	阿富汗军事
ويکيپېډيا:Infobox templates	Wikipedia:格式手册/信息框
کينډۍ:PoliticsAF	Template:阿富汗政治
کوکۍ	蝴蝶
کينډۍ:Native name	Template:Native name
مولۍ	萝卜
درملتون	藥房
هريپور ولسوالۍ	哈利普尔县
کينډۍ:Style/ril	Template:Style/ril
ويکيپېډيا:ډ-ځ-پ/لوستونکي	Wikipedia:读者常见问题解答
کينډۍ:Infobox Language/genetic2	Template:Infobox language/genetic
ويکيپېډيا:ډ-ځ-پ/بېلابېل	Wikipedia:综合常见问题解答
وېشنيزه:ويکيپيډيا وړې کينډۍ	Template:Done/See also
کينډۍ:Style/IPA	Template:Style/IPA
کينډۍ:Style/yid	Template:Style/yid
Module:Convert	模块:Convert
کينډۍ:د-ن-و-ا	Template:POTD
کينډۍ:وړکې ردېدنه	Template:Smallrejected
افغانستان او پاکستان کې د 2013 کال سېلابونه	2013年阿富汗和巴基斯坦洪灾
کينډۍ:د هېواد مالومات عمان	Template:Country data Oman
کينډۍ:د هېواد مالومات موزمبيق	Template:Country data Mozambique
کينډۍ:د هېواد مالومات کېمرون	Template:Country data Cameroon
Module:ConvertNumeric	模块:ConvertNumeric
کينډۍ:Infobox event	Template:Infobox event
ځانګړی:اوسني بدلونونه	Special:最近更改
Module:Coordinates	模块:Coordinates
د پېښور پر پوځي ښوونځي بريد	2014年白沙瓦學校襲擊事件
