Affrica	非洲
Iapan	日本
Sūðamerica	南美洲
Norþweg	挪威
Englaland	英格兰
Scotland	蘇格蘭
Wēalas	威爾士
Norðerne Īrland	北爱尔兰
Īrland Cynewīse	爱尔兰共和国
Ungerland	匈牙利
Spēonland	西班牙
Geānedu Rīcu American	美国
Belgice	比利时
Letseburg	卢森堡
Eorðe	地球
Līf	生命
George Washington	乔治·华盛顿
Finnland	芬兰
Swēoland	瑞典
Denemearc	丹麦
Polaland	波兰
Liþþuania	立陶宛
Italia	意大利
Swissland	瑞士
Ēastrīce	奥地利
Grēcland	希腊
Turcland	土耳其
Bēor	啤酒
Portugal	葡萄牙
Europe	欧洲
Asia	亚洲
Norðamerica	北美洲
Antarctica	南极洲
Wikipǣdia	维基百科
Niðerland	荷兰
Nīweoforwīcburg	纽约
Hwæsingatūn, D.C.	华盛顿哥伦比亚特区
Berlin	柏林
Los Angeles	洛杉矶
Spearctelle	電子計算機
Genf	日内瓦
Betweoxnett	互联网
Barack Obama	贝拉克·奥巴马
Uruguay	乌拉圭
Lunden	伦敦
Æppel	苹果
Paris	巴黎
Abraham Lincoln	亚伯拉罕·林肯
Android	Android
Google	Google
Mexico	墨西哥
Atlantisc Gārsecg	大西洋
Sericus Gārsecg	太平洋
California	加利福尼亚州
Mōnandæg	星期一
Æfterra Gēola	1月
Solmōnaþ	2月
Hrēþmōnaþ	3月
Tīw (tungol)	火星
Cenia	肯尼亚
Sigelhearwenaland	埃塞俄比亚
Ēastermōnaþ	4月
Þrimilcemōnaþ	5月
Sēremōnaþ	6月
Mǣdmōnaþ	7月
Wēodmōnaþ	8月
Hāligmōnaþ	9月
Winterfylleþ	10月
Blōtmōnaþ	11月
Gēolmōnaþ	12月
Tīwesdæg	星期二
Wēdnesdæg	星期三
Þunresdæg	星期四
Frīgedæg	星期五
Sæternesdæg	星期六
Sunnandæg	星期日
Lēo	狮
Francland	法国
Esperanto	世界语
Geāned Cynerīce	英国
Catte	猫
Cīnan Folclicu Cynewīse	中华人民共和国
Frencisc sprǣc	法语
Fisc	鱼
Brasil	巴西
Russland	俄罗斯
Eoferwicscīr	約克郡
Sǣ	海
Euxinus	黑海
Toronto	多伦多
Alabama	亚拉巴马州
São Paulo	聖保羅 (巴西)
São Paulo (rīce)	圣保罗州
Quebec	魁北克
Piza	比萨饼
Þēodscland	德国
Hwītrussland	白俄罗斯
Þēodsc sprǣc	德语
Īsland	冰岛
God	神 (一神教)
Estland	爱沙尼亚
Sætern (tungol)	土星
Ceocōlāte	巧克力
2 (getæl)	2
Þrīe	3
Fēower	4
Fīf	5
George W. Bush	乔治·沃克·布什
Lettland	拉脫維亞
Ucrægna	乌克兰
Cecland	捷克
Slofacia	斯洛伐克
Slofenia	斯洛文尼亚
Vilnius	维尔纽斯
Moldofa	摩尔多瓦
Rumǣnia	羅馬尼亞
Pulgaraland	保加利亚
Rōm	罗马
Macedonia Cynewīse	馬其頓共和國
Albania	阿尔巴尼亚
Grēneland	格陵兰
Croatia	克罗地亚
Bosnia and Herzegofina	波斯尼亚和黑塞哥维那
Godhopa	努克
Azerbaijan	阿塞拜疆
Andorra	安道尔
Cipros	賽普勒斯
Georgia (land)	格鲁吉亚
Casahstan	哈萨克斯坦
Melita	马耳他
Flandras	法兰德斯
Monaco	摩纳哥
Sweartbeorg	蒙特內哥羅
Faticanburg	梵蒂冈
San Marino	圣马力诺
Brysel	布鲁塞尔
Cūba	古巴
Barbados	巴巴多斯
Cǣgbord (spearctellend)	电脑键盘
Indonesia	印度尼西亚
Wolfgang Amadeus Mozart	沃尔夫冈·阿马德乌斯·莫扎特
Ludwig van Beethoven	路德维希·范·贝多芬
Sūðaffrica	南非
Algeria	阿尔及利亚
Usbecastan	乌兹别克斯坦
Warsaw	华沙
Wīn (drinc)	葡萄酒
Wæter	水
Holt	木材
Feorrsīen	电视
Īslendisc sprǣc	冰岛语
Cile	智利
Iesus	耶稣
Elvis Presley	埃爾維斯·皮禮士利
Wōden (tungol)	水星
Stǣr	历史
Apple Inc.	蘋果公司
Frig (tungol)	金星
Sprǣc	語言
Lufu	愛
Þunor (tungol)	木星
Uranus	天王星
Neptune (planēta)	海王星
Tungolcræft	天文學
Witancræft	科学
Pluto	冥王星
Montreal	蒙特利尔
Lēohtenstān	列支敦斯登
Plega	体育运动
Grantanbrycg	劍橋
Adolf Hitler	阿道夫·希特勒
Fyrst Woruldgūþ	第一次世界大战
Ōðru Woruldgūþ	第二次世界大战
Wikibēc	維基教科書
Augusto Pinochet	奥古斯托·皮诺切特
Geanca Cupala	杨卡·库巴拉
Ubuntu	Ubuntu
Stettin	什切青
Rīmcræft	数学
U2	U2樂團
Lǣden	拉丁语
Bahrain	巴林
Armenia	亞美尼亞
Serbia	塞尔维亚
Mōna	月球
Constantinopolis	伊斯坦堡
Australia	澳大利亚
Bob Marley	巴布·馬利
Argentina	阿根廷
Peru	秘鲁
Norþcorēa	朝鲜民主主义人民共和国
Cambodia	柬埔寨
Kuiperes gyrtel	柯伊伯带
Curān	古兰经
Alladōm	伊斯兰教
Lech Wałęsa	莱赫·瓦文萨
Europisce Gesamnung	欧洲联盟
Woruldwīd Webb	万维网
Wīf	女性
Wætertyge	高架渠
Don Quijote	堂吉诃德
Megelan	米蘭
Burg	城市
Napoleon I Francena Cāsere	拿破仑一世
Uesuuius	維蘇威火山
Sunne	太阳
Lēohtgēar	光年
Sunnlicu Endebyrdnes	太阳系
Ostsǣ	波罗的海
Wisle	维斯瓦河
Tōþ	牙齒
Wætertimber	氢
Wikimedia Commons	维基共享资源
Dæg	日
Ēasttimor	东帝汶
Niht	晚上
Gēar	年
Hundgēar	世纪
Rīn	莱茵河
Oslo	奥斯陆
Katowice	卡托维兹
1 Ceres	穀神星
Ii	愛奧那島
Dubai	杜拜
Folga	伏尔加河
Æðmlyft	氧
Dweligende tungol	行星
Venetia	威尼斯
Naruto	火影忍者
Moscow	莫斯科
Italisc sprǣc	意大利语
Cead	乍得
Nīwe Sǣland	新西兰
Indea	印度
Īsen	铁
Willelm Scacaspere	威廉·莎士比亚
Lēad	铅
Mongolland	蒙古国
Ficgīege	斐濟
Feneswela	委內瑞拉
Blēobord	國際象棋
Maine	缅因州
Hors	马
Amsterdam	阿姆斯特丹
Wǣpen	武器
Dēor	动物
Paraguay	巴拉圭
Ecuador	厄瓜多尔
Colombia	哥伦比亚
Strēawberge	草莓属
Buddendōm	佛教
Bolifia	玻利維亞
Coper	铜
Plante	植物
Nīwu Hāmtūnscīr	新罕布什尔州
Iamaica	牙买加
Massachusetts	麻薩諸塞州
Connecticut	康乃狄克州
Henn	鸡
Hawaii	夏威夷州
Cēsarēa	澤西
Swīn	家豬
Īshæf	北冰洋
Persealand	伊朗
Irac	伊拉克
Alaska	阿拉斯加州
Israhēl	以色列
Utrecht	乌得勒支
Gemen	也门
Clēofanwyrm	病毒
Polisc sprǣc	波兰语
Hascemisc Cynerīce þæs Iordanes	约旦
Florida	佛罗里达州
Arizona	亞利桑那州
Cuwait	科威特
Libanus	黎巴嫩
Oregon	俄勒冈州
Utah	犹他州
Hriðer	家牛
Malægsia	马来西亚
Burma	缅甸
Oman	阿曼
Pacistan	巴基斯坦
Qatar	卡塔尔
Tennis	网球
Saudisc Arabea	沙特阿拉伯
Tāprabane	斯里蘭卡
Iosep Stalin	斯大林
Syria	叙利亚
Plato	柏拉图
Tacgicastan	塔吉克斯坦
Aristoteles	亚里士多德
Thailand	泰国
Ūtƿeorp	无线电
Turcmenistan	土库曼斯坦
Geānedu Arabisc Bregorīcu	阿拉伯联合酋长国
Fietnam	越南
Sūþcorēa	大韩民国
Afghanistan	阿富汗
J. R. R. Tolkien	J·R·R·托尔金
Gold	金
Bængladesc	孟加拉国
Bleach (manga)	BLEACH
Socrates	苏格拉底
Angola	安哥拉
Tansania	坦桑尼亚
Philippines	菲律宾
Middel Affricanisc Cynewīse	中非共和國
Sūþende þǣre eaxe	南极
Norþende þære eaxe	北极点
Isaac Newton	艾萨克·牛顿
Albert Einstein	阿尔伯特·爱因斯坦
Geolu	黄色
Tunisia	突尼西亞
Simbabwe	辛巴威
Beicing	北京市
Sūþsudan	南蘇丹
Botswana	波札那
Burkina Faso	布吉納法索
Folcrīcelicu Cynewīse þæs Congwes	刚果民主共和国
Bægwaraland	巴伐利亚
Baden-Wyrttemberg	巴登-符腾堡
Æriþrea	厄立特里亚
Nīwe Delhi	新德里
Iohannes Paulus II Pāpa	若望·保祿二世
Gabon	加蓬
Mohandas Karamchand Gandhi	圣雄甘地
Gambia	冈比亚
Guinea	几内亚
Elpendbānrima	科特迪瓦
Camerun	喀麦隆
Grēnenæs Īega	佛得角
Lesotho	莱索托
Liberia	利比里亚
Libia	利比亚
Madagascar	马达加斯加
Mauritania	毛里塔尼亚
Morocco	摩洛哥
Mosambice	莫桑比克
Namibia	纳米比亚
Nigeria	奈及利亞
Charles Darwin	查尔斯·达尔文
Uganda	乌干达
Rwanda	卢旺达
Sōmalia	索马里
Gaius Iulius Caesar	尤利烏斯·凱撒
Sudan	苏丹共和国
Swasiland	斯威士兰
Hamburg	汉堡
Heorte	心臟
Brægen	脑
Prag	布拉格
Bleoh	藍色
Seolfor	銀
Tin	锡
Reddit	Reddit
Elsass	阿尔萨斯
Bihar	比哈尔邦
Michigan	密歇根州
Puerto Rico	波多黎各
Niðerseaxland	下萨克森
Hetwaraland	黑森
Illinois	伊利诺伊州
Norþdakota	北达科他州
Brandenburg	勃兰登堡
Langbeardnaland	伦巴第
Sūþdakota	南达科他州
Montǣna	蒙大拿州
Wyoming	怀俄明州
Ierusalem	耶路撒冷
Idaho	爱达荷州
Hwæsingatūn	华盛顿州
Nevada	内华达州
Danais	頓河 (俄羅斯)
Kosovo	科索沃地区
Indisc Gārsecg	印度洋
Caribisc Sǣ	加勒比海
Colorado	科羅拉多州
Tuscania	托斯卡纳
Alpis	阿尔卑斯山
Gænt	根特
Chicago	芝加哥
The Beatles	披頭四樂隊
Winter	冬季
Ēawielm	春季
Efenniht	晝夜平分點
Spēonisc sprǣc	西班牙语
Caligardamana	加尔各答
West Bengal	西孟加拉邦
Ātorcoppe	蜘蛛
Virginia	弗吉尼亚州
Westvirginia	西維吉尼亞州
Nīwe Eoforwīc	纽约州
Rhode Īeg	羅德島州
Ceorfdēor	昆虫
Marianland	马里兰州
Delaware	特拉华州
Fladimir Lenin	列宁
Ohio	俄亥俄州
Pennsylvānia	宾夕法尼亚州
Uetersen	于特森
Augustus	奥古斯都
Microsoft Windows	Microsoft Windows
Nīwe Cēsarēa	新泽西州
Calpis	直布罗陀
Finnisc sprǣc	芬兰语
Indiǣna	印第安纳州
Selffērende wægn	汽车
Roger Federer	罗杰·费德勒
Georgia (America)	喬治亞州
Marcus Aurelius	馬爾庫斯·奧列里烏斯
Texas	德克萨斯州
Puilla	普利亚
Norþcarolīna	北卡罗来纳州
Sūþcarolīna	南卡罗来纳州
Sicilia	西西里岛
Sardinia	撒丁岛
Ligore	卢瓦尔河
Sigen	塞纳河
Buenos Aires	布宜諾斯艾利斯
Mexicoburg	墨西哥城
Pīnæppel	菠蘿
Mississippi	密西西比州
Mississippi ēa	密西西比河
Mizoram	米佐拉姆邦
Tennessee	田纳西州
Abu Dhabi	阿布扎比
Nīwe Mexico	新墨西哥州
Athēnas	雅典
Minnesota	明尼蘇達州
Wisconsin	威斯康辛州
Iowa	艾奥瓦州
Nebraska	內布拉斯加州
Kansas	堪薩斯州
Hafana	哈瓦那
Missouri	密蘇里州
Louisiāna	路易斯安那州
Nagaland	那加兰邦
Kentucky	肯塔基州
Arkansas	阿肯色州
Ælf ēa	易北河
Oklahoma	奧克拉荷馬州
Donua	多瑙河
Hæfel	哈弗爾河
Norþsǣ	北海 (大西洋)
Flēogeball	排球
Uigenna	維也納
Cēapmannahæfen	哥本哈根
Stoccholm	斯德哥尔摩
Helsinki	赫尔辛基
Difelin	都柏林
Rēcwīc	雷克雅維克
Riga	里加
Menuþias	桑給巴爾
Dantsic	格但斯克
Frankfurt	美茵河畔法蘭克福
Death Note	死亡笔记
Biblioþēce	聖經
Ho Chi Minh Burg	胡志明市
Sōþ Iesus Cirice	真耶稣教会
Nīwenglisc sprǣc	英语
Andorra la Vella	安道尔城
Đồng Hới	同海市
Concepcion	康塞普西翁 (智利)
Cænugeard	基輔
Ontario	安大略
Ottawa	渥太華
Alberta	艾伯塔
Nīwe Scotland	新斯科舍
Końskowola	孔斯科沃拉
Geocon Landscipe	育空
Florentia	佛罗伦萨
Ǣt	食物
Snaca	蛇
Halifax	哈利法克斯
Quebecceaster	魁北克市
3. Æfterran Gēolan	1月3日
4. Æfterran Gēolan	1月4日
Región del Biobío (Cile)	比奥比奥大区
5. Æfterran Gēolan	1月5日
Arica	阿里卡
6. Æfterran Gēolan	1月6日
7. Æfterran Gēolan	1月7日
8. Æfterran Gēolan	1月8日
9. Æfterran Gēolan	1月9日
10. Æfterran Gēolan	1月10日
11. Æfterran Gēolan	1月11日
12. Æfterran Gēolan	1月12日
13. Æfterran Gēolan	1月13日
Beormingahām	伯明翰
14. Æfterran Gēolan	1月14日
15. Æfterran Gēolan	1月15日
16. Æfterran Gēolan	1月16日
17. Æfterran Gēolan	1月17日
18. Æfterran Gēolan	1月18日
Rōmānisc Rīce	羅馬帝國
Microsoft	微软
30. Æfterran Gēolan	1月30日
Kurów	库鲁夫
11. Solmōnðes	2月11日
11. Gēolmōnþes	12月11日
12. Gēolmōnðes	12月12日
17. Gēolmōnðes	12月17日
Wæþ	福斯河
Þrittiggēara Orlege	三十年戰爭
Benedictus XVI Pāpa	本篤十六世
6. Ēastermōnðes	4月6日
4. Ēastermōnþes	4月4日
Helmut Kohl	赫尔穆特·科尔
17. Ēastermōnðes	4月17日
12. Þrimilcemōnþes	5月12日
13. Þrimilcemōnþes	5月13日
20. Þrimilcemōnðes	5月20日
31 Þrimilcemōnaþ	5月31日
6. Mǣdmōnðes	7月6日
1. Mǣdmōnðes	7月1日
18. Mǣdmōnðes	7月18日
Gyldfōtþōðer	足球
26. Gēolmōnðes	12月26日
Eallbærnet	納粹大屠殺
IPad	IPad
Madrid	马德里
Elton John	艾爾頓·約翰
Undersǣbāt	潛艇
26. Wēodmōnðes	8月26日
24. Wēodmōnðes	8月24日
2. Hāligmōnþes	9月2日
Kassel	卡塞爾市
Canadisc underrīcu	加拿大行政区划
25. Hāligmōnðes	9月25日
Santiago (Cile)	圣地亚哥-德智利
1. Winterfylleðes	10月1日
14. Winterfylleðes	10月14日
8. Winterfylleðes	10月8日
7. Winterfylleðes	10月7日
Oldenburg (Oldenburg)	奥尔登堡
26. Winterfylleðes	10月26日
4. Blōtmōnðes	11月4日
1. Blōtmōnðes	11月1日
Wolfsburg	沃尔夫斯堡
Carl Micela Francena Cyning	查理大帝
Canberra	堪培拉
Sydney	悉尼
Grēne	綠色
Rēad	红色
Perþ (Australia)	珀斯
Fȳr	火
Westerne Australia	西澳大利亚州
Nīwe Sūþwealas	新南威爾士州
Norþerne Landscipe	北領地
Australisc Hēafodbyrig Landscipe	澳大利亚首都领地
Fīfeldor	艾德河
Nīl	尼罗河
Heortfordscīr	赫特福德郡
Comēta	彗星
Angol	安戈爾
Antofagasta	安托法加斯塔
Ancyra	安卡拉
Flocc:Bysen	Category:維基百科模板
Castro (Cile)	卡斯特罗市
Frencisc Guiana	法屬圭亞那
Chillán (Cile)	奇廉
Amāzanēa	亚马逊河
Tybingen	蒂宾根
Coyhaique	科伊艾克
Flocc:Bysen Land	Category:国家模板
Flocc:Bysen tīd	Category:时间模板
Willelmeshæfen	威廉港
Copiapó (Cile)	科皮亞波
Manama	麦纳麦
Delmenhorst	代尔门霍斯特
Brandenburg (burg)	哈弗尔河畔勃兰登堡
Wikipǣdia:Sandbox	Wikipedia:沙盒
Wikipǣdia:Inlǣdung	Wikipedia:新手入門/主頁
Cantabria	坎塔布里亚
Hūs	住宅
Rīmagiefung	代数
Mennisc bodiglār	人体解剖学
Osasco	奥萨斯库
Fujairah	富吉拉
Glasgow	格拉斯哥
Donghoi Lyfthæfene	同海機場
Rodor	外层空间
Sweartweald	黑森林
Curitiba	庫里奇巴
Weald	森林
Flocc:Cliferfētedēor	Category:偶蹄目
Talca	塔爾卡
Flothere	海军
Andalién	安達連河
Bysen:Lang-lt	Template:Lang-lt
Cwidbōc	箴言
Rancagua	兰卡瓜
Confucius	孔子
Corbin Bleu	柯賓·布魯
Flocc:Rīmcræft	Category:数学
Faroisca Īega	法罗群岛
Wendelsǣ	地中海
Flocc:Nīwes Sǣlandes īga	Category:新西兰岛屿
Cōcnearuness	庫克海峽
Crīstendōm	基督教
Windows 8	Windows 8
Bysen:Asia	Template:亞洲
Gandis	恒河
Worulddǣl	洲
Fugol	鸟
Hēafodstōl	首都
Monzón	蒙宗
Portuglisc sprǣc	葡萄牙語
Mōnaþ	月
Bysen:Fōtball stycce	Template:足球小作品
Almazán	艾爾瑪善鎮
Huang Siānfan	黄现璠
Kescwisc sprǣccynn	克丘亞語
Bill Gates	比尔·盖茨
Iapanisc sprǣc	日语
Wīsdōmbōc	百科全书
Hēafodtramet	Wikipedia:首页
Golf	高爾夫球
Hrōcburhfōtþōðer	橄欖球類運動
Olympisc Gamen	奥林匹克运动会
Eurasia	歐亞大陸
Andes	安地斯山脈
Durban	德班
Caspia	裏海
Uictoriamere	維多利亞湖
Estmere	维斯图拉潟湖
Babilōn	巴比伦
Ēalendisca Īega	奥兰 (芬兰)
Cægman Īegland	開曼群島
Novak Đoković	諾瓦克·喬科維奇
Fortunatus iegland	加那利群岛
Hrōcburhgesamnunge plega	橄欖球
Ūðwitegung	哲学
Flocc:Candidates for speedy deletion	Category:快速删除候选
Tē	茶
Hebe Camargo	赫柏·卡马戈
Gemǣnre ǣhte rǣd	共产主义
Wealdlīste rǣd	无政府主义
Ǣhtwealdes endebyrdness	资本主义
Frēodōmes þōht	自由主义
Gilmrǣd	法西斯主义
Cofentreo	考文垂
Ōðre Penisc Gūþ	第二次布匿战争
Cartaina	迦太基
Bryttisc Museum	大英博物馆
Sund	游泳
1451	1451年
Ellaspontus	達達尼爾海峽
Strǣtburg	斯特拉斯堡
Gytārre	吉他
Croatisc sprǣc	克罗地亚语
Cesena	切塞纳
Hāmburgere	漢堡 (食物)
Fédération Internationale de Volleyball	国际排球联合会
20e gēarhundred	20世纪
Catalan sprǣc	加泰罗尼亚语
11e gēarhundred	11世纪
Gelēaflēasnes	无神论
Cynn scī huang	秦始皇
Elisabeþ I Engla Cwēn	伊丽莎白一世 (英格兰)
Cynewīse	共和制
Þēodlices gemǣnscipes rǣd	纳粹主义
Nazi Þēodscland	納粹德國
Christopher Columbus	克里斯托弗·哥伦布
Iacobus Cōc	詹姆斯·庫克
Ēare	耳
Nasu	鼻
Ēage	眼
Scēap	綿羊
Mereswīn	海豚
Sǣhund	鲨鱼
Sycedēor	哺乳动物
Ǣmette	蚂蚁
Bēo	蜂族
Niðerlendisc sprǣc	荷蘭語
Ǣȝƿyrt	茄
Draca	龙 (西方)
Mōdor	母親
Snāw	雪
Wæterþōðer	水球
1865	1865年
Napoleon III Francena Casere	拿破仑三世
Russisc sprǣc	俄语
Hloþwig XIV Francena Cyning	路易十四
Hām	家
Vladimir Putin	弗拉基米尔·弗拉基米罗维奇·普京
Loðwic-Philippus Francena Cyning	路易-菲利普一世
Þēodacynewīse	英联邦
Hlāf	麵包
Taurica	克里米亚
Līfclēofa	细胞
Blōd	血液
Īwungplega	电子游戏
Rumǣnisc sprǣc	羅馬尼亞語
Regn	雨
Medumweder	氣候
Woruldlicu wearmung	全球变暖
Eorþbeofung	地震
Museum on Dēoraby	德比博物馆与艺术画廊
Winston Churchill	温斯顿·丘吉尔
Nelson Mandela	纳尔逊·曼德拉
10. gēarhundred	10世纪
Fȳrbeorg	火山
Wolcen	云
Īwungplegtōl	電子遊戲機
Wind	風
Lyfthelm	大气层
Sprǣccræft	语言学
Flocc:Pulgaraland	Category:保加利亚
Flocc:Francland	Category:法国
Flocc:Glīƿdrēam	Category:音乐
Flocc:Bōccræft	Category:文学
Fox	赤狐
Valladolid	巴利亚多利德
Alexander Mæcedonia Cyning	亚历山大大帝
Hēaphandþōðer	手球
Hugo Chávez	烏戈·查維茲
Þēowdōm	奴隶制度
Caffig	咖啡
Meolc	乳
Beorg	山
Oferswefn	催眠
Andrew Johnson	安德鲁·约翰逊
Miami	迈阿密
Americanisce Ingefeoht	南北战争
Rio de Janeiro	里约热内卢
Bryttisce Rīce	大英帝国
Albanisc sprǣc	阿尔巴尼亚语
Ucrægnisc sprǣc	乌克兰语
Crabba (steorra)	巨蟹座
Swēonisc sprǣc	瑞典語
Denisc sprǣc	丹麦语
Norðisc sprǣc	挪威语
Noam Chomsky	诺姆·乔姆斯基
Bæmisc sprǣc	捷克语
Karl Marx	卡尔·马克思
Lettisc sprǣc	拉脱维亚语
Liþþuanisc sprǣc	立陶宛语
Hinduismus	印度教
Wīflicu brēost	乳房
Mot	原子
Crēacisc sprǣc	希腊语
Weorcendebyrdness	操作系统
Īrisc sprǣc	愛爾蘭語
Ambihtlic Cīnisc sprǣc/ᚱᚢᚾ	官话
C. S. Lewis	C·S·路易斯
Baku	巴库
Hebrēisc sprǣc	希伯来语
Azeri sprǣc	阿塞拜疆语
Wilisc sprǣc	威尔士语
Scyttisce sprǣc	苏格兰盖尔语
John Locke	约翰·洛克
Friedrich Nietzsche	弗里德里希·尼采
Lifere	肝臟
Drēag (Fūdū)	喪屍
Gārsecg	洋
Gautama Budda	释迦牟尼
Premier League	英格兰足球超级联赛
Mahomet	穆罕默德
Ācweorna	松鼠
Rēmisc Cirice	天主教會
Bengalisc sprǣc	孟加拉语
Tunge	舌
Folcland Īegland	福克兰群岛
Manīeg	曼島
Wiht (īeg)	怀特岛郡
Heortford	哈特福 (英國)
Elisabeþ II	伊丽莎白二世
ß	ß
John F. Kennedy	约翰·肯尼迪
Ronald Reagan	罗纳德·里根
Æ	Æ
Ð	Ð
Fernando Alonso	费尔南多·阿隆索
Flocc:Feneswela	Category:委内瑞拉
Þunreshæfen	托爾斯港
11. Hāligmōnþes 2001. torngemōt	九一一袭击事件
Culfre	鸠鸽科
Trēow	树
Cīese	乾酪
Wīnberge	葡萄
Hunig	蜂蜜
Eorþperu	马铃薯
Searuþræl	机器人
Searucræft	技术
Feorrspreca	电话
Lugo	卢戈 (西班牙)
Hēahdēmere þāra Geāndena Rīca American	美国首席大法官
Windows 7	Windows 7
Windows Vista	Windows Vista
World Trade Center	世界贸易中心
Nelson Rockefeller	纳尔逊·洛克菲勒
One World Trade Center	世界貿易中心一號大樓
Fidel Castro	菲德尔·卡斯特罗
Rockefeller Center	洛克斐勒中心
Flocc:Brasil	Category:巴西
Flocc:Rumǣnia	Category:罗马尼亚
Hēafodgesceaft	化學元素
Gemot	分子
Cræftlicu endebyrdung	生物分類法
Lyft	气体
Lyftcræft	航空器
Clāðas	服装
Swēg	声音
Paper	纸
Rīm	数
Bere	大麦
Nirvana	涅槃乐队
Weder	天气
Land þǣre worulde	世界政區索引
Bera	熊科
John Adams	约翰·亚当斯
Thomas Jefferson	托马斯·杰斐逊
James Madison	詹姆斯·麦迪逊
James Monroe	詹姆斯·门罗
John Quincy Adams	约翰·昆西·亚当斯
Andrew Jackson	安德鲁·杰克逊
Martin Van Buren	马丁·范布伦
William Henry Harrison	威廉·亨利·哈里森
John Tyler	约翰·泰勒
James K. Polk	詹姆斯·诺克斯·波尔克
Zachary Taylor	扎卡里·泰勒
Ǣtweg	消化作用
Kylie Minogue	凯莉·米洛
Āc	栎属
Pīntrēow	松屬
Āte	燕麦
Hwǣte	小麦
Corn	谷物
Unmeaht	身心障礙
Gerīmbōc	历法
Ādl	疾病
Gregorisc gerīmbōc	公历
Soria	索里亚
Manisc sprǣc	曼島語
Bysen:Stedefindend scite Breten	Template:Location map United Kingdom
Millard Fillmore	米勒德·菲尔莫尔
Franklin Pierce	富兰克林·皮尔斯
James Buchanan	詹姆斯·布坎南
Pireni	比利牛斯山
Hālig Rōmānisc Rīce	神圣罗马帝国
Mongolrīce	蒙古帝国
Oþomanisce Rīce	奥斯曼帝国
Cirice Ednīwung	宗教改革
Wīcingas	維京人
Sweord	劍
Fȳrwǣpen	枪械
Iberia	伊比利亚半岛
Fȳrspringend	炸藥
Campwægn	坦克
Antwerpen	安特卫普
Brycg (burh)	布吕赫
Blǣwenberge	藍莓
Blæcberige	黑莓
Fenberge	小紅莓
Cīnisc gōsberige	奇異果
Retoromanisc sprǣc	罗曼什语
Īsrēam	冰淇淋
Ceace	蛋糕
Īsbrīw	雪葩
Dinegisc sprǣc	納瓦荷語
Meolcbrīw	酸奶
Montserrat	蒙塞拉特島
Bysen:Location map Greenland	Template:Location map Greenland
Wikicynn	維基物種
Arabisc sprǣc	阿拉伯语
Ian Magen	揚馬延
Corsica	科西嘉岛
Affricanisc sprǣc	南非語
Forma Þegn þæs Geānedan Cynerīces	英国首相
Santiago de Compostela	聖地亞哥-德孔波斯特拉
Iquique	伊基克
La Serena (Cile)	拉塞雷纳
Lebu	萊布 (智利)
Niðerscyttisc sprǣc	低地蘇格蘭語
Linux (cyrnel)	Linux内核
Darwin (æhtendebyrd)	Darwin (操作系统)
Emmen	埃門 (荷蘭)
Sofiet Gesamnung	苏联
Se Hlāford þāra Hringa	魔戒
Hrūse	地壳
Sīensearu	照相機
Gaðes	加的斯
Llión	莱昂 (西班牙)
Fōt	脚
Queen	皇后乐队
Freddie Mercury	弗雷迪·默丘里
Normandig	諾曼底
Metallica	金属乐队
Wikipǣdia:Fulgōd gewritu	Wikipedia:特色条目
Bysen:Link FA	Template:Link FA
Lēoht (dæg)	日光
Wikipǣdia:Se Þorpes Wella	Wikipedia:互助客栈
Vermont	佛蒙特州
Jacksonville, Florida	杰克逊维尔 (佛罗里达州)
Los Ángeles (Cile)	洛桑赫萊斯 (比奧比奧省)
Eþna	埃特纳火山
Æg	卵
Tibet	藏区
Handsprecend	移动电话
Strȳta	鸵鸟
Corēa	朝鲜 (称谓)
Wesend	美洲野牛属
Mameceaster	曼彻斯特
Turcas and Caicos Īegland	特克斯和凯科斯群岛
Blēocræft	刺绣
Wulf	狼
Major League Soccer	美國職業足球大聯盟
Þōðer	球 (體育)
Club de Gimnasia y Esgrima La Plata	拉普拉塔体操击剑俱乐部
Nīwu Gecȳþnes	新約聖經
Middelseaxe	米德塞克斯
San Pedro de la Paz	聖佩德羅德拉帕斯
Scræf (fugol)	鸕鶿
Dūfedoppa	鹈鹕
Nha Trang	芽莊市
Podolsk	波多利斯克
Pāpa	教宗
Rafael Correa	拉斐尔·科雷亚
5	5年
Louvre	卢浮宫
Sæfern	塞文河
Temes	泰晤士河
Tirana	地拉那
Motorhead	摩托头
Afen	雅芳河 (布里斯托)
6	6年
Josh Duhamel	喬許·杜默
Stīðen Āc	斯蒂夫尼奇
Crīstesmæsse	圣诞节
Bises	闰年
Steve Jobs	史蒂夫·乔布斯
Indo-Europisc sprǣchīred	印欧语系
Breinigerberg	贝瑞宁格堡
Muammar al-Gaddafi	穆阿迈尔·卡扎菲
Tiger	虎
Samsunghēap	三星集团
Ēaster	復活節
Germanisca sprǣca	日耳曼语族
Windows Mobile	Windows Mobile
GNU Frēo Gewrita Amearcunge Lēaf	GNU自由文档许可证
John Kerry	约翰·克里
Taiwan (īeg)	臺灣
Searusprecend	智能手机
Trōia	特洛伊
Nīwe Eoforwīc (scīrung)	紐約 (消歧義)
Ceafer	鞘翅目
Scōh	鞋
Baðanceaster	巴斯 (薩默塞特郡)
Īrland	爱尔兰岛
Bradanford	布拉德福德
Ceasterscīr	柴郡
Lonceasterscīr	兰开夏郡
Norþhymbraland	諾森伯蘭郡
Dūnholmscīr	達勒姆郡
Lincolnscīr	林肯郡
Snotingahāmscīr	諾丁漢郡
Dēorabyscīr	德比郡
Scrobbesbyrigscīr	什罗普郡
Stæffordscīr	斯塔福德郡
Lægreceastrescīr	莱斯特郡
Roteland	拉特蘭
Norþfolc	诺福克郡
Sūþfolc	薩福克郡
Grantabrycgscīr	劍橋郡
Norþhāmtūnescīr	北安普敦郡
Westmidlandscīr	西米德蘭茲郡
Herefordscīr	赫里福德郡
Wigreceastrescīr	伍斯特郡
Wæringscīr	沃里克郡
Beadanfordscīr	貝德福德郡
Cornweal	康沃爾郡
Bricgstōw	布里斯托尔
Defenascīr	德文郡
Sumorsǣte	森麻實郡
Dorsǣte	多塞特郡
Gleawcesterscīr	格洛斯特郡
Oxnafordscīr	牛津郡
Wiltūnscīr	威爾特郡
Hāmtūnescīr	漢普郡
Bearrucscīr	伯克郡
Buccingahāmscīr	白金汉郡
Ēastseaxe	埃塞克斯郡
Sūþrīge	薩里郡
Cent	肯特郡
Lundenceaster	倫敦市
Westmoringaland	威斯特摩蘭 (英格蘭)
Huntandūnscīr	亨廷登郡
Sūþseaxe	萨塞克斯郡
Seofon	7
Taylor Lautner	泰勒·洛納
Cumbraland	坎伯蘭
Jeremy Renner	杰瑞米·雷纳
Īs	冰
Fæder ūre	主禱文
Musée d'Orsay	奥赛博物馆
Hwerhwette	黄瓜
Edinburg	爱丁堡
Hwīt	白色
Sweart	黑色
Chris Pine	克里斯·潘恩
Lordi	妖怪樂團
6 (getæl)	6
Ambihtlicu sprǣc	官方语言
Heortæppel	番茄
Phong Nha-Ke Bang	峰牙－己榜國家公園
Entrena	恩特雷纳
Selena	莎麗娜
NASA	美国国家航空航天局
Merida (Feneswela)	梅里達市
Atlanta	亚特兰大
Benito Mussolini	贝尼托·墨索里尼
Bermuda	百慕大
Hēafod	头
Weolingtūn (Nīwe Sǣland)	惠灵顿
Bryten	大不列顛島
Alfred Nobel	阿尔弗雷德·诺贝尔
Camb (tō hǣre)	梳篦
Mennisc līc	人体
Lila Downs	利拉·唐斯
Andrew Garfield	安德魯·加菲爾德
Dottatiger	猎豹
Albany on Nīwum Eoforwīce	奥尔巴尼
Ūle	貓頭鷹
Anguilla	安圭拉
Guernsey	根西
Scearpbeorgas	斯瓦尔巴
Hrycgdēor	脊椎动物
Nowy Dwór Królewski	克鲁莱夫斯基新庄园
Faroisc sprǣc	法罗语
Catt	猫科
Lytel Spēonland	伊斯帕尼奥拉岛
Harrisburg	哈里斯堡
Hamor	槌
Picilemo	披市勒亩
Bryttiscan Fæmne Īegland	英屬維爾京群島
Flēoge	雙翅目
Norða	北极地区
Hund	犬科
Fresisc sprǣc	弗里西语
Antoni Gaudí	安东尼·高迪
Cliferfētedēor	偶蹄目
Steorrfisc	海星
Eurasisc bleohcrāwe	松鴉
Hrōc	秃鼻乌鸦
Ēotaland	日德兰半岛
Niþeru Þēodsc sprǣc	低地德语
Coning	穴兔
Cuscan Rīce	貴霜帝國
Tromsīeg	特罗姆瑟
Sandwīc	桑威治 (肯特郡)
Eormengyld Niccolò Cusano	尼可罗库萨诺大学
Montpelier on Uermonte	蒙彼利埃 (佛蒙特州)
Geac	牦牛
Palistiniscre Frēogunge Þēodnes	巴勒斯坦解放組織
Westgermanisca sprǣca	西日耳曼語支
Taylor Swift	泰勒·斯威夫特
Cōcīega	库克群岛
Brocc	獾
Sealterisc sprǣc	沙特弗里西語
Middelasia	中亚
Langaland	朗厄蘭島
Sealterland	萨特尔兰
Ofersǣwisc rind	桂皮
Jackson (Mississippi)	杰克逊 (密西西比州)
Concord (Nīwu Hāmtūnscīr)	康科德 (新罕布什尔州)
Annapolis	安那波利斯
Eald Corēa	古朝鮮
Hreaðemūs	蝙蝠
Ēastrīce-Ungerland	奥匈帝国
Tarnobrzeg	塔尔诺布热格
Wesle	鼬屬
Scīr	县
Sandwīc (ǣt)	三明治
Spearwa	雀科
Eormanrīc	厄尔曼纳里克
Francisco Franco	弗朗西斯科·佛朗哥
Tarja Halonen	塔里娅·哈洛宁
Willis Tower	威利斯大廈
Cantwaraburg	坎特伯雷
Cīna	中國
Tracter	漏斗
Englisc lagu	英美法系
Seolh	鰭足類
Ecser	埃切尔
Silesisc gereord	西里西亞語
Zhengzhou	郑州市
Foresittend	總統
Frencisc Polynesia	法屬玻里尼西亞
Roðem	鲁昂
Crīstesmæsse Īeg	圣诞岛
Bleohfugol	鹦形目
Cambihtere	凤头鹦鹉科
Arabea	阿拉伯半岛
Fȳstlāc	拳击
Seax	小刀
Top Gear	英国疯狂汽车秀
Tasmansǣ	塔斯曼海
Ceroke sprǣc	切羅基語
Campwīg be Tannebeorge	格伦瓦德之战
Īsbera	北極熊
Hand	手
Tu Fu	杜甫
Nīwe Scotta Ēaland	新喀里多尼亞
Cecoslofacia	捷克斯洛伐克
Lēaf	葉
Nepal Bhasa	尼瓦尔语
Valparaíso (on Cilan)	瓦尔帕莱索
Fugolīeg, Sūþgeorgia	伯德島 (南喬治亞群島)
Annenkovīeg	安年科夫島
Nathalia Dill	纳塞利亚·迪尔
Oaxaca	瓦哈卡州
Tahitisc sprǣc	大溪地語
Flemisc sprǣc	弗拉芒语
Yasser Arafat	亚西尔·阿拉法特
Oxnaford	牛津
Międzyrzec Podlaski	缅济热茨
Tasmania	塔斯馬尼亞州
Creto	克里特
Saint-Dié-des-Vosges	孚日圣迪耶
Eormengyld Oxnafordes	牛津大学
Þyrla	直升機
Sancte Elene Īeg	圣赫勒拿岛
Nicor	河马
Egisca Sǣ	爱琴海
Ichiro Mizuki	水木一郎
Anastacia	安娜塔西亚
Eufrāte	幼发拉底河
James A. Garfield	詹姆斯·艾布拉姆·加菲尔德
Cirice	教会
Persisc Sǣ	波斯湾
Sand	沙
Cyningestūn (Iamaica)	京斯敦
Lafor	豹
Age of Empires	世紀帝國系列
Tequixquiac	特基斯基阿克
Ulysses S. Grant	尤利西斯·辛普森·格兰特
Oklahoma City	奧克拉荷馬市
Meotedisca Mere	亞速海
William McKinley	威廉·麦金莱
Cawel	捲心菜
Foresittend þāra Geāndena Rīca	美国总统列表
Sūþgeorgia and þā Sūþsandwic Īegland	南乔治亚和南桑威奇群岛
Webbsīde	網站
Catalão	卡塔洛
Grover Cleveland	格罗弗·克利夫兰
Ealdhēahþēodisc	古高地德語
Satan	撒旦
Wordstǣrcræft	语源学
Beorglēo	美洲狮
Arabas	阿拉伯人
Proponditis	马尔马拉海
Ēagduru	窗
Chester A. Arthur	切斯特·艾伦·阿瑟
Riffeng	乌拉尔山脉
Rīcu þāra Geāndena Rīca American	美国州份
Pitcearnīega	皮特凯恩群岛
Benjamin Harrison	本杰明·哈里森
Rutherford B. Hayes	拉瑟福德·伯查德·海斯
Wīnlendisc panðer	美洲豹
Sūþaustralia	南澳大利亚州
Gotisc sprǣc	哥德語
Boise	博伊西
Bāt	艇
Awaisc sprǣc	瓜拉尼語
Gærsbēam	竹
Interlingua	国际语
Bosporos	伊斯坦布尔海峡
Smyrna	伊兹密尔
Lemburg	利沃夫
Cwēneland	昆士蘭州
Siligo	西利戈
Puerto Montt	蒙特港
Iane Austen	简·奥斯汀
Tægcwondo	跆拳道
Middel Englisc sprǣc	中古英语
Māorisc sprǣc	毛利语
Hannibal	汉尼拔
Hōrdōm	性交易
Twinemniendlic nama	二名法
Victoria (Australia)	維多利亞州
Geugoslafia	南斯拉夫
Ætla	阿提拉
Scrælingas	美洲原住民
Arancón	阿兰孔
Willelm Heretoga of Grantanbrycge	劍橋公爵威廉王子
Toshiro Mifune	三船敏郎
Tallahassee	塔拉赫西
Sundorrīcehād	独立
Bismarck (Norþdakota)	俾斯麥 (北達科塔州)
Aucland	奧克蘭都會區
Iohannes Paulus I Pāpa	若望·保禄一世
John Michael Talbot	约翰·約瑟夫·塔波特
Acrotiri and Ðecelia	亞克羅提利與德凱利亞
Arara	阿拉拉
Cnēo	膝
Willelm I Engla Cyning	威廉一世 (英格兰)
Campora Sancte Iohannes	肯波拉圣吉奥瓦尼
Sīde	丝绸
Sint-Truiden	圣特雷登
Lēoðlic scātung	花样滑冰
Stefn (līfcræft)	门 (生物)
Heanrig VIII Engla Cyning	亨利八世
Columbia (Sūþcarolīna)	哥伦比亚 (南卡罗来纳州)
Xena: Warrior Princess	齊娜武士公主
1880. gēar oþ 1889. gēar	1880年代
Helena (Montana)	赫勒拿 (蒙大拿州)
Wælhwelp	槍獵犬
Eormengyld Biobiwes	比奥比奥大学
Sufa	蘇瓦
Eorþmistel	羅勒
Lēohtfȳsend	激光
Prēossland	普魯士
Cheyenne (Wyoming)	夏延 (怀俄明州)
Norðerne healftrendel	北半球
Loidis	利兹
Fūcgī Beorg	富士山
Mūs	小鼠属
Geolurēad	橙色
Æcs	斧
Seofonbyrig	特兰西瓦尼亚
Tōl	工具
Alī	阿里·本·阿比·塔利卜
Hrān	驯鹿
Stānhencg	巨石阵
Ágreda	阿格雷达
Amazonas	亚马孙州 (巴西)
Ajaccio	阿雅克肖
Rodorcræft	航天器
Lisa Gerrard	莉薩·傑勒德
Thirty Seconds to Mars	30秒上火星
Paulínia	保利尼亚
Pierre	皮尔 (南达科他州)
Crabba	螃蟹
God Nerie þā Cwēne	天佑吾王
Meteūtsiht	腹瀉
Anna Maria Jopek	安娜·瑪莉亞·約佩克
Horshwæl	海象
Fōrhēafod	前额
Haile Selassie	海尔·塞拉西一世
Caðum	卡昂
Sonygegyld	索尼
Mynet	硬幣
Sūðerne Healftrendel	南半球
Cnihtas þæm Temple	圣殿骑士团
Americanisc fōtball	美式足球
Tōþsticca	牙籤
Folcmorðor	种族灭绝
Hociȝ	冰球
Swīnmūþa	希維諾烏伊希切
Īrisc Sǣ	愛爾蘭海
Tracia	色雷斯
Mongolas	蒙古族
Mǣs	默兹河
Talcahuano	塔爾卡瓦諾
Tahitīeg	大溪地
Ontynung	启示录
Abel Tasman	阿贝尔·塔斯曼
Gotan	哥特人
Nettfrumfindend	统一资源定位符
Ænglisc sprǣc	古英语
Englisc folc	英格蘭人
Eoforwic	約克
Iron Maiden	鐵娘子樂團
Asterix	阿斯泰利克斯历险记
Grǣg	灰色
Wearm geard	热带
Hwælhuntoþ	捕鯨
Sǣcū	海牛屬
Gregorius Pāpa I	教宗額我略一世
Cȳta (lyftcræft)	风筝
Þunor	索尔
Castel Goffredo	卡斯泰尔戈夫雷多
Roðos	罗得岛
Sanct	圣人
Wikipǣdia:FAQ	Wikipedia:常见问题解答
Cycene	廚房
Wæterdraca	鱷科
Hlæstwægn	载货汽车
Carl Wēala Þēoden	威爾斯親王查爾斯
Villeneuve-d'Ascq	阿斯克新城
Crāwe	乌鸦
Sūþtun on Defnum	普利茅斯
Bryttisca Indisca Garsecg Landscipe	英屬印度洋領地
Dēoraby	德比 (英格蘭)
Francan	法蘭克人
Fealcen	隼
Nightwish	夜愿
Mattheus se Godspellere	馬太
Mac OS	Mac OS
Leyden	莱顿
Fiðerlēasere	鷸鴕
Montehermoso	蒙特埃尔莫索
Louis the Pious	虔誠者路易
Cwēnsǣ	白海
Jim Morrison	吉姆·莫里森
GNOME	GNOME
Hāt	熱量
Spere	槍
Ēadig getæl	快樂數
Charleston (Westvirginia)	查尔斯顿 (西弗吉尼亚州)
Mynster	僧院
Oxnaford Englisc Wordbōc	牛津英語詞典
Īsearn	翠鸟
Carl XVI Gustaf Swēona Cyning	卡尔十六世·古斯塔夫
Świętochłowice	希维托赫洛维采
Zac Efron	柴克·艾弗隆
Monte Carlo	蒙特卡洛
Elba	厄尔巴岛
The Doors	門戶樂團
Fylfōt	卐
Clerke Clūdas	克拉克岩
Hara	兔属
Rīcisc edisc	國家公園
Boga	弓
Byrdling	陸龜
Bryttisc landbūnes	英國海外領土
Brūn	褐色
Hjaltland	设德兰
Byrddæg	生日
Æx-in-Profentse	普罗旺斯地区艾克斯
Gaza	加薩
Īsbeorg	冰山
Ephese	以弗所
Englisc wera rīcisc fōtballtēam	英格蘭足球代表隊
Pratibha Patil	普拉蒂巴·帕蒂尔
Minte	薄荷
Spilcarte	遊戲牌
Bysen:Commonscat	Template:Commons category
Hālig Land	聖地
Folcland Gewinn	马岛战争
Bēowulf	貝奧武夫
Marīahæfen	玛丽港
Hrǣw	屍體
IOS	IOS
Lee Harvey Oswald	李·哈維·奧斯瓦爾德
Frumtæl	素数
Þ	Þ
Orlando	奥兰多 (佛罗里达州)
Saint Petersburg	聖彼德斯堡 (佛羅里達州)
Hereðaland	霍达兰郡
Sogn and þa Flēotas	松恩-菲尤拉讷郡
Meore and Romsdæl	默勒-鲁姆斯达尔郡
Troms	特罗姆斯郡
Dǣlere	因數
Australisc fōtþōðer	澳式足球
Secglēac	蝦夷蔥
Stānweall sacunga	石牆暴動
Punta Arenas	蓬塔阿雷纳斯
Aaron	亞倫
Wu-Tang Clan	武当帮
Osgar I Swēona Cyning	奥斯卡一世
Hwēolrinnung	自行车运动
Aquilegia	阿奎萊亞
Hyll	丘
Beorneslēah	巴恩斯利
Banff	班夫 (苏格兰)
Soria (scīr)	索里亚省
El Royo	埃尔罗约
Harold V Norrena Cyning	哈拉尔五世
Þēodlic Dæg	国庆日
John Key	约翰·基
Ēadweard I Engla Cyning	爱德华一世
Sūþerne Thila	南圖勒群島
Candelmæssanīega	坎德爾默斯群島
Ræt	鼠
Ariel Sharon	阿里埃勒·沙龙
1050e	1050年代
Æneid	埃涅阿斯纪
Autaugaville, Alabama	奥塔贾维尔 (阿拉巴马州)
Forma Frencisce Rīce	法兰西第一帝国
Brādford	布雷德福特
Se Holbytla	哈比人歷險記
Eocene	始新世
Strǣt	街道
Superman	超人
Heorotbrēr	鼠李属
Wikipǣdia:Fulgōdra gewrita teohhunga	Wikipedia:特色条目评选
Wikipǣdia:Gōd gewrit genamunga	Wikipedia:優良條目評選
Rætswīn	豚鼠
Iconium	科尼亞 (土耳其)
Emma Goldman	埃玛·戈尔德曼
Iacobus I Grēatre Bryten Cyning	詹姆斯六世及一世
Crīstcirice	基督城
Coronel Fabriciano	法布里西亚诺上校城
Babsk	巴布斯克
Englisca Ingewinn	英國內戰
Bengal	孟加拉
Morgenmete	早餐
1060e	1060年代
Pippen III Francena Cyning	矮子丕平
Carl I (Grēatre Bryten Cyning)	查理一世 (英格蘭)
Ȝealdor/ᚷᛖᚪᛚᛞᚩᚱ	魔法
Cucler	匙
Geþofted Rīcu American	美利堅聯盟國
Elpendbān	象牙
Villarrobledo	比利亚罗夫莱多
Temuco	特木科
Hloðwic I Francena Cyning	克洛维一世
William Wallace	威廉·華萊士
Bundesliga	德国足球甲级联赛
Fȳrland	火地群岛
Maria I Engla Cwēn	玛丽一世 (英格兰)
Angelcirice	英國國教會
Engla Cyning	英格蘭君主列表
Lencten (tīd)	大齋期
Fuþorc	盧恩字母
Lēactric	莴苣
Beadu Hǣstingum	黑斯廷斯战役
Ēadweard VI Engla Cyning	爱德华六世
Jacques-Yves Cousteau	雅克-伊夫·库斯托
Horatio Nelson	第一代纳尔逊子爵霍雷肖·纳尔逊
Galilēa	加利利
Gaderscypefāna	英国国旗
Foldlic clūt	岩石圈
Þunor (weder)	雷
Þūma	拇指
Ælfrēd Micela	阿尔弗雷德大王
Hāmlǣrung	在家自學
Teutoburg Weald Beadu	条顿堡森林战役
Bysen:Cite book	Template:Cite book
O Canada	啊，加拿大
Biobío	比奥比奥河
Orcanege	奥克尼
Profentse	普罗旺斯
Predore	普雷多雷
Seaxe	撒克遜人
Willelm II Engla Cyning	威廉二世 (英格蘭)
Limburgisc	林堡语
Eallerīca Gotena Cyning	亚拉里克一世
Tygelwīg	拔河
Boētius	波爱修斯
Hunigbēo	蜜蜂屬
Abbod	修道院长
Mæcedonia	馬其頓
Sameramis	沙米拉姆
Pīp	烟斗
Aerosol	气溶胶
Gangnihessou	岡尼何梭
Ilfingburg	埃爾布隆格
Mierce	麥西亞王國
Þēodrīc Ēastgotena Cyning	狄奧多里克大帝
Westseaxena Rīce	威塞克斯王國
Hēahland	蘇格蘭高地
Norþhymbra Rīce	諾森布里亞王國
Wulfila	烏爾菲拉
Bram Stoker's Dracula	吸血殭屍：驚情四百年
Angeow	安茹
2011 FIFA Frēona Woruldceampscipe	2011年女子世界杯足球赛
Alexander VI Pāpa	亞歷山大六世
Æppellēaf	香堇菜
Mexiciscu rīce	墨西哥行政區劃
Cethāmīga	查塔姆群岛
Norþīg	北島 (紐西蘭)
Anne Cwēn	安妮 (英国女王)
Sūþīeg	南島 (新西蘭)
Sunnstede	至點
Regnwyrm	蚯蚓
Kara	Kara
Ceadmere	乍得湖
Getalu Rōmāniscra Cāsera	羅馬皇帝列表
Heantun	伍爾弗漢普頓
Wascas	巴斯克人
Minerva	弥涅耳瓦
Fȳræg	炸弹
Ashley Tisdale	艾希莉·提斯代爾
Þrondham	特倫德拉格
Nīwe Woruld	新大陸
Fȳrweorc	烟火
Æsc	梣树
Galwæg	戈尔韦
Ēadweard Andettere	懺悔者愛德華
Hramsa	熊葱
Scīdfarung	滑雪
World of Warcraft	魔兽世界
Byrig þāra Geāndena Rīca	美國城市列表 (按人口排列)
Nemniendlic cāsus	主格
Folcawanderung	欧洲民族大迁徙
Slayer	超級殺手合唱團
Maria Scotta Cwēn	玛丽一世 (苏格兰)
Indisc rīce	印度各邦和中央直辖区
Scield	盾
Henry V Englalandes	亨利五世 (英格兰)
Sciþþia	斯基泰人
Universidade Federal de Minas Gerais	米纳斯吉拉斯联邦大学
Sceanca	腿
Pulgare	保加利亞人
Lyftscip	飞艇 (轻航空器)
Cnut se Micela	克努特大帝
Saturnus	萨图尔努斯
Exanceaster	埃克塞特
Sanctes Laurentes Ēa	圣劳伦斯河
Mundlēow	盥洗盆
Sūþhjaltland	南设得兰群岛
Cartespil	卡片遊戲
Iscimbag	伊希姆拜
Basu Heorte	紫心勋章
Marianburg	马尔堡 (波兰)
Rosseg	梅恩蘭島 (奧克尼群島)
Nīwsǣlandworulddǣl	西兰大陆
Carl Fǣtta Francena Cyning	胖子查理
Þēodisc Āþbēorscipe	德意志邦聯
Wikipǣdia:How to edit a page	Help:编辑页面
Cantwarabyrig eorþbeofung 2011.	2011年基督城地震
Eorðæppelstycce	馬鈴薯條
Rīnland	莱茵兰
Eormengyld Tybingenes	蒂宾根大学
Blōdmearh	血腸
Midsumor	仲夏節
Timborwyrhta	木匠
Anlaf V Norrena Cyning	奥拉夫五世
Ēadweard Westseaxna Eorl	威塞克斯伯爵爱德华王子
Hacun VII Norrena Cyning	哈康七世
Ecgbryht	威塞克斯的埃格伯特
Earnulf Carendran	阿努尔夫 (东法兰克)
Bēda	比德
Laplandes Gūþ	拉布蘭戰爭
Willelm-Alexander Niðerlanda Cyning	威廉-亞歷山大 (荷蘭)
Bredspearctellend	平板電腦
Mathusal	瑪土撒拉
Bēowyrt	菖蒲
Pontcysyllte Wætertyge	龐特卡薩魯岧水道
Universidade Federal da Bahia	巴伊亚联邦大学
Nēohwæl	一角鲸
Ajman	阿吉曼
Harold Godwinson	哈罗德·戈德温森
Ȳþrīdung	衝浪
Brū	睫毛
Port:Stǣr	塔吉克斯坦国旗
Kiæresburh	瑟堡-奥克特维尔
Bresl	椒鹽卷餅
CONCACAF	中北美洲及加勒比海足球協會
Mentha arvensis	野薄荷
Searoburg	索爾茲伯里
Lunden Ēage	倫敦眼
Valdivia	瓦尔迪维亚
Pachuca de Soto	帕丘卡
Balsminte	水薄荷
Dweorgedosle	唇萼薄荷
Landbūnes	属地
Rēadingas	雷丁
Mængo	杧果属
Grēate Bryten Cynerīce	大不列顛王國
Brōcminte	欧薄荷
Iane Grey Hlæfdige	简·格雷
Charmed	聖女魔咒
Grammatisc cyn	性 (语法)
Nica Ūphebbung	尼卡暴动
Sihþ	视知觉
Brycgāðexe	喙頭蜥
Americanisc wera rīcisc fōtballtēam	美國國家足球隊
Maywood, Illinois	梅坞市
Þrēo Coreaniscu Cynerīcu	朝鲜三国时代
Feðer (blæces)	筆
Pening	芬尼
Bryttisca Antarctisca Landscipe	英属南极领地
Starcraft	星际争霸
Seofon dēadlica synna	七宗罪
Zavodovski-īeg	扎沃多夫斯基岛
Finger	中指
Midwearme geardas	温带
Angleseg	安格尔西岛
Niðerseaxisc sprǣc	西低地德语
Māse	山雀科
Caselle Landi	卡塞莱兰迪
Penwiðsteort	兰兹角
Æðelstān Engla Cyning	埃塞尔斯坦
Ras al-Khaimah	拉斯海玛
Elene Constantinoples	聖海倫納
Nintendo DS	任天堂DS
Ēse	阿萨神族
Nīwe Francland	新法蘭西
Englalandes Fana	英格兰国旗
Cyclades	基克拉泽斯
Trafalgar Sǣfeoht	特拉法加海戰
Iosephine Francena Caserin	约瑟芬·德·博阿尔内
Sōlate	向日葵
Cynelica Sciphere	英國皇家海軍
Inbærnes	乳香
Difelinscīr	都柏林地區
Æppelcyrnel (wǣpen)	手榴弹
Helm	盔
Umm Al Quwain	烏姆蓋萬
Nīwes Sǣlandes þēodlīc fōtþōðerhēap	新西蘭國家足球隊
Ingang:Stǣr	Portal:历史
Nonne Etone	納尼頓
Fīfte Cynewīse	第五共和國
The Oval	橢圓球場 (貝爾法斯特)
2010 FIFA Woruldceampscipe	2010年世界盃足球賽
Sunu	兒子
Caltojar	卡尔托哈尔
Grīpfealcen	海东青
Snāwbordfarung	單板滑雪
Ōsgeard	阿斯加德
Glīdflēogung	滑翔伞
Mageoscīr	梅奧郡
Berlanga de Duero	贝尔兰加德杜埃罗
Blizzard Entertainment	暴雪娛樂
Gerinnung	凝血
Dofras	多佛尔
Cannae Beadu	坎尼會戰
Herenuma	战俘
Dȳfung	潜水
Daguerreotype	银版摄影法
Dūnholm	達拉謨
Þrēotīene Landbūnessa	十三殖民地
Brenda Song	布蘭達·宋
Lincoln	林肯 (林肯郡)
Syllīega	锡利群岛
Smallville (TV endebyrdnes)	超人前传
Helen Clark	海伦·克拉克
Būr	房間
Wēala Þēoden	威爾士親王
Scōnīeg	斯科訥
Milanes Bann	米兰敕令 (君士坦丁)
Francforta	熱狗
Gelocen boge	弩
Meremægden	人魚
Wichlawscīr	威克洛郡
Striuelin	史特靈
Æðelred Unrǣd	决策无方者埃塞尔雷德
Twentig Þūsend Lēowena Under þǣm Sǣ	海底两万里
Baius	巴约
Ballōn (lyftcræft)	气球 (航空器)
Colneceaster	科尔切斯特
Meodu	蜂蜜酒
Met (Grammaticcræft)	语气
Sǣelpend	象海豹属
Grytviken	古利德維肯
Fox News	福斯新聞頻道
Brīw	餬
Ēadweard se Ieldra	長者愛德華
Iþacige	伊薩基島
Baius tæpped	贝叶挂毯
Montréal Canadiens	蒙特利尔加拿大人
Underburg	郊區
Sharjah	夏尔迦
Antrimscīr	安特里姆郡
Vigdís Finnbogadóttir	维格迪丝·芬博阿多蒂尔
Final Fantasy	最終幻想系列
Norrena Cyning	挪威君主列表
Westmynster	西敏 (倫敦地區)
Ēadmund Æðeling	埃德蒙一世
Rachel McAdams	瑞秋·麥亞當斯
Fermanagh	弗馬納郡
Dūnscīr	唐郡
E Pluribus Unum	合众为一
Foresittend Franclandes	法国总统
New Jersey Devils	新澤西魔鬼
Philadelphia Flyers	費城飛人
Yun Chi-ho	尹致昊
Sancte Elene Īeg, Upstigeīeg and Tristan da Cunha	圣赫勒拿、阿森松和特里斯坦-达库尼亚
Tirowen	蒂龍郡
Jack Ruby	杰克·鲁比
Ardmachusscīr	阿馬郡
Scene	香农河
Wīnland	文蘭 (紐芬蘭)
Luel	卡萊爾
Ēadgar Engla Cyning	和平者埃德加
Kea	啄羊鹦鹉
Itumbiara	伊通比亚拉
A Night at the Opera	歌劇之夜 (專輯)
Queen (album)	Queen (同名專輯)
Þunres Hamor	妙爾尼爾
Oben am jungen Rhein	在年輕的萊茵河上
Guinness	健力士
Scræfclūdas (Sūþgeorgia)	沙格岩
Łobez	沃貝茲
Liðere	机弦
Thomas Cranmer	托馬斯·克蘭麥
Tawpomere	陶波湖
Universidad de Concepción	康塞普西翁大学
Hameldūn (Nīwe Sǣland)	哈密尔顿 (新西兰)
Stǣr þǣre Worulde	世界歷史
Rēad wulf	紅狼
Normandisca Forcyme	诺曼征服英格兰
Fif Scīr	法夫
Stǣrwrītere	历史学家
Carolina Hurricanes	卡羅來納颶風
Nebrond	宁录
Tampa Bay Lightning	坦帕灣閃電
Scrobbesburh	什魯斯伯里
Fæger hǣr	金髮
Napier (Nīwe Sǣland)	內皮爾 (紐西蘭)
Myrra	沒藥
Harold III Norrena Cyning	无情者哈拉尔
Fisc and styccu	炸鱼薯条
Middeltūn þǣra de Cahaignes	米尔顿凯恩斯
Florida Panthers	佛羅里達美洲豹
Washington Capitals	華盛頓首都
Īrisc fōtþōðer	蓋爾式足球
Nīwes Sǣlandes Þēodlic Stēormǣlhēap	新西兰国家党
West Loðene	西洛锡安
Lonceaster	蘭卡斯特 (蘭開夏郡)
Sūþalpis	南阿爾卑斯山脈
Midloðene	中洛锡安
Neamere	內湖 (英國)
Ēast Loðene	东洛锡安
Fermat tæl	費馬數
Clackmannanscīr	克拉克曼南郡
Liccidfeld	利奇菲爾德
Sūþorcanege	南奥克尼群岛
Rænkīnes hātȝemet	蘭金溫標
Se Fēolagascipe þæs Hringes	魔戒現身
Cod	鱈科
Gold (bleoh)	金色
Holstānburg	西西缪特
Micel Ficgīeg	维提岛
Wrenna	鹪鹩科
Ciricewæl	柯克沃尔
1984 (bōc)	一九八四
Folcaþing	丹麥國民議會
Underset gamen	资料片
Elig	伊利 (劍橋郡)
Getalu burga in Þēodsclande	德国城市列表
Innuendo	Innuendo
The Game	The Game (专辑)
Bancorena burg	班戈
Washington Redskins	华盛顿红皮
Ægelesburg	艾爾斯伯里
Wuldor	烏勒爾
Lāmwic	勒威克
Westgeatland	西約特蘭
Rosenrot	Rosenrot
Wīcinga Ieldu	維京時期
Victory (scip)	勝利號戰艦
Sihhem	納布盧斯
Beatrix Potter	碧雅翠絲·波特
Ēadgar Æðeling	显贵者埃德加
Grēat Rōmisc Fȳr	羅馬大火
Mann	個人
Tollund wer	圖倫男子
Hēapplega	團隊運動
Levanger	莱旺厄尔
Ynce	英寸
Gearwung (plega)	體能鍛煉
Diablo (gamen)	暗黑破坏神 (游戏)
Anggun	安谷
Wīfa rihta forðung	婦女權利
Cham	含姆
Zune	Zune
Nettþōðer	籃網球
In	IN
Diablo	Diablo
Cnut	克努特
Eormengyld Ciles	智利大学
Sēremōnaþ 2007	2007年6月
Offa Miercna Cyning	麦西亚的奥法
Mǣdmōnaþ 2006	2006年7月
Mǣdmōnaþ 2007.	2007年7月
Wēodmōnaþ 2007	2007年8月
Engel	天使
Sasha Cohen	萨莎·科恩
Æðelflǣd	埃塞爾弗萊德
Pat Benatar	佩特·班納塔
Michelle Kwan	关颖珊
Wæstm	农作物
Beate Eriksen	贝亚特·埃里克森
D.C. United	华盛顿特区联
Eowland	厄兰岛
Starcraft II	星海爭霸II：自由之翼
Allan Kardec	亞蘭·卡甸
Diablo III	暗黑破壞神III
Sceadu (gyden)	絲卡蒂
Diablo II	暗黑破壞神II
Atlanta Thrashers	亞特蘭大鶇鳥
The God Delusion	上帝错觉
Canadisc fōtþōðer	加拿大式足球
Ealra Hālgena Ǣfen	万圣夜
Weorcdæg	工時規管
Bān	骨骼
7 World Trade Center	世界貿易中心七號大樓
Vampire Knight	吸血鬼騎士
Wēodmōnaþ 2006	2006年8月
Ælle Sūþseaxna cyning	萨塞克斯的埃尔
Æðelbald West-Seaxna Cyning	威塞克斯的埃塞尔博尔德
Ælfweard West-Seaxes	威塞克斯的埃尔夫沃德
Bēagel	貝果
Rēcels	香
Ūtwyrp	電台廣播
Iapanisc āttorcopplic crabba	甘氏巨螯蟹
Woruldlic Gemōt þāra Ciricena	普世教會協會
Blæcesburg, Virginia	黑堡 (弗吉尼亚州)
Marjorie Estiano	Marjorie Estiano
Ítróttarfelag Fuglafjarðar	IF弗格莱夫乔德
Fotþōðer	足球 (消歧義)
Oresundes brycg	厄勒海峽大橋
Vadillo	巴迪略
Dohtor	女兒
Spell Twēgra Burga	双城记
John Ashcroft	约翰·阿什克罗夫特
Orosius	保卢斯·奥罗修斯
Alexis Tsipras	阿列克西斯·齊普拉斯
Dufenal I Scotta	唐纳德一世
Constontinus I Scotta Cyning	康斯坦丁二世 (皮克特人)
Seolfor (bleoh)	銀色
Philip Jaisohn	徐載弼
Wælheall Herig	瓦尔哈拉神殿
Æbbandūn	泰晤士河畔阿賓頓
Law & Order	法律與秩序
Westmannland	西曼蘭
Moretoin	莫尔坦 (芒什省)
Leaves' Eyes	枯葉之眼
Jeanette Biedermann	珍妮特·貝德曼
Corn Flakes	玉米片
Amol	阿莫勒
Penda Miercna Cyning	麦西亚的彭达
Mælcolm II Scotta Cyning	马尔科姆二世 (苏格兰)
Ēadgar Scotta Cyning	埃德加 (苏格兰国王)
Ofergewiht	超重
Constontinus II Scotta Cyning	康斯坦丁三世 (苏格兰)
Pak Hon-yong	朴宪永
Americanisc frēona rīcisc fōtballtēam	美国国家女子足球队
Mǣdmōnaþ 2005	2005年7月
Winterfylleþ 2005	2005年10月
Berserca	狂戰士
Minoru Yamasaki	山崎實
Almaluez	阿尔马卢埃斯
Pulgara Cyning	保加利亚君主列表
Cuneglæsse	红花琉璃草
Australisca Witenagemōt	澳大利亚国会
Lao	佬族
Wīfel	象鼻蟲
Agalloch	Agalloch
Godspell Mattheus	馬太福音
Ēadweard Cyning Næss	爱德华国王角
Palestinisce Landscipas	巴勒斯坦领土
James Ēa	詹姆斯河
Ȝ	Ȝ
Gærsīeg, Sūþgeorgia	格拉斯島 (南喬治亞群島)
Nazarēth	拿撒勒
Rise of Nations	王国的兴起
Geþingedōm	苏格兰行政区划
Getalu Smallville-belimpdǣla	超人前传集数列表
Kwara Rīce	夸拉州
Windlesōra	溫莎 (伯克郡)
Ēastermōnaþ 2005	2005年4月
Heo Jong-suk	許貞淑
Caroline Zhang	張圓圓
America's Cup	美洲杯帆船赛
Paramore	帕拉莫尔
Recedham	羅奇代爾
Herelic munucregol	军事修会
Ǣȝhnōg	蛋诺类
Coritiba Foot Ball Club	科里蒂巴足球俱乐部
Tansonnhates Geondrīciscum Lyfthæfene	新山一國際機場
Þresc stīele	敲击金属
The Chronicles of Narnia	納尼亞傳奇
Aliud	阿柳德
Iacub Colas	雅克布·科拉斯
Baraona	巴劳纳
James Hetfield	詹姆斯·海特菲尔德
Keane	基音樂團
Medinaceli	梅迪纳塞利
Láchar	拉查尔
Burgo de Osma-Ciudad de Osma	布尔戈德奥斯马-休达德奥斯马
Suellacabras	苏埃利亚卡夫拉斯
Yanguas	伊安瓜斯
Pensacola	彭萨科拉 (佛罗里达州)
San Esteban de Gormaz	圣埃斯特万德戈尔马斯
Barbourscīr, Westvirginia	巴伯縣 (西維吉尼亞州)
Duval Scīr, Florida	杜瓦爾縣 (佛羅里達州)
Hāmtūnscīr Scīr, West Virginia	漢普夏縣 (西維吉尼亞州)
Samsung Galaxy Note	三星Galaxy Note
Perfume	Perfume
Park Jung-yang	朴重陽
Rōwrenoc (Virginia)	羅阿諾克 (維吉尼亞州)
Sūþtūn Hōh	萨顿胡
Tuidi	特威德河
Sǣbeorg	海底山
Dornwaraceaster	多爾切斯特 (多塞特郡)
Chris Pratt	克里斯·普瑞特
Walhshalh	沃爾索爾
Bēdesford, Virginia	貝德福 (維吉尼亞州)
Ēadƿeard Æðeling Scīr, Virginia	愛德華王子縣 (維吉尼亞州)
Cañamaque	卡尼亚马克
Cambihtuc	雞尾鸚鵡
Navaleno	纳瓦莱诺
Hwælsang	鲸歌
Boston Breakers	波士顿开拓者
Wyr, Orcanege	懷爾島 (奧克尼群島)
Dasaratha Maurya	达沙拉沙
Þrīnessunnandæg	聖三一主日
Cannae	坎尼
Olympia-Einkaufszentrum	奥林匹亚购物中心站
Niht (gyden)	諾特 (北歐神話)
Trévago	特雷瓦戈
JavaScript weorcsearu	JavaScript引擎
Dévanos	德瓦诺斯
Læland	洛兰岛
Bukan	布坎
Gemǣne Rīca of Australie	澳大利亚总督
Geþacasteort	撒切爾半島
Grahamland	葛拉漢地
Wikipǣdia:Sceortpæþ	Wikipedia:捷徑
Ólvega	奥尔韦加
Mirai Nagasu	長洲未來
Eormengyld Juraj Dobrila on Pula	普拉大学
Scieppend	創造神
Sybelhūs on Lundne	国宴厅
Beadu þæs Bogn	博因河战役
Minga Guazú	明加瓜蘇
Atari Jaguar	雅达利Jaguar
Smallville (Gēar 4)	超人前传 (第四季)
Hēffe Wehbig	海法·维哈比
Magaña	马加尼亚
Ulfretūn	纽伯里 (伯克郡)
Tæppa	水龍頭
Smallville (Gēar 3)	超人前传 (第三季)
Tīdunghēap	新闻组
Rēan	瀾
Vindicationīeg	溫德凱申島
Negombo	內貢博
Centenera de Andaluz	森特内拉德亚恩达卢斯
Þrimilcemōnaþ 2005	2005年5月
Blecinga īeg	布萊金厄
Lox (catte)	猞猁屬
Gewuldorbeagungīeg (on Sūþorcanege)	科羅內申島
Lǣden-ofgangena stæfrǣwa	衍生拉丁字母
Æfterra Gēola 2005.	2005年1月
Huntandūn	亨廷登
Tomtun	塔姆沃思
City of Heroes	英雄城市
World of Warcraft: Wrath of the Lich King	魔獸世界：巫妖王之怒
Ambihtlicu Cīnisc sprǣc	現代標準漢語
Hwicce	赫威赛王国
Falster	法爾斯特島
Janus (Windows beta)	Windows 3.x
Difelinburg	都柏林城堡
SOX leoht-fæt	钠灯
Madrynhȳð	馬德林港
Solmōnaþ 2005	2005年2月
Hāligmōnaþ 2005	2005年9月
Gawain and se Grēna Cniht	高文爵士与绿骑士
Maroare	摩拉維亞人
Chrono Trigger	时空之轮
Selfrīcsiendlica landbūnessa	自治区
Bellingshausenīeg	別林斯高晉島
Adreminte	短舌匹菊
Stæfford	斯塔福德
Almarza	阿尔马萨
Aldealices	阿尔德亚利塞斯
Aldealafuente	阿尔德亚拉丰特
Alentisque	阿伦蒂斯克
Adradas	阿德拉达斯
Alconaba	阿尔科纳瓦
Abejar	阿韋哈爾
Almajano	阿尔马哈诺
Arenillas	阿雷尼利亚斯
Aldealpozo	阿尔德亚尔波索
Alcubilla de las Peñas	阿尔库维利亚德拉斯佩尼亚斯
Aldealseñor	阿尔德亚尔塞尼奥尔
Alcubilla de Avellaneda	阿尔库维利亚德亚韦利亚内达
Covaleda	科瓦莱达
Casarejos	卡萨雷霍斯
Cerbón	塞尔翁
Calatañazor	卡拉塔尼亚索尔
Almazul	阿尔马苏尔
Cidones	西多内斯
Alpanseque	阿尔潘塞克
Arcos de Jalón	阿尔科斯德哈隆
Aldehuela de Periáñez	阿尔德韦拉德佩里亚涅斯
Beratón	贝拉通
Almenar de Soria	阿尔梅纳尔德索里亚
Maján	马汉 (索里亚省)
Coscurita	科斯库里塔
Barcones	巴尔科内斯
Castilfrío de la Sierra	卡斯蒂尔夫里奥德拉谢拉
Castilruiz	卡斯蒂尔鲁伊斯
Miño de Medinaceli	米尼奥德梅迪纳塞利
Vinuesa	比努埃萨
Cigudosa	西古多萨
Candilichera	坎迪利切拉
Ausejo de la Sierra	奥塞霍德拉谢拉
Carabantes	卡拉万特斯
Soliedra	索列德拉
Taroda	塔罗达
Nepas	内帕斯
Valtajeros	巴尔塔赫罗斯
Arévalo de la Sierra	阿雷瓦洛德拉谢拉
Pozalmuro	波萨尔穆罗
Cabrejas del Pinar	卡夫雷哈斯德尔皮纳尔
Villasayas	比利亚赛阿斯
Cubilla	库维利亚
Castillejo de Robledo	卡斯蒂列霍德罗夫莱多
Escobosa de Almazán	埃斯科沃萨德亚尔马桑
Estepa de San Juan	埃斯特帕德圣胡安
Carrascosa de la Sierra	卡拉斯科萨德拉谢拉
Las Aldehuelas	拉萨尔德韦拉斯
Bayubas de Arriba	上巴尤瓦斯
Borobia	博罗维亚
Bliecos	布列科斯
Buberos	布韦罗斯
Muriel Viejo	穆列尔维耶霍
Oncala	翁卡拉
Fuentecambrón	丰特坎夫龙
Cabrejas del Campo	卡夫雷哈斯德尔坎波
Frechilla de Almazán	弗雷奇利亚德亚尔马桑
Ergo Proxy	死亡代理人
Valdelagua del Cerro	巴尔德拉瓜德尔塞罗
Ciria	西里亚
Buitrago	布伊特拉戈
Talveila	塔尔韦拉
Salduero	萨尔杜埃罗
Fuentes de Magaña	丰特斯德马加尼亚
Viana de Duero	比亚纳德杜埃罗
Tardelcuende	塔尔德尔昆德
Duruelo de la Sierra	杜鲁埃洛德拉谢拉
Bayubas de Abajo	下巴尤瓦斯
Fuentearmegil	丰特亚尔梅希尔
Fuentelmonge	丰特尔蒙赫
Rollamienta	罗利亚缅塔
Villar del Ala	比利亚尔德拉拉
Velilla de los Ajos	贝利利亚德洛萨霍斯
Momblona	蒙夫洛纳
Fresno de Caracena	弗雷斯诺德卡拉塞纳
Valdegeña	巴尔德赫尼亚
Velamazán	贝拉马桑
Torlengua	托尔伦瓜
Fuentecantos	丰特坎托斯
Carrascosa de Abajo	下卡拉斯科萨
Pinilla del Campo	皮尼利亚德尔坎波
Serón de Nágima	塞龙德纳希马
Blacos	布拉科斯
Valdeavellano de Tera	巴尔德亚韦利亚诺德特拉
Narros	纳罗斯
Valdeprado	巴尔德普拉多
Borjabad	博尔哈瓦德
Fuentelsaz de Soria	丰特尔萨斯德索里亚
San Leonardo de Yagüe	圣莱奥纳尔多德阿格
Muriel de la Fuente	穆列尔德拉丰特
Villar del Río	比利亚尔德尔里奥
Valderrodilla	巴尔德罗迪利亚
Espejón	埃斯佩洪
Liceras	利塞拉斯
Matalebreras	马塔莱夫雷拉斯
Quintana Redonda	金塔纳雷东达
Nafría de Ucero	纳夫里亚德乌塞罗
Sotillo del Rincón	索蒂略德尔林孔
Torrubia de Soria	托鲁维亚德索里亚
Noviercas	诺维耶尔卡斯
Tajueco	塔胡埃科
Valdenebro	巴尔德内夫罗
Villaciervos	比利亚希耶尔沃斯
Villanueva de Gormaz	戈尔马斯新镇
Yelo	耶洛
Montenegro de Cameros	蒙特内格罗德卡梅罗斯
Ucero	乌塞罗
Langa de Duero	兰加德杜埃罗
Quiñonería	基尼奥内里亚
Villar del Campo	比利亚尔德尔坎波
Portillo de Soria	波尔蒂略德索里亚
Gormaz	戈尔马斯
Santa Cruz de Yanguas	圣克鲁斯德安瓜斯
Villaseca de Arciel	比利亚塞卡德亚尔希耶尔
Reznos	雷斯诺斯
Cueva de Ágreda	库埃瓦德亚格雷达
Nolay	诺莱 (索里亚省)
Cirujales del Río	西鲁哈莱斯德尔里奥
Caracena	卡拉塞纳
Cubo de la Solana	库沃德拉索拉纳
Miño de San Esteban	米尼奥德圣埃斯特万
Fuentestrún	丰特斯特伦
Espeja de San Marcelino	埃斯佩哈德圣马尔塞利诺
Matamala de Almazán	马塔马拉德亚尔马桑
La Póveda de Soria	拉波韦达德索里亚
Los Rábanos	洛斯拉瓦诺斯
Quintanas de Gormaz	金塔纳斯德戈尔马斯
Santa María de Huerta	圣马里亚德韦尔塔
San Pedro Manrique	圣佩德罗曼里克
Velilla de la Sierra	贝利利亚德拉谢拉
Valdemaluque	巴尔德马卢克
San Felices	圣费利塞斯
Renieblas	雷涅夫拉斯
Morón de Almazán	莫龙德亚尔马桑
Los Villares de Soria	洛斯维利亚雷斯德索里亚
Torreblacos	托雷夫拉科斯
Vizmanos	比斯马诺斯
Tejado	特哈多
Retortillo de Soria	雷托尔蒂略德索里亚
Herrera de Soria	埃雷拉德索里亚
Deza	德萨
Monteagudo de las Vicarías	蒙特亚古多德拉斯维卡里亚斯
La Riba de Escalote	拉里瓦德埃斯卡洛特
Montejo de Tiermes	蒙特霍德铁尔梅斯
La Losilla	拉洛西利亚
Recuerda	雷库埃尔达
Tajahuerce	塔哈韦尔塞
Santa María de las Hoyas	圣马里亚德拉斯奥亚斯
Fuentepinilla	丰特皮尼利亚
Golmayo	戈尔迈奥
Rioseco de Soria	里奥塞科德索里亚
Gómara	戈马拉
Stromnæs	斯特罗姆内斯
Rōmānisc Cāsere	羅馬皇帝
Weogornaceasterscīrsēaw	辣醬油
Picilemwes eorþbeofung 2010 gēares	2010年智利披市勒亩地震
Getalu ambihtlicra sprǣca	官方语言列表
Worulde Fanan	世界旗帜网
Hafoc	鹰
Dēaðas in 2005. gēare	2005年逝世人物列表
York University	约克大学 (加拿大)
Hrēþmōnaþ 2005	2005年3月
Grēnelandes Norren sprǣc	格陵蘭諾爾斯語
Gēolmōnaþ 2004	2004年12月
Brytenwealda	不列颠统治者
Winterfylleþ 2004	2004年10月
Sǣearmlandes Rīcisc Edisc	峡湾国家公园
Port Authority of New York and New Jersey	紐約與新澤西港口事務管理局
Getalu īega be landware	岛屿列表 (按人口)
Denisc and Norþwegisc stæfrǣw	丹麦语和挪威语字母
Street Fighter IV	街頭霸王IV
Help:Innoþ	Help:目录
Wikipǣdia:Tutorial	Wikipedia:新手入門/參與
Wīntrēow	攀緣植物
Brycgstōwīeg	布里斯托爾島
Witch Hunter Robin	禁獵魔女
Smallville (Gēar 5)	超人前传 (第五季)
Oenoīeg	奧埃諾島
3 World Trade Center	世界貿易中心三號大樓
Landa getalu be lēodweardcynne	各國政體列表
Granta	康河
Los Angeles Sol	洛杉矶太阳
Hāligmōnaþ 2006	2006年9月
Hrodulf se rēadnosoda hrāndēor	紅鼻子馴鹿魯道夫
Molinos de Duero	莫利诺斯德杜埃罗
Vozmediano	博斯梅迪亚诺
Hinojosa del Campo	伊诺霍萨德尔坎波
Elpendīeg	象岛 (南极洲)
Getæl īega	岛屿列表
Elenesburh	海倫斯堡
Walhshalh Weald	华捷伍德
Gēatland	哥得蘭島
Būc	胃
Candelmæssanīeg	坎德爾默斯島
Loppestre	海螯蝦
Blōtmōnaþ 2004	2004年11月
Sculdorscēotend	長管槍械
Nīwes Sǣlandes Weorces Stēormǣlhēap	新西兰工党
Unicron	尤尼克隆
Simeon II Pulgara Cyning	西美昂二世·萨克森-科堡-哥达斯基
Cutey Honey	甜心戰士
Clarenceīeg, Sūþhjaltland	克拉倫斯島 (南極洲)
Umm Culþþūm	烏姆·庫勒蘇姆
Tenercebrai	坦谢布赖 (奥恩省)
2 World Trade Center	世界貿易中心二號大樓
Cōcīeg (þāra Sūþsandwic Īeglanda)	庫克島 (南桑威奇群島)
Cooperīeg	庫珀島
Gemyndigung Twintorra	九一一國家紀念博物館
Froggmann	蛙人
Beadu Omdurmanes	恩圖曼戰役
Ƿ	Ƿ
Lundene Foreweard (1839.)	1839年伦敦条约
Elisabeþ Cwēn Land	伊利沙伯女皇地
Wikipǣdia:Ambihtsecghof	Wikipedia:大使館
National Hockey League	國家冰球聯盟
Frōm	弗罗姆
Flyhthæfen	機場
Sandeg, Orcanege	桑迪島 (奧克尼群島)
Egilseg	埃吉爾賽島
Leskovīeg	列斯科夫島
Love Machine (sang)	LOVE MACHINE
Stǣrlice gemynddagas	历史上的今天
Pecland	峰区
4 World Trade Center	世界貿易中心四號大樓
Women's Professional Soccer	美国女子足球职业联赛
Sǣweardþrēat	海岸巡防隊
Agnes Monica	杨诗曼
Montaguīeg	蒙塔古島
Windlesōra and Mægdenhȳþ	溫莎-梅登黑德
Evile	Evile
Flocc:Ƿeras	Category:男性
Flocc:Ƿīf	Category:女性人物
Flocc:Þēodscland	Category:德国
Flocc:Italia	Category:意大利
Flocc:Geānedu Rīcu American	Category:美国
Flocc:Russland	Category:俄罗斯
Flocc:Canada	Category:加拿大
Flocc:Geānede Cynerīce	Category:英国
Flocc:Spēonland	Category:西班牙
Flocc:Cīna	Category:中国
Flocc:Iapan	Category:日本
Flocc:Australia	Category:澳大利亚
Flocc:Mexico	Category:墨西哥
Flocc:Indea	Category:印度
Flocc:Saudisc Arabea	Category:沙烏地阿拉伯
Flocc:Israhēl	Category:以色列
Flocc:Turcland	Category:土耳其
Flocc:Sūðaffrica	Category:南非
Flocc:Ǣgypt	Category:埃及
Flocc:Persealand	Category:伊朗
Flocc:Nīwe Sǣland	Category:新西兰
Flocc:Argentina	Category:阿根廷
Traversayīega	特拉韋賽群島
Flocc:Afghanistan	Category:阿富汗
Flocc:Algeria	Category:阿爾及利亞
Flocc:Ēastrīce	Category:奧地利
Flocc:Bangladesc	Category:孟加拉国
Flocc:Cūba	Category:古巴
Flocc:Sigelhearwenaland	Category:衣索比亞
Flocc:Indonesia	Category:印尼
Flocc:Irac	Category:伊拉克
Flocc:Niðerland	Category:荷兰
Flocc:Nigeria	Category:奈及利亞
Flocc:Pacistan	Category:巴基斯坦
Flocc:Pōlaland	Category:波蘭
Flocc:Portugal	Category:葡萄牙
Flocc:Sudan	Category:苏丹
Flocc:Tansania	Category:坦尚尼亞
Flocc:Ucrægna	Category:烏克蘭
Flocc:Fietnam	Category:越南
Flocc:Rōmānisc Cāsere	Category:罗马帝国
Flocc:Sycedēor	Category:哺乳類
Flocc:Fugolas	Category:鸟类
Flocc:Plantan	Category:植物
Flocc:Stǣr	Category:历史
Flocc:Ferscipe	Category:社会
Flocc:Gelēafan	Category:宗教
Flocc:Plegan	Category:体育
Flocc:Eorþ	Category:地球
Victor Iusccenco	維克多·安德烈耶維奇·尤先科
Thila-īeg	圖勒島
Palmerland	帕爾默地
Pagetbeorg	帕吉特山
Handfisc	臂鈎躄魚科
MTB	魚雷快艇
Īsensmiþ	鐵匠
Visokoi-īeg	維索科伊島
Willisīega	威利斯群島
Wiogoraceastre	伍斯特
Mōr	酸沼
Pickersgillīega	皮克斯吉爾群島
Três Pontas	特雷斯蓬塔斯
Saundersīeg	桑德斯島
Ānlāfes Æþelinges Hæfen	奧拉夫王子港
Sydneycofa	悉尼灣
Kupriyanovīega	庫普里亞諾夫群島
Smith & Wesson 500	史密斯威森M500左輪手槍
Hwæl	鯨
Flocc:Scīrung	Category:消歧义
Flocc:Olympisc Gamen	Category:奥林匹克运动会
Flocc:Crīstendōm	Category:基督教
Flocc:Alladōm	Category:伊斯兰教
Decatur	迪凯特号驱逐舰
Wilcumanīega	韋爾科姆群島
Ammomanes	漠百灵属
Ātmǣl	燕麥片
Earn	鵰
Scyrte	裙
Irac Cyning	伊拉克国王
Elpend	象科
Elworuldontygenes	另類全球化運動
Sceota	鱒
Þēodacynewīse Dæg	英聯邦日
Flocc:Styccelicu gewritu	Category:小作品
Flocc:Wikipedia categorization	Category:維基百科分類
Flocc:Sidaþing	Category:文化
Flocc:Gēar	Category:年
Flocc:Worulddǣl	Category:大洲
Flocc:Lyftcræftas	Category:航空器
Nexus: The Jupiter Incident	银河创世纪：木星事件
Wikipǣdia:Gecorene gemynddagas	Wikipedia:历史上的今天
Wikipǣdia:Tutorial (Editing)	Wikipedia:新手入門/編輯
Bysen:Stēorungsunnanendebyrdnes	Template:太阳系
Wikipǣdia:Wikibōceras	Wikipedia:維基百科人
Scearseax	刮鬍刀
Wikipǣdia:Recentchanges	Help:最近更改
Basu	紫色
Bysen:Succession box	Template:Succession box
Flocc:Flēogeball	Category:排球
Flocc:Wikipedia bots	Category:維基百科機器人
Ened	鸭
Hwīt Draca	白龍 (撒克遜)
Bysen:Cquote	Template:Quote
Flocc:Þēodisc	Category:德国人
Flocc:Land	Category:国家
Catherine	凱瑟琳
Wikipǣdia:Bewitendas	Wikipedia:管理员
Flocc:Lēode	Category:人物
Wikipǣdia:Bēna tō and fram bewitendhāde	Wikipedia:申请成为管理人员
Flocc:Tīd	Category:时间
Flocc:Bodiȝlār	Category:解剖学
Wikipǣdia:Betwuxsprǽclice bendas	Help:跨语言链接
Flocc:Leornung	Category:教育
Cyningesbeorg	柯尼斯堡
Ægypt	埃及
Yulia Lipnitskaya	尤利婭·利普尼茨卡婭
Flocc:Ūtwitan	Category:哲学家
Bysen:Bot	Template:Bot
Wikipǣdia:Hwæt Wikipǣdia Nis	Wikipedia:维基百科不是什么
Canada	加拿大
Flocc:Ungerland	Category:匈牙利
Flocc:Belgice	Category:比利時
Flocc:Cipros	Category:賽普勒斯
Flocc:Cecland	Category:捷克
Flocc:Denemearc	Category:丹麥
Flocc:Estland	Category:爱沙尼亚
Flocc:Finnland	Category:芬蘭
Flocc:Crecaland	Category:希腊
Flocc:Lettland	Category:拉脫維亞
Flocc:Īsland	Category:冰島
Flocc:Letseburg	Category:卢森堡
Flocc:Liþuania	Category:立陶宛
Flocc:Melita	Category:馬爾他
Flocc:Swēoland	Category:瑞典
Flocc:Slofacia	Category:斯洛伐克
Flocc:Īrland Cynewīse	Category:爱尔兰
Flocc:Fulgōd ȝeƿritu	Category:特色条目
Flocc:Spærcletelle gamen	Category:电子游戏
Heofon	天國
Fresland	弗里西亞
Flocc:Microsoft	Category:微軟
Wikipǣdia:Edit summary	Wikipedia:編輯摘要
Bysen:Flagicon	Template:Flagicon
Flocc:Land on Europan	Category:欧洲国家
Flocc:Europe	Category:欧洲
Flocc:Wikipedia:Help	Category:帮助文档
Help:Mōtungtramet	Wikipedia:讨论页
Wikipǣdia:Efenealde belimpas	Portal:新聞動態
Bysen:Documentation	Template:Documentation
Wikipǣdia:Protected pages	Wikipedia:保護方針
Flocc:Wikibōceras	Category:维基人
Wikipǣdia:Gemǣnscipes Ingang	Wikipedia:社群首页
Flocc:Brūcendsprǣc	Category:用户语言
Wikipǣdia:Fīf styde	Wikipedia:五大支柱
Wikipǣdia:Ānsund styccegewrit	Wikipedia:小作品
Wikipǣdia:Bealu	Wikipedia:破坏
Sung Jae-ki	成在基
Sundorrīcesdæg	獨立日
Bysen:Softredirect	Template:軟重定向
Bysen:Delete	Template:Delete
Snægel	腹足纲
Bryttisce Wealdendas	英国君主列表
Flocc:Searucræft	Category:技术
Flocc:Sprǣca	Category:语言
Flocc:Gerīmbōc	Category:曆法
Flocc:Hāliȝdagas	Category:假日
Help:Onbregdan nīwne tramet	Help:创建新条目
Flocc:Wikipǣdia	Category:维基百科
Flocc:Unȝebēacniende trametas	Category:不可索引页面
Flocc:Pages with broken file links	Category:缺少文件的页面
Wikipǣdia:Manual of Style	Wikipedia:格式手册
Bysen:-	Template:-
Bysen:Navbox	Template:Navbox
Handspearctellend	移动设备
Flocc:Byrig on Persum	Category:伊朗城市
Ēadweard Cyning Cofa	愛德華七世灣
Bysen:Sēðung þurfed	Template:Fact
Angelfresisca sprǣca	盎格鲁-弗里西语组
Flocc:Fana bysen	Category:旗帜模板
Bysen:((	Template:((
Bysen:!-	Template:!-
Bysen:!!	Template:!!
Bysen:=	Template:=
Bysen:Navbar	Template:Navbar
Bysen:Unicode	Template:Unicode
Bysen:E	Template:Exp10
Bysen:Clear	Template:Clear
Bysen:Col-break	Template:Col-break
Bysen:Col-begin	Template:Col-begin
Bysen:Col-end	Template:Col-end
Bysen:Color	Template:Color
Bysen:Anchor	Template:Anchor
Wikipǣdia:List of articles all languages should have	Wikipedia:基礎條目
Flocc:Affrica	Category:非洲
Flocc:Mǣdmōnaþ	Category:7月
Flocc:Þorpas	Category:村落
Flocc:Bēc	Category:書籍
Flocc:Mōnþas	Category:月份
Bysen:Wikisource	Template:Wikisource
Bysen:Babel	Template:Babel
Bysen:Commons	Template:Commons
Bysen:Link GA	Template:Link GA
Bysen:Reflist	Template:Reflist
Bysen:NavPeriodicTable	Template:NavPeriodicTable
Wikipǣdia:Fulgōdra gewrita hwætgōdnesse	Wikipedia:特色條目標準
Bysen:Stycce	Template:Stub
Bysen:Brūcend de	Template:User de
Bysen:Brūcend de-1	Template:User de-1
Bysen:Brūcend el	Template:User el
Bysen:Brūcend es	Template:User es
Bysen:Brūcend de-3	Template:User de-3
Bysen:Brūcend en-3	Template:User en-3
Bysen:Brūcend el-1	Template:User el-1
Bysen:Brūcend en-1	Template:User en-1
Bysen:Brūcend en-2	Template:User en-2
Bysen:Brūcend eo-2	Template:User eo-2
Bysen:Brūcend en-4	Template:User en-4
Bysen:Brūcend fi	Template:User fi
Bysen:Brūcend en-0	Template:User en-0
Bysen:Brūcend es-4	Template:User es-4
Bysen:Brūcend en	Template:User en
Bysen:Brūcend de-2	Template:User de-2
Bysen:Brūcend es-1	Template:User es-1
Bysen:Brūcend fi-1	Template:User fi-1
Bysen:Brūcend fr-1	Template:User fr-1
Flocc:Līf	Category:生命
Bysen:Brūcend he-2	Template:User he-2
Bysen:Brūcend it-3	Template:User it-3
Bysen:User sk	Template:User sk
Bysen:Brūcend fr-2	Template:User fr-2
Bysen:Brūcend ja	Template:User ja
Bysen:Brūcend ja-1	Template:User ja-1
Bysen:Brūcend it-1	Template:User it-1
Bysen:Brūcend fr	Template:User fr
Cosco	庫斯科
Flocc:Solmōnaþ	Category:2月
Flocc:1949	Category:1949年
Bysen:Stedefindend scite/Writ	Template:Location map/Info
Flocc:Ceorfdēor	Category:昆蟲綱
Bysen:Fs mid	Template:Football squad mid
Flocc:Asia	Category:亚洲
Flocc:Cile	Category:智利
Flocc:21e gēarhundred	Category:21世纪
Flocc:Lesotho	Category:莱索托
Flocc:Brūcend uk	Category:Uk 使用者
Flocc:Sūðamerica	Category:南美洲
Flocc:Brūcend uk-M	Category:Uk 母語使用者
Flocc:1918	Category:1918年
Flocc:1954	Category:1954年
Flocc:Ǣt	Category:食品
Flocc:1946	Category:1946年
Bysen:Fs player	Template:Football squad player
Flocc:Gyldfōtþōðer	Category:足球
Flocc:1945	Category:1945年
Bysen:Mod	Template:Mod
Flocc:1926	Category:1926年
Bysen:NowCommons	Template:NowCommons
Bysen:Brūcend sv	Template:User sv
Flocc:1920	Category:1920年
Bysen:Brūcend it	Template:User it
Bysen:Brūcend uk	Template:User uk
Bysen:Brūcend es-2	Template:User es-2
Bysen:Infobox Football club	Template:Infobox football club
Bysen:Welcome	Template:Welcome
Flocc:Bysen mid ūtweardum hlence	Category:外部资源模板
Bysen:Country data Slovakia	Template:Country data Slovakia
Bysen:Country data Czech Republic	Template:Country data Czech Republic
Bysen:Country data Honduras	Template:Country data Honduras
Bysen:Country data Bolivia	Template:Country data Bolivia
Bysen:Country data Denemearc	Template:Country data Denmark
Bysen:Country data Īsland	Template:Country data Iceland
Bysen:Country data Poland	Template:Country data Poland
Bysen:Scire in Irlande	Template:愛爾蘭行政區劃
Bysen:Click	Template:Click
Bysen:Wikivar	Template:Wikivar
Flocc:Brūcend fr-1	Category:Fr-1 使用者
Bysen:Country data Norway	Template:Country data Norway
Bysen:Wikiquote	Template:Wikiquote
Bysen:Country showdata	Template:Country showdata
Bysen:Country data Mexico	Template:Country data Mexico
Bysen:Affrica	Template:Africa
Bysen:Infobox television	Template:电视节目信息框
Flocc:Americisc Awendung Wig	Category:美國革命
Bysen:FWB	Template:FWB
Bysen:IUCN2008	Template:IUCN2008
Bysen:Geānedu Rīcu American	Template:美国行政区划
Bysen:Country data Australia	Template:Country data Australia
Bysen:Cyþþubox ieg	Template:Infobox islands
Bysen:Country data France	Template:Country data France
Bysen:Ambox	Template:Ambox
Flocc:Americanisc stǣr	Category:美國歷史
Bysen:Fossil range/bar	Template:Fossil range/bar
Bysen:Rnd	Template:Rnd
Bysen:Infobox Country	Template:國家基礎資訊
Bysen:Max	Template:Max
Bysen:Country data Austria	Template:Country data Austria
Bysen:Infobox Mīlitisc Gemōt	Template:Infobox Military Conflict
Bysen:Documentation/docname	Template:Documentation/docname
Bysen:Country data Finland	Template:Country data Finland
Wikipǣdia:Tutorial (Wikipedia links)	Wikipedia:新手入門/維基文本
Bysen:Country data Japan	Template:Country data Japan
Bysen:Start box	Template:Start
Bysen:Infobox U.S. Scīr	Template:Infobox U.S. County
Bysen:Cleanup	Template:Cleanup
Flocc:Crabbas	Category:螃蟹
Bysen:Cite journal	Template:Cite journal
Bysen:Xpd	Template:Xpd
Bysen:Lang-ar	Template:Lang-ar
Bysen:Brūcend es-0	Template:User es-0
Bysen:Cite news	Template:Cite news
Bysen:Featured article	Template:Featured article
Bysen:Country data Russia	Template:Country data Russia
Flocc:Paris	Category:巴黎
Flocc:Brūcend en-4	Category:En-4 使用者
Flocc:Brūcend en	Category:En 使用者
Flocc:Croatia	Category:克罗地亚
Flocc:Brūcend en-2	Category:En-2 使用者
Bysen:Infobox	Template:Infobox
Bysen:Main other	Template:Main other
Bysen:Image class names	Template:Image class names
Flocc:Stafas	Category:字母文字
Bysen:Documentation/start box	Template:Documentation/start box
Bysen:Documentation/end box2	Template:Documentation/end box2
Wikipǣdia:Gecorene gemynddagas/23 Hāligmōnaþ	Wikipedia:历史上的今天/9月23日
Bysen:Documentation/start box2	Template:Documentation/start box2
Bysen:Template other	Template:Template other
Wikipǣdia:Gecorene gemynddagas/4 Solmōnaþ	Wikipedia:历史上的今天/2月4日
Wikipǣdia:Gecorene gemynddagas/22 Hāligmōnaþ	Wikipedia:历史上的今天/9月22日
Bysen:Lang-da	Template:Lang-da
Wikipǣdia:Gecorene gemynddagas/30 Blōtmōnaþ	Wikipedia:历史上的今天/11月30日
Wikipǣdia:Gecorene gemynddagas/18 Solmōnaþ	Wikipedia:历史上的今天/2月18日
Wikipǣdia:Gecorene gemynddagas/28 Æfterra Gēola	Wikipedia:历史上的今天/1月28日
Bysen:Legend	Template:Legend
Wikipǣdia:Gecorene gemynddagas/14 Æfterra Gēola	Wikipedia:历史上的今天/1月14日
Wikipǣdia:Gecorene gemynddagas/25 Solmōnaþ	Wikipedia:历史上的今天/2月25日
Wikipǣdia:Gecorene gemynddagas/10 Wēodmōnaþ	Wikipedia:历史上的今天/8月10日
Flocc:Bryttisce wrīteras	Category:英国作家
Wikipǣdia:Gecorene gemynddagas/15 Winterfylleþ	Wikipedia:历史上的今天/10月15日
Wikipǣdia:Gecorene gemynddagas/31 Wēodmōnaþ	Wikipedia:历史上的今天/8月31日
Wikipǣdia:Gecorene gemynddagas/12 Blōtmōnaþ	Wikipedia:历史上的今天/11月12日
Wikipǣdia:Gecorene gemynddagas/30 Mǣdmōnaþ	Wikipedia:历史上的今天/7月30日
Wikipǣdia:Gecorene gemynddagas/3 Wēodmōnaþ	Wikipedia:历史上的今天/8月3日
Wikipǣdia:Gecorene gemynddagas/27 Wēodmōnaþ	Wikipedia:历史上的今天/8月27日
Bysen:Cite web	Template:Cite web
Wikipǣdia:Gecorene gemynddagas/21 Æfterra Gēola	Wikipedia:历史上的今天/1月21日
Wikipǣdia:Gecorene gemynddagas/8 Solmōnaþ	Wikipedia:历史上的今天/2月8日
Bysen:Country data Italy	Template:Country data Italy
Wikipǣdia:Gecorene gemynddagas/20 Æfterra Gēola	Wikipedia:历史上的今天/1月20日
Wikipǣdia:Gecorene gemynddagas/23 Æfterra Gēola	Wikipedia:历史上的今天/1月23日
Wikipǣdia:Gecorene gemynddagas/28 Hāligmōnaþ	Wikipedia:历史上的今天/9月28日
Bysen:Imdb title	Template:Imdb title
Wikipǣdia:Gecorene gemynddagas/31 Gēolmōnaþ	Wikipedia:历史上的今天/12月31日
Wikipǣdia:Gecorene gemynddagas/1 Solmōnaþ	Wikipedia:历史上的今天/2月1日
Wikipǣdia:Gecorene gemynddagas/14 Gēolmōnaþ	Wikipedia:历史上的今天/12月14日
Wikipǣdia:Gecorene gemynddagas/25 Æfterra Gēola	Wikipedia:历史上的今天/1月25日
Wikipǣdia:Gecorene gemynddagas/6 Wēodmōnaþ	Wikipedia:历史上的今天/8月6日
Wikipǣdia:Gecorene gemynddagas/24 Wēodmōnaþ	Wikipedia:历史上的今天/8月24日
Wikipǣdia:Gecorene gemynddagas/9 Blōtmōnaþ	Wikipedia:历史上的今天/11月9日
Wikipǣdia:Gecorene gemynddagas/18 Æfterra Gēola	Wikipedia:历史上的今天/1月18日
Wikipǣdia:Gecorene gemynddagas/17 Wēodmōnaþ	Wikipedia:历史上的今天/8月17日
Wikipǣdia:Gecorene gemynddagas/27 Mǣdmōnaþ	Wikipedia:历史上的今天/7月27日
Flocc:Stǣr þæs Geānedan Cynerīces	Category:不列顛群島歷史
Bysen:Country data	Template:Country data
Wikipǣdia:Gecorene gemynddagas/20 Wēodmōnaþ	Wikipedia:历史上的今天/8月20日
Wikipǣdia:Gecorene gemynddagas/1 Winterfylleþ	Wikipedia:历史上的今天/10月1日
Wikipǣdia:Gecorene gemynddagas/5 Winterfylleþ	Wikipedia:历史上的今天/10月5日
Wikipǣdia:Gecorene gemynddagas/8 Winterfylleþ	Wikipedia:历史上的今天/10月8日
Wikipǣdia:Talk page	Wikipedia:討論頁指導
Wikipǣdia:Gecorene gemynddagas/15 Solmōnaþ	Wikipedia:历史上的今天/2月15日
Bysen:Coor URL	Template:MapsServer
Bysen:Notice	Template:Notice
Bysen:Pp-template	Template:Pp-template
Bysen:·	Template:·
Bysen:Brūcend nl-1	Template:User nl-1
Bysen:Infobox Winodland	Template:Infobox Polska
Bysen:Min	Template:Min
Bysen:Wiktionarypar2	Template:Wiktionary
Bysen:Brūcend nl-2	Template:User nl-2
Bysen:Infobox Ice Hockey Player	Template:Infobox Ice Hockey Player
Bysen:Lang-enm	Template:Lang-enm
Bysen:Country data Sweden	Template:Country data Sweden
Flocc:Byrig on Dēnum	Category:丹麥城市
Bysen:Lang-ang	Template:Lang-ang
Flocc:Eorþtilþ	Category:农业
Wikipǣdia:Gecorene gemynddagas/26 Blōtmōnaþ	Wikipedia:历史上的今天/11月26日
Wikipǣdia:Gecorene gemynddagas/26 Wēodmōnaþ	Wikipedia:历史上的今天/8月26日
Wikipǣdia:Gecorene gemynddagas/12 Gēolmōnaþ	Wikipedia:历史上的今天/12月12日
Wikipǣdia:Gecorene gemynddagas/25 Gēolmōnaþ	Wikipedia:历史上的今天/12月25日
Wikipǣdia:Gecorene gemynddagas/10 Æfterra Gēola	Wikipedia:历史上的今天/1月10日
Wikipǣdia:Gecorene gemynddagas/31 Æfterra Gēola	Wikipedia:历史上的今天/1月31日
Wikipǣdia:Gecorene gemynddagas/6 Winterfylleþ	Wikipedia:历史上的今天/10月6日
Wikipǣdia:Gecorene gemynddagas/6 Hrēþmōnaþ	Wikipedia:历史上的今天/3月6日
Wikipǣdia:Gecorene gemynddagas/18 Hrēþmōnaþ	Wikipedia:历史上的今天/3月18日
Wikipǣdia:Gecorene gemynddagas/17 Winterfylleþ	Wikipedia:历史上的今天/10月17日
Wikipǣdia:Gecorene gemynddagas/27 Hrēþmōnaþ	Wikipedia:历史上的今天/3月27日
Wikipǣdia:Gecorene gemynddagas/19 Hrēþmōnaþ	Wikipedia:历史上的今天/3月19日
Wikipǣdia:Gecorene gemynddagas/2 Winterfylleþ	Wikipedia:历史上的今天/10月2日
Wikipǣdia:Gecorene gemynddagas/2 Mǣdmōnaþ	Wikipedia:历史上的今天/7月2日
Wikipǣdia:Gecorene gemynddagas/10 Hrēþmōnaþ	Wikipedia:历史上的今天/3月10日
Wikipǣdia:Gecorene gemynddagas/1 Ēastermōnaþ	Wikipedia:历史上的今天/4月1日
Wikipǣdia:Gecorene gemynddagas/31 Mǣdmōnaþ	Wikipedia:历史上的今天/7月31日
Wikipǣdia:Gecorene gemynddagas/12 Wēodmōnaþ	Wikipedia:历史上的今天/8月12日
Wikipǣdia:Gecorene gemynddagas/26 Solmōnaþ	Wikipedia:历史上的今天/2月26日
Wikipǣdia:Gecorene gemynddagas/17 Mǣdmōnaþ	Wikipedia:历史上的今天/7月17日
Wikipǣdia:Gecorene gemynddagas/5 Wēodmōnaþ	Wikipedia:历史上的今天/8月5日
Wikipǣdia:Gecorene gemynddagas/16 Hāligmōnaþ	Wikipedia:历史上的今天/9月16日
Wikipǣdia:Gecorene gemynddagas/31 Winterfylleþ	Wikipedia:历史上的今天/10月31日
Wikipǣdia:Gecorene gemynddagas/12 Solmōnaþ	Wikipedia:历史上的今天/2月12日
Wikipǣdia:Gecorene gemynddagas/15 Æfterra Gēola	Wikipedia:历史上的今天/1月15日
Wikipǣdia:Gecorene gemynddagas/19 Hāligmōnaþ	Wikipedia:历史上的今天/9月19日
Wikipǣdia:Gecorene gemynddagas/16 Æfterra Gēola	Wikipedia:历史上的今天/1月16日
Wikipǣdia:Gecorene gemynddagas/13 Mǣdmōnaþ	Wikipedia:历史上的今天/7月13日
Wikipǣdia:Gecorene gemynddagas/2 Æfterra Gēola	Wikipedia:历史上的今天/1月2日
Wikipǣdia:Gecorene gemynddagas/9 Mǣdmōnaþ	Wikipedia:历史上的今天/7月9日
Wikipǣdia:Gecorene gemynddagas/10 Solmōnaþ	Wikipedia:历史上的今天/2月10日
Wikipǣdia:Gecorene gemynddagas/5 Hrēþmōnaþ	Wikipedia:历史上的今天/3月5日
Wikipǣdia:Gecorene gemynddagas/29 Sēremōnaþ	Wikipedia:历史上的今天/6月29日
Wikipǣdia:Gecorene gemynddagas/14 Blōtmōnaþ	Wikipedia:历史上的今天/11月14日
Wikipǣdia:Gecorene gemynddagas/6 Æfterra Gēola	Wikipedia:历史上的今天/1月6日
Wikipǣdia:Gecorene gemynddagas/18 Mǣdmōnaþ	Wikipedia:历史上的今天/7月18日
Wikipǣdia:Gecorene gemynddagas/23 Mǣdmōnaþ	Wikipedia:历史上的今天/7月23日
Wikipǣdia:Gecorene gemynddagas/1 Mǣdmōnaþ	Wikipedia:历史上的今天/7月1日
Wikipǣdia:Gecorene gemynddagas/20 Gēolmōnaþ	Wikipedia:历史上的今天/12月20日
Wikipǣdia:Gecorene gemynddagas/30 Wēodmōnaþ	Wikipedia:历史上的今天/8月30日
Wikipǣdia:Gecorene gemynddagas/11 Wēodmōnaþ	Wikipedia:历史上的今天/8月11日
Wikipǣdia:Gecorene gemynddagas/9 Wēodmōnaþ	Wikipedia:历史上的今天/8月9日
Wikipǣdia:Gecorene gemynddagas/29 Blōtmōnaþ	Wikipedia:历史上的今天/11月29日
Wikipǣdia:Gecorene gemynddagas/2 Ēastermōnaþ	Wikipedia:历史上的今天/4月2日
Wikipǣdia:Gecorene gemynddagas/12 Mǣdmōnaþ	Wikipedia:历史上的今天/7月12日
Wikipǣdia:Gecorene gemynddagas/29 Wēodmōnaþ	Wikipedia:历史上的今天/8月29日
Wikipǣdia:Gecorene gemynddagas/24 Sēremōnaþ	Wikipedia:历史上的今天/6月24日
Wikipǣdia:Gecorene gemynddagas/25 Blōtmōnaþ	Wikipedia:历史上的今天/11月25日
Wikipǣdia:Gecorene gemynddagas/21 Wēodmōnaþ	Wikipedia:历史上的今天/8月21日
Wikipǣdia:Gecorene gemynddagas/29 Mǣdmōnaþ	Wikipedia:历史上的今天/7月29日
Wikipǣdia:Gecorene gemynddagas/29 Æfterra Gēola	Wikipedia:历史上的今天/1月29日
Wikipǣdia:Gecorene gemynddagas/5 Gēolmōnaþ	Wikipedia:历史上的今天/12月5日
Wikipǣdia:Gecorene gemynddagas/25 Hrēþmōnaþ	Wikipedia:历史上的今天/3月25日
Wikipǣdia:Gecorene gemynddagas/22 Hrēþmōnaþ	Wikipedia:历史上的今天/3月22日
Wikipǣdia:Gecorene gemynddagas/9 Hrēþmōnaþ	Wikipedia:历史上的今天/3月9日
Wikipǣdia:Gecorene gemynddagas/12 Hrēþmōnaþ	Wikipedia:历史上的今天/3月12日
Wikipǣdia:Gecorene gemynddagas/11 Hrēþmōnaþ	Wikipedia:历史上的今天/3月11日
Wikipǣdia:Gecorene gemynddagas/19 Gēolmōnaþ	Wikipedia:历史上的今天/12月19日
Wikipǣdia:Gecorene gemynddagas/24 Solmōnaþ	Wikipedia:历史上的今天/2月24日
Wikipǣdia:Gecorene gemynddagas/13 Solmōnaþ	Wikipedia:历史上的今天/2月13日
Wikipǣdia:Gecorene gemynddagas/20 Solmōnaþ	Wikipedia:历史上的今天/2月20日
Wikipǣdia:Gecorene gemynddagas/5 Æfterra Gēola	Wikipedia:历史上的今天/1月5日
Wikipǣdia:Gecorene gemynddagas/15 Hrēþmōnaþ	Wikipedia:历史上的今天/3月15日
Wikipǣdia:Gecorene gemynddagas/23 Solmōnaþ	Wikipedia:历史上的今天/2月23日
Wikipǣdia:Gecorene gemynddagas/13 Hrēþmōnaþ	Wikipedia:历史上的今天/3月13日
Wikipǣdia:Gecorene gemynddagas/15 Hāligmōnaþ	Wikipedia:历史上的今天/9月15日
Wikipǣdia:Gecorene gemynddagas/15 Gēolmōnaþ	Wikipedia:历史上的今天/12月15日
Wikipǣdia:Gecorene gemynddagas/4 Hāligmōnaþ	Wikipedia:历史上的今天/9月4日
Wikipǣdia:Gecorene gemynddagas/8 Hāligmōnaþ	Wikipedia:历史上的今天/9月8日
Wikipǣdia:Gecorene gemynddagas/18 Gēolmōnaþ	Wikipedia:历史上的今天/12月18日
Wikipǣdia:Gecorene gemynddagas/4 Hrēþmōnaþ	Wikipedia:历史上的今天/3月4日
Wikipǣdia:Gecorene gemynddagas/4 Winterfylleþ	Wikipedia:历史上的今天/10月4日
Wikipǣdia:Gecorene gemynddagas/21 Blōtmōnaþ	Wikipedia:历史上的今天/11月21日
Wikipǣdia:Gecorene gemynddagas/1 Hāligmōnaþ	Wikipedia:历史上的今天/9月1日
Wikipǣdia:Gecorene gemynddagas/3 Mǣdmōnaþ	Wikipedia:历史上的今天/7月3日
Wikipǣdia:Gecorene gemynddagas/4 Mǣdmōnaþ	Wikipedia:历史上的今天/7月4日
Wikipǣdia:Gecorene gemynddagas/13 Æfterra Gēola	Wikipedia:历史上的今天/1月13日
Wikipǣdia:Gecorene gemynddagas/28 Sēremōnaþ	Wikipedia:历史上的今天/6月28日
Wikipǣdia:Gecorene gemynddagas/7 Sēremōnaþ	Wikipedia:历史上的今天/6月7日
Wikipǣdia:Gecorene gemynddagas/6 Hāligmōnaþ	Wikipedia:历史上的今天/9月6日
Wikipǣdia:Gecorene gemynddagas/25 Hāligmōnaþ	Wikipedia:历史上的今天/9月25日
Wikipǣdia:Gecorene gemynddagas/27 Æfterra Gēola	Wikipedia:历史上的今天/1月27日
Wikipǣdia:Gecorene gemynddagas/6 Mǣdmōnaþ	Wikipedia:历史上的今天/7月6日
Wikipǣdia:Gecorene gemynddagas/15 Mǣdmōnaþ	Wikipedia:历史上的今天/7月15日
Wikipǣdia:Gecorene gemynddagas/10 Hāligmōnaþ	Wikipedia:历史上的今天/9月10日
Wikipǣdia:Gecorene gemynddagas/26 Hāligmōnaþ	Wikipedia:历史上的今天/9月26日
Wikipǣdia:Gecorene gemynddagas/20 Hāligmōnaþ	Wikipedia:历史上的今天/9月20日
Wikipǣdia:Gecorene gemynddagas/16 Mǣdmōnaþ	Wikipedia:历史上的今天/7月16日
Wikipǣdia:Gecorene gemynddagas/14 Mǣdmōnaþ	Wikipedia:历史上的今天/7月14日
Wikipǣdia:Gecorene gemynddagas/25 Mǣdmōnaþ	Wikipedia:历史上的今天/7月25日
Wikipǣdia:Gecorene gemynddagas/12 Æfterra Gēola	Wikipedia:历史上的今天/1月12日
Wikipǣdia:Gecorene gemynddagas/23 Wēodmōnaþ	Wikipedia:历史上的今天/8月23日
Wikipǣdia:Gecorene gemynddagas/22 Sēremōnaþ	Wikipedia:历史上的今天/6月22日
Wikipǣdia:Gecorene gemynddagas/16 Wēodmōnaþ	Wikipedia:历史上的今天/8月16日
Wikipǣdia:Gecorene gemynddagas/30 Gēolmōnaþ	Wikipedia:历史上的今天/12月30日
Wikipǣdia:Gecorene gemynddagas/4 Blōtmōnaþ	Wikipedia:历史上的今天/11月4日
Wikipǣdia:Gecorene gemynddagas/3 Æfterra Gēola	Wikipedia:历史上的今天/1月3日
Wikipǣdia:Gecorene gemynddagas/30 Hāligmōnaþ	Wikipedia:历史上的今天/9月30日
Wikipǣdia:Gecorene gemynddagas/8 Æfterra Gēola	Wikipedia:历史上的今天/1月8日
Wikipǣdia:Gecorene gemynddagas/1 Hrēþmōnaþ	Wikipedia:历史上的今天/3月1日
Wikipǣdia:Gecorene gemynddagas/14 Solmōnaþ	Wikipedia:历史上的今天/2月14日
Wikipǣdia:Gecorene gemynddagas/7 Winterfylleþ	Wikipedia:历史上的今天/10月7日
Wikipǣdia:Gecorene gemynddagas/19 Solmōnaþ	Wikipedia:历史上的今天/2月19日
Wikipǣdia:Gecorene gemynddagas/28 Hrēþmōnaþ	Wikipedia:历史上的今天/3月28日
Wikipǣdia:Gecorene gemynddagas/20 Hrēþmōnaþ	Wikipedia:历史上的今天/3月20日
Wikipǣdia:Gecorene gemynddagas/6 Solmōnaþ	Wikipedia:历史上的今天/2月6日
Wikipǣdia:Gecorene gemynddagas/7 Solmōnaþ	Wikipedia:历史上的今天/2月7日
Wikipǣdia:Gecorene gemynddagas/21 Solmōnaþ	Wikipedia:历史上的今天/2月21日
Wikipǣdia:Gecorene gemynddagas/1 Wēodmōnaþ	Wikipedia:历史上的今天/8月1日
Wikipǣdia:Gecorene gemynddagas/14 Hrēþmōnaþ	Wikipedia:历史上的今天/3月14日
Wikipǣdia:Gecorene gemynddagas/28 Solmōnaþ	Wikipedia:历史上的今天/2月28日
Wikipǣdia:Gecorene gemynddagas/27 Hāligmōnaþ	Wikipedia:历史上的今天/9月27日
Wikipǣdia:Gecorene gemynddagas/8 Mǣdmōnaþ	Wikipedia:历史上的今天/7月8日
Wikipǣdia:Gecorene gemynddagas/11 Hāligmōnaþ	Wikipedia:历史上的今天/9月11日
Wikipǣdia:Gecorene gemynddagas/22 Mǣdmōnaþ	Wikipedia:历史上的今天/7月22日
Wikipǣdia:Gecorene gemynddagas/28 Wēodmōnaþ	Wikipedia:历史上的今天/8月28日
Wikipǣdia:Gecorene gemynddagas/1 Blōtmōnaþ	Wikipedia:历史上的今天/11月1日
Wikipǣdia:Gecorene gemynddagas/2 Solmōnaþ	Wikipedia:历史上的今天/2月2日
Wikipǣdia:Gecorene gemynddagas/4 Wēodmōnaþ	Wikipedia:历史上的今天/8月4日
Wikipǣdia:Gecorene gemynddagas/22 Gēolmōnaþ	Wikipedia:历史上的今天/12月22日
Wikipǣdia:Gecorene gemynddagas/20 Winterfylleþ	Wikipedia:历史上的今天/10月20日
Wikipǣdia:Gecorene gemynddagas/28 Mǣdmōnaþ	Wikipedia:历史上的今天/7月28日
Wikipǣdia:Gecorene gemynddagas/17 Æfterra Gēola	Wikipedia:历史上的今天/1月17日
Wikipǣdia:Gecorene gemynddagas/3 Solmōnaþ	Wikipedia:历史上的今天/2月3日
Bysen:Lang-sr	Template:Lang-sr
Wikipǣdia:Gecorene gemynddagas/7 Mǣdmōnaþ	Wikipedia:历史上的今天/7月7日
Wikipǣdia:Gecorene gemynddagas/24 Mǣdmōnaþ	Wikipedia:历史上的今天/7月24日
Wikipǣdia:Gecorene gemynddagas/21 Mǣdmōnaþ	Wikipedia:历史上的今天/7月21日
Wikipǣdia:Gecorene gemynddagas/6 Sēremōnaþ	Wikipedia:历史上的今天/6月6日
Wikipǣdia:Gecorene gemynddagas/11 Mǣdmōnaþ	Wikipedia:历史上的今天/7月11日
Wikipǣdia:Gecorene gemynddagas/8 Wēodmōnaþ	Wikipedia:历史上的今天/8月8日
Wikipǣdia:Gecorene gemynddagas/15 Wēodmōnaþ	Wikipedia:历史上的今天/8月15日
Wikipǣdia:Gecorene gemynddagas/10 Mǣdmōnaþ	Wikipedia:历史上的今天/7月10日
Wikipǣdia:Gecorene gemynddagas/16 Hrēþmōnaþ	Wikipedia:历史上的今天/3月16日
Wikipǣdia:Gecorene gemynddagas/14 Winterfylleþ	Wikipedia:历史上的今天/10月14日
Wikipǣdia:Gecorene gemynddagas/17 Hrēþmōnaþ	Wikipedia:历史上的今天/3月17日
Wikipǣdia:Gecorene gemynddagas/24 Hrēþmōnaþ	Wikipedia:历史上的今天/3月24日
Wikipǣdia:Gecorene gemynddagas/21 Hrēþmōnaþ	Wikipedia:历史上的今天/3月21日
Wikipǣdia:Gecorene gemynddagas/5 Solmōnaþ	Wikipedia:历史上的今天/2月5日
Wikipǣdia:Gecorene gemynddagas/3 Winterfylleþ	Wikipedia:历史上的今天/10月3日
Wikipǣdia:Gecorene gemynddagas/7 Hāligmōnaþ	Wikipedia:历史上的今天/9月7日
Wikipǣdia:Gecorene gemynddagas/26 Mǣdmōnaþ	Wikipedia:历史上的今天/7月26日
Wikipǣdia:Gecorene gemynddagas/14 Sēremōnaþ	Wikipedia:历史上的今天/6月14日
Flocc:Beorgas	Category:山
Bysen:Brūcend ru	Template:User ru
Flocc:20e gēarhundred	Category:20世纪
Bysen:IPA	Template:IPA
Bysen:Bēc þǣre Nīwan Gecȳþnesse	Template:新约圣经目录
Bysen:USpresidents	Template:美国总统
Wikipǣdia:Gecorene gemynddagas/7 Hrēþmōnaþ	Wikipedia:历史上的今天/3月7日
Wikipǣdia:Gecorene gemynddagas/29 Hrēþmōnaþ	Wikipedia:历史上的今天/3月29日
Wikipǣdia:Gecorene gemynddagas/28 Ēastermōnaþ	Wikipedia:历史上的今天/4月28日
Bysen:LangWithName	Template:LangWithName
Flocc:Hwæsingatūn	Category:华盛顿州
Flocc:Wihta	Category:傳說生物
Wikipǣdia:Gecorene gemynddagas/30 Hrēþmōnaþ	Wikipedia:历史上的今天/3月30日
Wikipǣdia:Gecorene gemynddagas/22 Solmōnaþ	Wikipedia:历史上的今天/2月22日
Wikipǣdia:Gecorene gemynddagas/31 Hrēþmōnaþ	Wikipedia:历史上的今天/3月31日
Wikipǣdia:Gecorene gemynddagas/23 Hrēþmōnaþ	Wikipedia:历史上的今天/3月23日
Wikipǣdia:Gecorene gemynddagas/17 Solmōnaþ	Wikipedia:历史上的今天/2月17日
Bysen:Birth date and age	Template:Birth date and age
Bysen:MONTHNAME	Template:MONTHNAME
Wikipǣdia:Gecorene gemynddagas/30 Æfterra Gēola	Wikipedia:历史上的今天/1月30日
Wikipǣdia:Gecorene gemynddagas/9 Solmōnaþ	Wikipedia:历史上的今天/2月9日
Wikipǣdia:Gecorene gemynddagas/8 Hrēþmōnaþ	Wikipedia:历史上的今天/3月8日
Bysen:Sortname	Template:Sortname
Flocc:Gebēd	Category:禱告
Wikipǣdia:Gecorene gemynddagas/29 Solmōnaþ	Wikipedia:历史上的今天/2月29日
Wikipǣdia:Gecorene gemynddagas/2 Hrēþmōnaþ	Wikipedia:历史上的今天/3月2日
Bysen:Country data Ireland	Template:Country data Ireland
Wikipǣdia:Gecorene gemynddagas/27 Solmōnaþ	Wikipedia:历史上的今天/2月27日
Wikipǣdia:Gecorene gemynddagas/26 Hrēþmōnaþ	Wikipedia:历史上的今天/3月26日
Flocc:Country data templates	Category:国家资料模板
Bysen:Namespace detect	Template:Namespace detect
Wikipǣdia:Gecorene gemynddagas/Solmōnaþ	Wikipedia:历史上的今天/2月
Bysen:Fmbox	Template:Fmbox
Bysen:Country data England	Template:Country data England
Flocc:19e gēarhundred	Category:19世纪
Bysen:Country data Republic of Ireland	Template:Country data Republic of Ireland
Flocc:Wrīteras	Category:作家
Bysen:Country data Switzerland	Template:Country data Switzerland
Flocc:Eormengyld	Category:大学
Bysen:Lang-cs	Template:Lang-cs
Bysen:Lang-he	Template:Lang-he
Bysen:Infobox OS	Template:Infobox OS
Bysen:Both	Template:Both
Bysen:Brūcend pt-1	Template:User pt-1
Flocc:Æfterra Gēola	Category:1月
Bysen:Lang-fa	Template:Lang-fa
Bysen:End tab	Template:End tab
Bysen:Brūcend pl	Template:User pl
Bysen:Brūcend nl	Template:User nl
Bysen:Tab	Template:Tab
Bysen:Brūcend pl-0	Template:User pl-0
Wikipǣdia:Gecorene gemynddagas/12 Winterfylleþ	Wikipedia:历史上的今天/10月12日
Bysen:Brūcend no-2	Template:User no-2
Bysen:Start tab	Template:Start tab
Wikipǣdia:Gecorene gemynddagas/11 Solmōnaþ	Wikipedia:历史上的今天/2月11日
Bysen:Australia	Template:Australia
Wikipǣdia:Nospam	Wikipedia:被保护的标题
Wikipǣdia:Gecorene gemynddagas/5 Blōtmōnaþ	Wikipedia:历史上的今天/11月5日
Wikipǣdia:Gecorene gemynddagas/11 Æfterra Gēola	Wikipedia:历史上的今天/1月11日
Wikipǣdia:Gecorene gemynddagas/3 Hāligmōnaþ	Wikipedia:历史上的今天/9月3日
Wikipǣdia:Gecorene gemynddagas/24 Hāligmōnaþ	Wikipedia:历史上的今天/9月24日
Bysen:Rtl-lang	Template:Rtl-lang
Bysen:Please don't change this page	Wikipedia:新手入門/介紹
Bysen:Tlx	Template:Tlx
Bysen:CAN	Template:CAN
Bysen:Lang-de	Template:Lang-de
Bysen:Country data Austria-Hungary	Template:Country data Austria-Hungary
Bysen:Sæternes Bōtm	Template:土星的卫星
Bysen:Lang-la	Template:Lang-la
Flocc:Wucu	Category:星期
Bysen:Lang-af	Template:Lang-af
Wikipǣdia:Gecorene gemynddagas/Gēolmōnaþ	Wikipedia:历史上的今天/12月
Bysen:Infobox Album	Template:Infobox Album
Bysen:User	Template:User
Wikipǣdia:Gecorene gemynddagas/16 Gēolmōnaþ	Wikipedia:历史上的今天/12月16日
Wikipǣdia:Gecorene gemynddagas/9 Æfterra Gēola	Wikipedia:历史上的今天/1月9日
Wikipǣdia:Gecorene gemynddagas/7 Æfterra Gēola	Wikipedia:历史上的今天/1月7日
Wikipǣdia:Gecorene gemynddagas/19 Mǣdmōnaþ	Wikipedia:历史上的今天/7月19日
Wikipǣdia:Gecorene gemynddagas/13 Wēodmōnaþ	Wikipedia:历史上的今天/8月13日
Wikipǣdia:Gecorene gemynddagas/12 Hāligmōnaþ	Wikipedia:历史上的今天/9月12日
Wikipǣdia:Gecorene gemynddagas/2 Hāligmōnaþ	Wikipedia:历史上的今天/9月2日
Wikipǣdia:Gecorene gemynddagas/7 Wēodmōnaþ	Wikipedia:历史上的今天/8月7日
Wikipǣdia:Gecorene gemynddagas/4 Ēastermōnaþ	Wikipedia:历史上的今天/4月4日
Wikipǣdia:Gecorene gemynddagas/22 Æfterra Gēola	Wikipedia:历史上的今天/1月22日
Wikipǣdia:Gecorene gemynddagas/4 Æfterra Gēola	Wikipedia:历史上的今天/1月4日
Wikipǣdia:Gecorene gemynddagas/19 Wēodmōnaþ	Wikipedia:历史上的今天/8月19日
Wikipǣdia:Gecorene gemynddagas/18 Hāligmōnaþ	Wikipedia:历史上的今天/9月18日
Wikipǣdia:Gecorene gemynddagas/4 Gēolmōnaþ	Wikipedia:历史上的今天/12月4日
Wikipǣdia:Gecorene gemynddagas/2 Wēodmōnaþ	Wikipedia:历史上的今天/8月2日
Wikipǣdia:Gecorene gemynddagas/21 Gēolmōnaþ	Wikipedia:历史上的今天/12月21日
Wikipǣdia:Gecorene gemynddagas/20 Mǣdmōnaþ	Wikipedia:历史上的今天/7月20日
Wikipǣdia:Gecorene gemynddagas/18 Wēodmōnaþ	Wikipedia:历史上的今天/8月18日
Wikipǣdia:Gecorene gemynddagas/24 Æfterra Gēola	Wikipedia:历史上的今天/1月24日
Wikipǣdia:Brōðra rǣdscēawung	Wikipedia:同行评审
Bysen:Year nav	Template:YearTOC
Flocc:Flyhthæfenan on Fietname	Category:越南機場
Bysen:Brūcend pl-1	Template:User pl-1
Flocc:Cyningas of Englalande	Category:英格蘭君主
Flocc:Bryttisce cyningas	Category:英国君主
Bysen:Brūcend fr-3	Template:User fr-3
Bysen:Imdb name	Template:Imdb name
Flocc:Tunisia	Category:突尼西亞
Bysen:PD	Template:PD-because
Bysen:Wikispell	Template:Wikinews
Bysen:Brūcend lt	Template:User lt
Bysen:Cc-by-sa-2.0	Template:CC-BY-SA-2.0
Bysen:Mbox	Template:Mbox
Bysen:Oppose	Template:Oppose
Bysen:Coord/link	Template:Coord/link
Bysen:Infobox UK place	Template:Infobox UK place
Bysen:Brūcend is-1	Template:User is-1
Bysen:Brūcend is-2	Template:User is-2
Bysen:Brūcend is	Template:User is
Bysen:Brūcend de-0	Template:User de-0
Bysen:Brūcend en-5	Template:User en-5
Bysen:Dagas þǣre wuce	Template:星期中的日子
Bysen:Brūcend fr-0	Template:User fr-0
Flocc:Norþ Carolīna	Category:北卡罗来纳州
Flocc:Puerto Rico	Category:波多黎各
Flocc:Byrig þāra Geāndena Rīca American	Category:美國城市
Bysen:Country data West Germany	Template:Country data West Germany
Bysen:Lang-ru	Template:Lang-ru
Bysen:Country data East Germany	Template:Country data East Germany
Bysen:Infobox Aircraft Begin	Template:Infobox Aircraft Begin
Bysen:Browsebar	Template:Browsebar
Bysen:Timeline Temperature Conversion	Template:Timeline Temperature Conversion
Flocc:Brittisca Here	Category:英國陸軍
Bysen:Disambig	Template:Disambig
Flocc:Byrig on Israhēlum	Category:以色列聚居地
Bysen:Country data Nazi Germany	Template:Country data Nazi Germany
Bysen:Selectskin	Template:Select skin
Bysen:Doi	Template:Doi
Bysen:Country data German Empire	Template:Country data German Empire
Flocc:Coreanisc stǣr	Category:朝鮮半島歷史
Bysen:Fb	Template:Fb
Bysen:Lang-grc	Template:Lang-grc
Bysen:Brūcend ksh	Template:User ksh
Bysen:Infobox Film	Template:Infobox Film
Bysen:Lang-en	Template:Lang-en
Bysen:Flag template documentation	Template:Flag template documentation
Bysen:Fix	Template:Fix
Bysen:Lang-id	Template:Lang-id
Bysen:Period end	Template:Period end
Bysen:Tn	Template:Tn
Bysen:Brūcend sv-2	Template:User sv-2
Bysen:Brūcend it-2	Template:User it-2
Bysen:Lang-fr	Template:Lang-fr
Bysen:Fossil range	Template:Geological range
Bysen:Brūcend pt-0	Template:User pt-0
Bysen:Editnotice	Template:Editnotice
Bysen:Betwuxwici	Template:InterWiki
Flocc:Byrig in þǣm Niðerlandum	Category:荷蘭城市
Wikipǣdia:Gecorene gemynddagas/Hāligmōnaþ	Wikipedia:历史上的今天/9月
Bysen:Coord	Template:Coord
Bysen:Brūcend pt-3	Template:User pt-3
Flocc:Byrig on Lincolnscīre	Category:林肯郡城鎮
Bysen:Country data Kalmar Union	Template:Country data Kalmar Union
Bysen:Brūcend pt-2	Template:User pt-2
Flocc:Wyoming	Category:怀俄明州
Wikipǣdia:Gecorene gemynddagas/14 Hāligmōnaþ	Wikipedia:历史上的今天/9月14日
Wikipǣdia:Gecorene gemynddagas/20 Sēremōnaþ	Wikipedia:历史上的今天/6月20日
Wikipǣdia:Gecorene gemynddagas/22 Wēodmōnaþ	Wikipedia:历史上的今天/8月22日
Wikipǣdia:Gecorene gemynddagas/9 Hāligmōnaþ	Wikipedia:历史上的今天/9月9日
Wikipǣdia:Gecorene gemynddagas/13 Hāligmōnaþ	Wikipedia:历史上的今天/9月13日
Wikipǣdia:Gecorene gemynddagas/1 Æfterra Gēola	Wikipedia:历史上的今天/1月1日
Wikipǣdia:Gecorene gemynddagas/14 Wēodmōnaþ	Wikipedia:历史上的今天/8月14日
Wikipǣdia:Gecorene gemynddagas/6 Gēolmōnaþ	Wikipedia:历史上的今天/12月6日
Bysen:Brūcend fr-4	Template:User fr-4
Flocc:Grēneland	Category:格陵蘭
Wikipǣdia:Gecorene gemynddagas/Winterfylleþ	Wikipedia:历史上的今天/10月
Bysen:Brūcend la-1	Template:User la-1
Bysen:Land on Europan	Template:Europe
Bysen:Brūcend el-0	Template:User el-0
Flocc:User sk	Category:Sk 使用者
Flocc:Brūcend eo	Category:Eo 使用者
Flocc:Brūcend fr	Category:Fr 使用者
Flocc:Brūcend cy	Category:Cy 使用者
Flocc:Brūcend got	Category:Got 使用者
Flocc:Brūcend ang	Category:Ang 使用者
Flocc:Brūcend la	Category:La 使用者
Flocc:Brūcend lt	Category:Lt 使用者
Flocc:Brūcend pt	Category:Pt 使用者
Flocc:Brūcend sv	Category:Sv 使用者
Flocc:Brūcend fr-3	Category:Fr-3 使用者
Flocc:Brūcend cy-3	Category:Cy-3 使用者
Flocc:Brūcend ang-3	Category:Ang-3 使用者
Flocc:Brūcend it-3	Category:It-3 使用者
Flocc:Brūcend pl-3	Category:Pl-3 使用者
Flocc:Brūcend fi-1	Category:Fi-1 使用者
Flocc:Brūcend cy-1	Category:Cy-1 使用者
Flocc:Brūcend ang-1	Category:Ang-1 使用者
Flocc:Brūcend nl-1	Category:Nl-1 使用者
Flocc:Brūcend pl-1	Category:Pl-1 使用者
Flocc:Brūcend fr-4	Category:Fr-4 使用者
Flocc:Brūcend cy-4	Category:Cy-4 使用者
Flocc:Brūcend ang-4	Category:Ang-4 使用者
Flocc:Brūcend it-4	Category:It-4 使用者
Flocc:Brūcend pl-4	Category:Pl-4 使用者
Flocc:Brūcend fr-2	Category:Fr-2 使用者
Flocc:Brūcend cy-2	Category:Cy-2 使用者
Flocc:Brūcend ang-2	Category:Ang-2 使用者
Flocc:Brūcend it-2	Category:It-2 使用者
Flocc:Brūcend la-2	Category:La-2 使用者
Flocc:Brūcend pl-2	Category:Pl-2 使用者
Flocc:Brūcend sv-2	Category:Sv-2 使用者
Flocc:Brūcend fr-M	Category:Fr 母語使用者
Flocc:Brūcend is-M	Category:Is 母語使用者
Flocc:Brūcend lt-N	Category:Lt 母語使用者
Flocc:Brūcend nl-M	Category:Nl 母語使用者
Flocc:Brūcend ru-M	Category:Ru 母語使用者
Flocc:Feormung	Category:娱乐
Flocc:Hēafodstōlas þæs Sericus Gārsecges	Category:大洋洲首都
Flocc:Turcas and Caicos Īegland	Category:特克斯和凱科斯群島
Flocc:Articles that need to be wikified	Category:需要维基化的页面
Flocc:Byrig on Canadan	Category:加拿大聚居地
Flocc:Īega	Category:岛屿
Flocc:Sericus Garsecg	Category:太平洋
Flocc:User sk-N	Category:Sk 母語使用者
Flocc:Brūcend de	Category:De 使用者
Flocc:Brūcend de-2	Category:De-2 使用者
Flocc:Brūcend de-3	Category:De-3 使用者
Flocc:Brūcend de-4	Category:De-4 使用者
Flocc:Brūcend el	Category:El 使用者
Flocc:Brūcend el-1	Category:El-1 使用者
Flocc:Brūcend el-2	Category:El-2 使用者
Flocc:Brūcend el-3	Category:El-3 使用者
Flocc:Brūcend el-N	Category:El 母語使用者
Flocc:Brūcend en-3	Category:En-3 使用者
Flocc:Brūcend en-5	Category:En-5 使用者
Flocc:Brūcend en-M	Category:En 母语使用者
Flocc:Brūcend eo-2	Category:Eo-2 使用者
Flocc:Brūcend es	Category:Es 使用者
Flocc:Brūcend es-1	Category:Es-1 使用者
Flocc:Brūcend es-2	Category:Es-2 使用者
Flocc:Puilla	Category:普利亞
Flocc:Brūcend es-3	Category:Es-3 使用者
Flocc:Brūcend es-4	Category:Es-4 使用者
Flocc:Brūcend es-N	Category:Es 母语使用者
Flocc:Brūcend fi	Category:Fi 使用者
Flocc:Brūcend fi-M	Category:Fi 母語使用者
Flocc:Brūcend fo	Category:Fo 使用者
Flocc:Brūcend fo-1	Category:Fo-1 使用者
Flocc:Brūcend fo-2	Category:Fo-2 使用者
Flocc:Brūcend fo-4	Category:Fo-4 使用者
Flocc:Brūcend is	Category:Is 使用者
Flocc:Brūcend is-1	Category:Is-1 使用者
Flocc:Brūcend is-2	Category:Is-2 使用者
Flocc:Brūcend is-3	Category:Is-3 使用者
Flocc:Brūcend is-4	Category:Is-4 使用者
Flocc:Byrig on Mexican	Category:墨西哥聚居地
Flocc:Mexiciscu rīce	Category:墨西哥行政區劃
Bysen:Brūcend la-3	Template:User la-3
Flocc:Frencisc Guiana	Category:法屬圭亞那
Ǣht	財產權
Flocc:Hebrēisc sprǣc	Category:希伯來語
Flocc:Brūcend pt-3	Category:Pt-3 使用者
Flocc:Bryttisc bōccræft	Category:英國文學
Flocc:Brūcend pl-N	Category:Pl 母語使用者
Flocc:Brūcend pt-1	Category:Pt-1 使用者
Bysen:Country data Germany	Template:Country data Germany
Bysen:Country data Geāned Cynerīce	Template:Country data United Kingdom
Wikipǣdia:Gecorene gemynddagas/17 Gēolmōnaþ	Wikipedia:历史上的今天/12月17日
Wikipǣdia:Gecorene gemynddagas/Mǣdmōnaþ	Wikipedia:历史上的今天/7月
Bysen:Lang-be	Template:Lang-be
Bysen:Cite encyclopedia	Template:Cite encyclopedia
Bysen:Country data Scotland	Template:Country data Scotland
Wikipǣdia:Tutorial (Formatting)	Wikipedia:新手入門/格式
Flocc:Brūcend it	Category:It 使用者
Flocc:Brūcend it-1	Category:It-1 使用者
Flocc:Rīcu þāra Geāndena Rīca American	Category:美国州份
Flocc:Brūcend ksh	Category:Ksh 使用者
Bysen:Mpl	Template:Mpl
Flocc:Brūcend la-1	Category:La-1 使用者
Wikipǣdia:Gecorene gemynddagas/29 Hāligmōnaþ	Wikipedia:历史上的今天/9月29日
Flocc:Brūcend la-3	Category:La-3 使用者
Flocc:Brūcend la-4	Category:La-4 使用者
Wikipǣdia:Gecorene gemynddagas/5 Hāligmōnaþ	Wikipedia:历史上的今天/9月5日
Bysen:Cite doi	Template:Cite doi
Flocc:Pulgara cyningas	Category:保加利亚君主
Flocc:Fȳrbeorgas	Category:火山
Flocc:Dēorabyscīr	Category:德比郡
Flocc:Byrig on Latie	Category:拉齐奥大区城市
Bysen:Englaland Scīra	Template:英格蘭各郡
Flocc:Feohtan	Category:武术
Bysen:Country data Australasia	Template:Country data Australasia
Flocc:Blōtmōnaþ	Category:11月
Wikipǣdia:Babel	Wikipedia:巴別
Bysen:Help contents back	Template:Help contents back
Flocc:Lēodweard	Category:領袖
Flocc:Scopas	Category:诗人
Flocc:Hāligmōnaþ	Category:9月
Flocc:Winterfylleþ	Category:10月
Flocc:Sǣ	Category:海洋
Flocc:Gēolmōnaþ	Category:12月
Flocc:Wēodmōnaþ	Category:8月
Flocc:Þrimilcemōnaþ	Category:5月
Flocc:Brandenburg	Category:勃兰登堡州
Flocc:Englaland	Category:英格蘭
Seringas	中國人
Wikipǣdia:Gecorene gemynddagas/22 Blōtmōnaþ	Wikipedia:历史上的今天/11月22日
Flocc:Ēastermōnaþ	Category:4月
Bysen:IPA2	Template:IPA-all
Flocc:Līfnamrǣden	Category:生物分類學
Bysen:Lang-it	Template:Lang-it
Bysen:Coord/dms2dec	Template:Coord/dms2dec
Bysen:Country data Brazil	Template:Country data Brazil
Flocc:Gestorfen in 988	Category:988年逝世
Flocc:Wæter	Category:水
Flocc:Hēafod and swēor	Category:頭頸
Flocc:Geboren in 121	Category:121年出生
Wikipǣdia:MediaWiki namespace	Wikipedia:MediaWiki名字空间
Bysen:Lang-mi	Template:Lang-mi
Flocc:180	Category:180年
Flocc:Gestorfen in 180	Category:180年逝世
Flocc:Drincas	Category:饮料
Flocc:Gestorfen in 2005	Category:2005年逝世
Flocc:450	Category:450年
Wikipǣdia:Administrators' how-to guide	Help:管理員操作手冊
Bysen:Start date and age	Template:Start date and age
Wikipǣdia:Manigsprǣclicu samodwyrcung	Wikipedia:跨语言协作
Flocc:Geboren in 1974	Category:1974年出生
Flocc:Geboren in 1899	Category:1899年出生
Flocc:Oklahoma	Category:奧克拉荷馬州
Flocc:Iapanisc sangeras	Category:日本歌手
Flocc:Forman Þegnas	Category:总理
Flocc:Geboren in 1954	Category:1954年出生
Flocc:850	Category:850年
Flocc:Geboren in 850	Category:850年出生
Bysen:Cyþþubox Æþel	Template:Infobox Royalty
Flocc:Hwītrussland	Category:白俄羅斯
Flocc:Alberta	Category:亞伯達
Flocc:Ontario	Category:安大略
Flocc:Nīwe Scotland	Category:新斯科細亞
Flocc:899	Category:899年
Flocc:Gestorfen in 899	Category:899年逝世
Flocc:Geocon Landscipe	Category:育空
Flocc:Massachusetts	Category:麻薩諸塞州
Flocc:924	Category:924年
Flocc:Gestorfen in 924	Category:924年逝世
Bysen:Editprotected	Template:Editprotected
Bysen:Country data Ungerland	Template:Country data Hungary
Flocc:Land on Affrice	Category:非洲国家
Bysen:Canadan underrīce	Template:加拿大一级行政区
Bysen:Template reference list	Template:Template reference list
Flocc:Geboren in 1239	Category:1239年出生
Flocc:1249	Category:1249年
Flocc:1289	Category:1289年
Flocc:1305	Category:1305年
Flocc:Gestorfen in 1305	Category:1305年逝世
Flocc:1307	Category:1307年
Wikipǣdia:Gecorene gemynddagas/Blōtmōnaþ	Wikipedia:历史上的今天/11月
Bysen:Brūcend pt-4	Template:User pt-4
Bysen:Country data New Zealand	Template:Country data New Zealand
Bysen:Brūcend es-3	Template:User es-3
Flocc:Ēa Franclandes	Category:法國河流
Flocc:Brūcend pt-2	Category:Pt-2 使用者
Flocc:Brūcend pt-4	Category:Pt-4 使用者
Flocc:Brūcend pt-N	Category:Pt 母語使用者
Flocc:Brūcend ru	Category:Ru 使用者
Flocc:Brūcend sv-M	Category:Sv 母語使用者
Flocc:1634	Category:1634年
Flocc:1638	Category:1638年
Bysen:En icon	Template:En icon
Flocc:1719	Category:1719年
Flocc:Gestorfen in 1719	Category:1719年逝世
Bysen:Country data Faroe Islands	Template:Country data Faroe Islands
Flocc:121	Category:121年
Bysen:Lang	Template:Lang
Wikipǣdia:Gecorene gemynddagas/21 Hāligmōnaþ	Wikipedia:历史上的今天/9月21日
Bysen:Country data Americanisc	Template:Country data United States
Flocc:Trēowu	Category:树
Bysen:Infobox ea	Template:Infobox River
Flocc:Geboren in 1634	Category:1634年出生
Flocc:Geboren in 1638	Category:1638年出生
Flocc:Geboren in 1852	Category:1852年出生
Flocc:Geboren in 1892	Category:1892年出生
Flocc:Geboren in 1918	Category:1918年出生
Flocc:Geboren in 1945	Category:1945年出生
Flocc:Geboren in 1949	Category:1949年出生
Flocc:Geboren in 1981	Category:1981年出生
Flocc:Geboren in 1993	Category:1993年出生
Flocc:1715	Category:1715年
Wikipǣdia:Gecorene gemynddagas/Ēastermōnaþ	Wikipedia:历史上的今天/4月
Bysen:Period color	Template:Period color
Flocc:11e gēarhundred	Category:11世纪
Flocc:988	Category:988年
Flocc:10e gēarhundred	Category:10世纪
Flocc:7e gēarhundred	Category:7世纪
Flocc:1239	Category:1239年
Flocc:Gestorfen in 1307	Category:1307年逝世
Flocc:Corsica	Category:科西嘉大区
Flocc:Gestorfen in 1715	Category:1715年逝世
Flocc:Russisce bōccræft	Category:俄国文学
Flocc:Sardinia	Category:撒丁
Bysen:Lang-hi	Template:Lang-hi
Flocc:Florida	Category:佛罗里达州
Bysen:Convert/And0	Template:Convert/And0
Bysen:Coord/dec2dms/dm	Template:Coord/dec2dms/dm
Bysen:Elementbox isotopes stable	Template:Infobox element/isotopes stable
Flocc:Nevada	Category:内华达州
Flocc:Nebraska	Category:內布拉斯加州
Flocc:Norþ Dakota	Category:北达科他州
Flocc:Nīwe Eoforwīc	Category:紐約州
Flocc:Rhode Īeg	Category:羅德島州
Flocc:Louisiāna	Category:路易斯安那州
Flocc:Marianland	Category:马里兰州
Flocc:Maine	Category:缅因州
Flocc:Minnesota	Category:明尼苏达州
Flocc:Michigan	Category:密歇根州
Flocc:Mississippi	Category:密西西比州
Flocc:Missouri	Category:密蘇里州
Flocc:Vermont	Category:佛蒙特州
Flocc:Virginia	Category:維吉尼亞州
Flocc:Idaho	Category:爱达荷州
Flocc:Iowa	Category:艾奥瓦州
Flocc:Arkansas	Category:阿肯色州
Flocc:Alaska	Category:阿拉斯加州
Flocc:Arizona	Category:亚利桑那州
Flocc:Alabama	Category:阿拉巴马州
Flocc:Ohio	Category:俄亥俄州
Flocc:Westvirginia	Category:西弗吉尼亚州
Flocc:Wisconsin	Category:威斯康辛州
Flocc:Indiāna	Category:印第安纳州
Flocc:Illinois	Category:伊利諾州
Flocc:Kansas	Category:堪薩斯州
Flocc:California	Category:加利福尼亞州
Flocc:Kentucky	Category:肯塔基州
Flocc:Connecticut	Category:康涅狄格州
Flocc:Colorado	Category:科罗拉多州
Flocc:Texas	Category:得克萨斯州
Flocc:Hawaii	Category:夏威夷州
Bysen:Fs end	Template:Football squad end
Bysen:Fs start	Template:Football squad start
Bysen:WPMILHIST Infobox style	Template:WPMILHIST Infobox style
Flocc:Ōðru Woruldgūþ	Category:第二次世界大战
Flocc:Nīwes Sǣlandes byrig	Category:紐西蘭城市
Bysen:Fossil range/marker	Template:Fossil range/marker
Flocc:Hundas	Category:狗
Flocc:OS X gamen	Category:OS X遊戲
Flocc:Cattas	Category:貓科
Wikipǣdia:Gecorene gemynddagas/16 Solmōnaþ	Wikipedia:历史上的今天/2月16日
Wikipǣdia:Gecorene gemynddagas/25 Wēodmōnaþ	Wikipedia:历史上的今天/8月25日
Flocc:Russisce wrīteras	Category:俄國作家
Bysen:•	Template:•
Flocc:1066	Category:1066年
Flocc:Gestorfen in 1066	Category:1066年逝世
Flocc:Angola	Category:安哥拉
Flocc:Botswana	Category:波札那
Flocc:Elpendbānrima	Category:象牙海岸
Flocc:Æriþrea	Category:厄利垂亞
Flocc:Gabon	Category:加蓬
Flocc:Gambia	Category:冈比亚
Flocc:Guinea	Category:幾內亞
Flocc:Camerun	Category:喀麥隆
Flocc:Grēnenæs Īega	Category:佛得角
Flocc:Cenia	Category:肯亞
Flocc:Liberia	Category:利比里亚
Flocc:Libia	Category:利比亞
Flocc:Morocco	Category:摩洛哥
Flocc:Mauritania	Category:毛里塔尼亚
Flocc:1451	Category:1451年
Flocc:Namibia	Category:纳米比亚
Flocc:Caribisc Sǣ	Category:加勒比海
Flocc:Delaware	Category:特拉华州
Flocc:Georgia (America)	Category:喬治亞州
Flocc:Montāna	Category:蒙大拿州
Bysen:Merge	Template:Merge
Flocc:Tennessee	Category:田纳西州
Flocc:Baden-Wyrttemberg	Category:巴登-符腾堡州
Flocc:1852	Category:1852年
Flocc:1892	Category:1892年
Flocc:Gestorfen in 1926	Category:1926年逝世
Flocc:1973	Category:1973年
Flocc:Gestorfen in 1973	Category:1973年逝世
Flocc:1975	Category:1975年
Flocc:1981	Category:1981年
Flocc:Gestorfen in 1982	Category:1982年逝世
Flocc:2004	Category:2004年
Flocc:Gestorfen in 2004	Category:2004年逝世
Flocc:2005	Category:2005年
Flocc:2006	Category:2006年
Flocc:2007	Category:2007年
Flocc:2008	Category:2008年
Flocc:Ēa	Category:河流
Bysen:Brūcend el-2	Template:User el-2
Bysen:Brūcend fo-1	Template:User fo-1
Bysen:Brūcend fo-3	Template:User fo-3
Bysen:Brūcend la-2	Template:User la-2
Bysen:Brūcend no-1	Template:User no-1
Bysen:Brūcend pl-2	Template:User pl-2
Bysen:Brūcend pt	Template:User pt
Flocc:Sūþsudan	Category:南蘇丹
Flocc:Cead	Category:乍得
Flocc:Uganda	Category:烏干達
Flocc:Rōmānisce Cāseras	Category:羅馬皇帝
Flocc:Brūcend nl	Category:Nl 使用者
Flocc:Brūcend no-1	Category:No-1 使用者
Flocc:Brūcend no-2	Category:No-2 使用者
Flocc:Brūcend no	Category:No 使用者
Flocc:Niðerlanda Cyningas	Category:荷兰君主
Flocc:Norrena cyningas	Category:挪威君主
Flocc:Swēona cyningas	Category:瑞典君主
Flocc:Armenia	Category:亞美尼亞
Flocc:Bahrain	Category:巴林
Flocc:Mennisc bodiȝlār	Category:人体解剖学
Flocc:Feorrsīen	Category:电视
Flocc:Angelcirice	Category:英格蘭教會
Flocc:14e gēarhundred	Category:14世纪
Flocc:13e gēarhundred	Category:13世纪
Flocc:2e gēarhundred	Category:2世纪
Flocc:4e gēarhundred	Category:4世纪
Flocc:5e gēarhundred	Category:5世纪
Flocc:18e gēarhundred	Category:18世纪
Flocc:6e gēarhundred	Category:6世纪
Flocc:Arabea	Category:阿拉伯半島
Flocc:Nīwlicu Word	Category:新詞
Flocc:Nīwesǣlendisce wrīteras	Category:新西兰作家
Flocc:Seaxland-Anhalt	Category:萨克森-安哈尔特州
Flocc:Niðerseaxland	Category:下萨克森州
Flocc:Russe	Category:俄罗斯人
Flocc:Unƿǣre lēode	Category:虛構角色
Flocc:Crēcisc ūtwitan	Category:希腊哲学家
Flocc:Bægwaraland	Category:巴伐利亚州
Flocc:Superman	Category:超人
Flocc:Ēage	Category:眼睛
Flocc:Corn	Category:谷物
Flocc:Nīweoforwīcburg	Category:紐約市
Flocc:Norþhāmtūnescīr	Category:北安普敦郡
Flocc:Gamen	Category:休閒
Flocc:Snotingahāmscīr	Category:諾丁罕郡
Flocc:15e gēarhundred	Category:15世纪
Flocc:Georgia (land)	Category:喬治亞
Flocc:Cambodia	Category:柬埔寨
Flocc:Americanisc sangeras	Category:美国歌手
Flocc:Bryttisce scopas	Category:英国诗人
Flocc:Stǣr þæs Cynerices Greatbryttenes	Category:英国历史
Flocc:Iamaica	Category:牙買加
Bysen:Lang-hy	Template:Lang-hy
Flocc:Scotta cyningas	Category:蘇格蘭君主
Flocc:Bryttiscan Fæmne Īegland	Category:英屬處女群島
Flocc:Corēa	Category:朝鮮半島
Flocc:Burma	Category:緬甸
Flocc:Taprabane	Category:斯里蘭卡
Bysen:Col-3	Template:Col-3
Flocc:Tacgicastan	Category:塔吉克
Flocc:Ēasttimor	Category:東帝汶
Flocc:Turcmenistan	Category:土库曼斯坦
Flocc:Usbecastan	Category:烏茲別克
Flocc:Geānedan Arabiscan Bregorīce	Category:阿拉伯联合酋长国
Flocc:9e gēarhundred	Category:9世纪
Flocc:Sofiet Gesamnung	Category:苏联
Bysen:Bēc þǣre Ealdan Gecȳþnesse	Template:希伯来圣经
Bysen:Brūcend de-4	Template:User de-4
Flocc:Searwa stycce	Category:科学技术小作品
Flocc:Wēalas	Category:威爾斯
Flocc:Blizzard Entertainment	Category:暴雪娱乐
Flocc:Foresittendas þāra Geāndena Rīca American	Category:美国总统
Flocc:Europisc stǣr	Category:欧洲历史
Flocc:Hascemisce Cynerīce þæs Iordanes	Category:约旦
Flocc:Bosnia and Herzegovina	Category:波斯尼亚和黑塞哥维那
Flocc:Norþweg	Category:挪威
Flocc:Barbados	Category:巴巴多斯
Flocc:Paraguay	Category:巴拉圭
Flocc:Ficgiege	Category:斐济
Flocc:Lēohtenstān	Category:列支敦斯登
Flocc:Uruguay	Category:乌拉圭
Flocc:Andorra	Category:安道爾
Flocc:Serbia	Category:塞尔维亚
Flocc:Ecuador	Category:厄瓜多
Flocc:Peru	Category:秘鲁
Flocc:Bolifia	Category:玻利维亚
Flocc:Albania	Category:阿爾巴尼亞
Flocc:Monaco	Category:摩纳哥
Flocc:Land on Norðamerican	Category:北美洲國家
Flocc:Fiscas	Category:鱼类
Flocc:Mūþ	Category:嘴
Flocc:Wyrta	Category:蔬菜
Flocc:Ofet	Category:水果
Flocc:Nīwu Gecȳþnes	Category:新约圣经
Flocc:Musea	Category:博物馆
Flocc:Rímcræft	Category:函数
Flocc:Landscipas Swēolandes	Category:瑞典省份
Flocc:Stǣrlice Sprǣccræft	Category:歷史語言學
Flocc:Dūnholmscīr	Category:達勒姆郡
Flocc:Manga	Category:日本漫畫
Flocc:Eoferwicscīr	Category:約克郡
Flocc:Oferhæleðas	Category:超級英雄
Flocc:Calpis	Category:直布羅陀
Flocc:Beadwe	Category:战役
Flocc:Weorcendebyrdnessa	Category:操作系统
Flocc:Mexicorīce	Category:墨西哥州份
Flocc:Hetwaraland	Category:黑森州
Flocc:Canadan underrīce and landscipas	Category:加拿大一級行政區
Flocc:Lunden	Category:倫敦
Flocc:Lincolnscīr	Category:林肯郡
Bysen:Incubator	Template:Incubator
Flocc:Dæg þæs gēares	Category:日
Flocc:Wiltūnscīr	Category:威爾特郡
Flocc:Wigreceastrescīr	Category:伍斯特郡
Flocc:Haran	Category:兔屬
Flocc:Americanisce Ingefeoht	Category:南北戰爭
Flocc:Byrig on Tuscanie	Category:托斯卡纳大区城市
Flocc:Wyrt	Category:香草
Flocc:Dēor	Category:动物
Flocc:Hweorfdēor	Category:脊椎動物亞門
Flocc:Cægman Īegland	Category:開曼群島
Flocc:Folcland Īegland	Category:马尔维纳斯群岛
Flocc:Land on Sūðamerican	Category:南美洲國家
Flocc:Colombia	Category:哥倫比亞
Bysen:End box	Template:Rail end
Flocc:Anime	Category:日本動畫
Flocc:Oxnafordscīr	Category:牛津郡
Flocc:Hociȝ	Category:曲棍球
Flocc:Sicilia	Category:西西里
Flocc:Grantabrycgscīr	Category:劍橋郡
Flocc:Þēodacynewīse	Category:英联邦
Flocc:Līþ	Category:酒
Flocc:Spearctellas	Category:電子遊戲機
Flocc:Englisc scīr	Category:英格蘭的郡
Flocc:Æþelingas	Category:王子
Flocc:Ceasterscīr	Category:柴郡
Flocc:Sūþrige	Category:薩里郡
Flocc:Defenascīr	Category:德文郡
Flocc:Se Hlāford þāra Hringa	Category:魔戒
Flocc:Rōmāniscu Folclār	Category:罗马神话
Flocc:Beadanfordscīr	Category:貝德福德郡
Flocc:Bergan	Category:浆果
Flocc:Bēor	Category:啤酒
Flocc:Sang	Category:歌曲
Flocc:Eormengyld byrig	Category:大学城
Flocc:Hēafodstōlas	Category:首都
Flocc:Byrig on Paraguay	Category:巴拉圭城市
Flocc:Stōwlice hēafodstōlas Canadan	Category:加拿大城市
Flocc:Ēastseaxe	Category:艾塞克斯郡
Flocc:Middelasia	Category:中亚
Flocc:Indisca Underworulddǣl	Category:南亚
Flocc:NFL	Category:國家美式足球聯盟
Flocc:Tuscania	Category:托斯卡纳
Flocc:Latium	Category:拉齐奥
Flocc:Lonceasterscīr	Category:蘭開夏郡
Flocc:Hāmtūnescīr	Category:漢普郡
Flocc:Brūcend pl	Category:Pl 使用者
Flocc:Rōmānisca sprǣca	Category:罗曼语族
Flocc:Fōr	Category:交通
Flocc:Sund	Category:游泳
Flocc:Hēapplegan	Category:團隊運動
Flocc:Toys	Category:玩具
Flocc:Hīwscipe	Category:家庭
Flocc:Cornweall	Category:康沃爾郡
Flocc:Cīna Caseras	Category:中国皇帝
Flocc:Antarctica	Category:南极洲
Flocc:Norðamerica	Category:北美洲
Flocc:Sangestre	Category:歌手
Flocc:Euxinus	Category:黑海
Flocc:Meras	Category:湖泊
Bysen:Elementbox isotopes decay2	Template:Infobox element/isotopes decay2
Bysen:Flagcountry	Template:Flagcountry
Bysen:Country data Weimar Republic	Template:Country data Weimar Republic
Flocc:Sweartbeorg	Category:黑山
Flocc:Indisc Gārsecg	Category:印度洋
Flocc:Wægnas	Category:汽车
Bysen:Brūcend af-2	Template:User af-2
Wealhmoru	胡萝卜
Flocc:Byrig on Francum	Category:法國聚居地
Flocc:Cent	Category:肯特
Flocc:Byrig on Fietname	Category:越南城市
Flocc:Byrig on þǣm Ucrægnan	Category:烏克蘭城市
Flocc:Byrig on Eotolwarum	Category:義大利城市
Flocc:Scotland	Category:蘇格蘭
Flocc:Spēonisc bōccræft	Category:西班牙文學
Flocc:Hēafodstōlas in Europe	Category:歐洲首都
Flocc:Hēafodstōlas in Asie	Category:亞洲首都
Flocc:Norðerne Īrland	Category:北愛爾蘭
Sadolīeg, Sūþgeorgia	薩德爾島 (南喬治亞群島)
Flocc:Īrisc bōccræft	Category:愛爾蘭文學
Bysen:CompactTOC	Template:CompactTOC
Flocc:Geāsparedu līc	Category:木乃伊
Bysen:Dmbox	Template:Dmbox
Flocc:Byrig on Californie	Category:加利福尼亞州聚居地
Flocc:Wikipedia tutorial	Category:维基百科使用指南
Bysen:Wikia	Template:Wikia
Flocc:World Trade Center	Category:世界貿易中心
Bysen:Rounddown	Template:Rounddown
Flocc:Loidis	Category:列斯
Flocc:Australisc Hēafodburg Landscipe	Category:澳大利亚首都领地
Bysen:Country data Cænada	Template:Country data Canada
Bysen:Color box	Template:Color box
Flocc:Angleseg	Category:安格尔西岛
Bysen:Coord/dec2dms	Template:Coord/dec2dms
Flocc:Cyþþubox	Category:側面模板
Bysen:Flag	Template:Flag
Bysen:Country data Barbados	Template:Country data Barbados
Bysen:Country data Empire of Japan	Template:Country data Empire of Japan
Bysen:Country data Free French	Template:Country data Free French Force
Bysen:Country data Martinique	Template:Country data Martinique
Bysen:Country data Åland Islands	Template:Country data Åland
Bysen:Lang-pl	Template:Lang-pl
Bysen:Brūcend pl-3	Template:User pl-3
Bysen:Brūcend pl-4	Template:User pl-4
Trojany (Masovian Voivodship)	特洛疆尼
Flocc:Willelm Shakespeare	Category:威廉·莎士比亚
Flocc:Land on Asie	Category:亚洲国家
Bysen:Fapages	Template:Fapages
Flocc:Windows gamen	Category:Windows游戏
Bysen:Landskap	Template:瑞典舊省
Flocc:Wicibōceras in þǣm Geānlǣhtum Rīcum American	Category:美国维基人
Bysen:Plegere-stycce	Template:Actor-stub
Bysen:Nigerie Rīce	Template:尼日利亚州
Flocc:Wikipedia protected edit requests	Category:維基百科編輯被保護頁面請求
Bysen:Brūcend la-4	Template:User la-4
Bysen:Brūcend la	Template:User la
Bysen:Brūcend it-4	Template:User it-4
Bysen:Brūcend is-3	Template:User is-3
Bysen:Brūcend fo-2	Template:User fo-2
Bysen:Brūcend fo	Template:User fo
Bysen:Brūcend el-4	Template:User el-4
Bysen:Brūcend el-3	Template:User el-3
Bysen:Brūcend cy-3	Template:User cy-3
Bysen:Brūcend cy-2	Template:User cy-2
Bysen:Brūcend cy-1	Template:User cy-1
Bysen:Brūcend cy	Template:User cy
Bysen:Brūcend ang	Template:User ang
Bysen:Szl icon	Template:Szl icon
Bysen:Lang-ty	Template:Lang-ty
Bysen:Lang-ti	Template:Lang-ti
Bysen:Lang-sq	Template:Lang-sq
Bysen:Lang-ro	Template:Lang-ro
Bysen:Lang-kl	Template:Lang-kl
Bysen:IPAc-en	Template:IPAc-en
Bysen:Lang-es	Template:Lang-es
Bysen:Lang-cy	Template:Lang-cy
Bysen:Lang-bn	Template:Lang-bn
Flocc:Westmidlandscīr	Category:西米德蘭茲郡
Bysen:ISO 639 name de	Template:ISO 639 name de
Bysen:StarCraft endebyrdnes	Template:星際爭霸系列
Bysen:Country data Ryūkyū Kingdom	Template:Country data Ryukyu Kingdom
Flocc:Wæringscīr	Category:瓦立克郡
Flocc:Wīcinga Ieldu	Category:維京時期
Wikipǣdia:Gecorene gemynddagas/Wēodmōnaþ	Wikipedia:历史上的今天/8月
Flocc:Seolh	Category:鳍足亚目
Flocc:Engla cyningas	Category:盎格魯-撒克遜君主
Flocc:Quebec	Category:魁北克
Flocc:Bryttisce ofersǣ landscipas	Category:英国海外领土
Flocc:Ostsǣ	Category:波羅的海
Flocc:Bysen Brūcend Box	Category:维基百科用户框
Flocc:Gūþ	Category:战争
Flocc:Ēastgermanisca sprǣca	Category:东日耳曼语支
Flocc:Lēoðlic scātung	Category:花樣滑冰
Bysen:Lang-zh	Template:Lang-zh
Bysen:Lang-mn	Template:Lang-mn
Bysen:Lang-fi	Template:Lang-fi
Bysen:Lang-sv	Template:Lang-sv
Flocc:Frencisc Polynesia	Category:法屬玻里尼西亞
Flocc:Germanisca sprǣca	Category:日耳曼語族
Bysen:Precision1	Template:Precision1
Bysen:Precision/tz	Template:Precision/tz
Bysen:Precision/tz/1	Template:Precision/tz/1
Flocc:Rōmānisc stǣr	Category:羅馬歷史
Flocc:Īshocig	Category:冰球
Wikipǣdia:Edit conflicts	Help:编辑冲突
Flocc:Constantinopolis	Category:伊斯坦堡
Wikipǣdia:Page history	Help:页面历史
Flocc:Mintan	Category:唇形科
Flocc:Langbeardnaland	Category:倫巴第
Wikipǣdia:Snellbred	Wikipedia:備忘單
Wikipǣdia:This page is protected	Wikipedia:獲保護頁面
Wikipǣdia:Sundortácnu	Help:特殊字母與符號
Flocc:Rōm	Category:罗马
Flocc:Norþhymbraland	Category:諾森伯蘭郡
Flocc:Scipu	Category:船艦
Flocc:Scrobbesbyrigscīr	Category:施洛普郡
Flocc:Byrig on Seringum	Category:中國聚居地
Flocc:Byrig on Gleawcesterscīre	Category:格羅斯特郡城鎮
Flocc:NHL	Category:國家冰球聯盟
Flocc:Byrig on Nīwum Hāmtūnscīre	Category:新罕布什尔州城市
Flocc:Byrig on Dūnholmscīre	Category:達勒姆郡城鎮
Sīðemestan dēaðas	歷年逝世人物列表
Flocc:Americanisc fōtball	Category:美式足球
Flocc:Stæffordscīr	Category:斯塔福德郡
Flocc:Bermuda	Category:百慕大
Flocc:Bearrucscīr	Category:伯克郡
Flocc:Norþgermanisca sprǣca	Category:北日耳曼语支
Flocc:São Paulo	Category:聖保羅 (巴西)
Flocc:Westgermanisca sprǣca	Category:西日耳曼语支
Flocc:Byrig on Sūþrigum	Category:薩里郡城鎮
Flocc:Byrig on Cornweallum	Category:康沃尔郡城镇
Flocc:Byrig on Cent	Category:肯特郡城鎮
Flocc:Dȳfung	Category:潛水
Flocc:Byrig on Scrobbesbyrigscīre	Category:施洛普郡市鎮
Flocc:Nīwre Gecȳþnesse bōc	Category:新约圣经书籍
Flocc:Antrimscīr	Category:安特里姆郡
Flocc:Celtisc sprǣc	Category:凱爾特語族
Flocc:Fōtþōðer	Category:足球類運動
Flocc:Bryttisce Scīre	Category:聯合王國的郡
Flocc:Wendelsǣs īega	Category:地中海島嶼
Flocc:Orcanege	Category:奥克尼群岛
Flocc:Byrig on Ēastseaxum	Category:東薩塞克斯郡城鎮
Flocc:Tūnas on Mageoscīre	Category:梅奥郡居民点
Flocc:Byrig	Category:城市
Flocc:Brūcend fo-3	Category:Fo-3 使用者
Flocc:Bretta Æþelingas	Category:英国王子
Wikipǣdia:Tutorial (External links)	Wikipedia:使用指南/外部链接
Flocc:Personal life	Category:生活
Flocc:Brūcend ang-0	Category:Ang-0 使用者
Flocc:Byrig on Brettum	Category:英國城市
Flocc:Self líf	Category:個人生活
Bysen:Coord/display/title	Template:Coord/display/title
Bysen:Year in other calendars	Template:Year in other calendars
Bysen:Ombox/core	Template:Ombox/core
Flocc:Brūcend en-1	Category:En-1 使用者
Flocc:Geboren in 1946	Category:1946年出生
Flocc:Brūcend de-1	Category:De-1 使用者
Flocc:Geboren in 1920	Category:1920年出生
Flocc:Germanisc mægþ	Category:日耳曼人
Flocc:Īrisce Scīre	Category:愛爾蘭的郡
Flocc:Skrælingcynn	Category:美洲原住民
Flocc:Byrig on Eoferwicscīre	Category:約克郡城鎮
Hunna Rīce	匈人帝國
Bysen:Bo	Template:Bo
Bysen:Kylie Minogue	Template:凱莉·米洛
Bysen:Mennisc bodiglārlicu ansīen	Template:人体解剖学
Wikipǣdia:Gecorene gemynddagas/Sēremōnaþ	Wikipedia:历史上的今天/6月
Wikipǣdia:Gecorene gemynddagas/Æfterra Gēola	Wikipedia:历史上的今天/1月
Wikipǣdia:Gecorene gemynddagas/Hrēþmōnaþ	Wikipedia:历史上的今天/3月
Wikipǣdia:Gecorene gemynddagas/Þrimilcemōnaþ	Wikipedia:历史上的今天/5月
Wikipǣdia:Tutorial (Talk pages)	Wikipedia:新手入門/討論
Wikipǣdia:Tutorial (Related site links)	Wikipedia:新手入門/方針指引
Bysen:Wiktionarylang	Template:Wiktionarylang
Bysen:Start date	Template:Start date
Bysen:Portas	Template:Portals
Wikipǣdia:10 þing þe þu nāst ymbe Wicipǣdian	Wikipedia:關於維基百科你或許不知道的十件事
Bysen:Brūcend ang-2	Template:User ang-2
Bysen:Brūcend ang-1	Template:User ang-1
Bysen:Brūcend ang-3	Template:User ang-3
Bysen:Nama	Template:Given name
Bysen:Elementbox isotopes decay	Template:Infobox element/isotopes decay
Bysen:Brūcend cy-4	Template:User cy-4
Bysen:Brūcend fo-4	Template:User fo-4
Bysen:Lang-kw	Template:Lang-kw
Bysen:Eald-Rōm-stycce	Template:Ancient-Rome-stub
Bysen:Infobox/row	Template:Infobox/row
Wikipǣdia:Tutorial (Wrap-up and more info)	Wikipedia:新手入門/總結
Bysen:Lang-sco	Template:Lang-sco
Wikipǣdia:Tutorial (Registration)	Wikipedia:新手入門/權限
Bysen:Seriesbox Aircraft Categories	Template:Seriesbox aircraft categories
Wikipǣdia:Ádihtoðes FAQ	Wikipedia:编辑者常见问题解答
Swǣfe	士瓦本
Wikipǣdia:IPA for Nīƿenglisce	Wikipedia:英語國際音標
Wikipǣdia:Protection log	Wikipedia:Protection log
Wikipǣdia:Block log	Wikipedia:Block log
Wikipǣdia:Deletion log	Wikipedia:删除纪录/存档
Hindberge	覆盆子
Bysen:End	Template:End
Bysen:Syndrigebocstafas	Template:Special characters
Wikipǣdia:Upload log	Wikipedia:上载纪录/存档
Bysen:Country flagairforce	Template:Air force/core
Lorde	洛德 (歌手)
Georgius Grantanbrycge Æþeling	喬治王子 (劍橋)
Flocc:Wæstmas	Category:農作物
Wikipǣdia:Administrators' reading list	Wikipedia:管理員必讀
Module:Yesno	模块:Yesno
Module:Category handler	模块:Category handler
Yun Hyon-seok	六友堂
Module:Arguments	模块:Arguments
Syndrig:RecentChanges	Special:最近更改
Flocc:Byrig on Langbeardum	Category:伦巴第大区城市
Module:Namespace detect	模块:Namespace detect
Flocc:Gestorfen in 1975	Category:1975年逝世
Module:Namespace detect/data	模块:Namespace detect/data
Module:Namespace detect/config	模块:Namespace detect/config
