Hĭ-ciŭ	非洲
Nĭk-buōng	日本
Nàng Mī-ciŭ	南美洲
Nò̤-ŭi	挪威
Ĭng-gáik-làng	英格兰
Sŭ-gáik-làng	蘇格蘭
Ŭi-ī-sê̤ṳ	威爾士
Báe̤k Ái-ī-làng	北爱尔兰
Ái-ī-làng	爱尔兰共和国
Hungary	匈牙利
Să̤-băng-ngà	西班牙
Mī-guók	美国
Bī-lé-sì	比利时
Luxembourg	卢森堡
Ṳ̄-dêu	宇宙
Dê-giù	地球
Sĕng-mêng	生命
Sī	死亡
Nè̤ng	人
Huăng-hī	快樂
George Washington	乔治·华盛顿
Wikidata	维基数据
Hŭng-làng	芬兰
Sôi-diēng	瑞典
Dăng-măk	丹麦
Pŏ̤-làng	波兰
Lithuania	立陶宛
É-dâi-lé	意大利
Sô̤i-sê̤ṳ	瑞士
Ó̤-dê-lé	奥地利
Hĭ-lé-nà̤	希腊
Tū-ī-gì	土耳其
Bì-ciū	啤酒
Può-dò̤-ngà	葡萄牙
Ĕu-ciŭ	欧洲
Ā-ciŭ	亚洲
Báe̤k Mī-ciŭ	北美洲
Nàng-gĭk-ciŭ	南极洲
Wikipedia	维基百科
Hò̤-làng	荷兰
Ĭng-gĕng	阴茎
PHP	PHP
Niū-iók-chê	纽约
Washington, D.C.	华盛顿哥伦比亚特区
Gô-gĭng-săng	旧金山
Báik-lìng	柏林
Los Angeles	洛杉矶
Diêng-nō̤	電子計算機
Sŭ-là̤-sié	苏黎世
Barack Obama	贝拉克·奥巴马
Uruguay	乌拉圭
MediaWiki	MediaWiki
Lùng-dŭng	伦敦
Bìng-guō	苹果
Bă-là̤	巴黎
Mĕ̤k-să̤-gŏ̤	墨西哥
Dâi-să̤-iòng	大西洋
Tái-bìng-iòng	太平洋
California	加利福尼亚州
Boston	波士顿
Lā̤-bái-ék	星期一
Huōi-sĭng	火星
Kenya	肯尼亚
Ethiopia	埃塞俄比亚
Gŭng-ciō (nguòng-siū)	君主
Ghana	加纳
Lā̤-bái-nê	星期二
Lā̤-bái-săng	星期三
Lā̤-bái-sé	星期四
Lā̤-bái-ngô	星期五
Lā̤-bái-lĕ̤k	星期六
Lā̤-bái-nĭk	星期日
Săi (mà-kuŏ dông-ŭk)	狮
Huák-guók	法国
Kēng	犬
Ĭng-guók	英国
Mà	猫
Dṳ̆ng-huà Ìng-mìng Gê̤ṳng-huò-guók	中华人民共和国
Huák-ngṳ̄	法语
Wiktionary	维基词典
Ngṳ̀	鱼
Ciū	酒
Bă-să̤	巴西
Ngò̤-lò̤-sṳ̆	俄罗斯
Hāi	海
Alabama	亚拉巴马州
Wikimedia	维基媒体基金会
Jimmy Wales	吉米·威爾斯
Dáik-guók	德国
Belarus	白俄罗斯
Dáik-ngṳ̄	德语
Bĭng-dō̤	冰岛
Estonia	爱沙尼亚
Tū-sĭng	土星
Hĭ-gĭ	固定翼飛機
Ciéng-cĕng	战争
1	1
2	2
3	3
4	4
5	5
0	0
George W. Bush	乔治·沃克·布什
Latvia	拉脫維亞
Ukraine	乌克兰
Ciék-káik	捷克
Slovakia	斯洛伐克
Slovenia	斯洛文尼亚
Moldova	摩尔多瓦
Romania	羅馬尼亞
Bulgaria	保加利亚
Lò̤-mā	罗马
Macedonia Gê̤ṳng-huò-guók	馬其頓共和國
Albania	阿尔巴尼亚
Croatia	克罗地亚
Bosnia gâe̤ng Herzegovina	波斯尼亚和黑塞哥维那
Azerbaijan	阿塞拜疆
Andorra	安道尔
Cyprus	賽普勒斯
Georgia (guók-gă)	格鲁吉亚
Kazakhstan	哈萨克斯坦
Malta	马耳他
Monaco	摩纳哥
Montenegro	蒙特內哥羅
Vaticano	梵蒂冈
San Marino	圣马力诺
Gū-bă	古巴
Belize	伯利兹
Barbados	巴巴多斯
Java	Java
Éng-dô-nà̤-să̤-ā	印度尼西亚
Tū-ī-gì-ngṳ̄	土耳其语
Nàng-hĭ	南非
Algeria	阿尔及利亚
Wiki Dù-cṳ̆-guāng	维基文库
Uzbekistan	乌兹别克斯坦
Huà-să	华沙
Può-dò̤-ciū	葡萄酒
Cūi	水
Chà	木材
Diêng-sê	电视
Chile	智利
Ià-sŭ	耶稣
Galileo Galilei	伽利略·伽利莱
Cūi-sĭng	水星
Lĭk-sṳ̄	历史
Gĭng-sĭng	金星
Ngṳ̄-ngiòng	語言
Ái	愛
Mŭk-sĭng	木星
Ngṳ̀ng-ò̤	银河系
Tiĕng-uòng-sĭng	天王星
Hāi-uòng-sĭng	海王星
Tiĕng-ùng	天文學
Sĭng-gă-pŏ̤	新加坡
Kuŏ-hŏk	科学
Mìng-uòng-sĭng	冥王星
Ciŏng-lài	未来
Séng-mū Mā-lé-ā	馬利亞 (耶穌的母親)
Liechtenstein	列支敦斯登
Adolf Hitler	阿道夫·希特勒
Dâ̤-nê-ché̤ṳ Sié-gái Dâi-ciéng	第二次世界大战
Wiki Gáu-kuŏ-cṳ̆	維基教科書
Wiki Ngṳ̄-liŏh	维基语录
Wiki Dâi-hŏk	维基学院
Cṳ̆ng	時鐘
Ubuntu	Ubuntu
Linux	Linux
Só-hŏk	数学
Lá-dĭng-ngṳ̄	拉丁语
Bahrain	巴林
Armenia	亞美尼亞
Serbia	塞尔维亚
Nguŏk-giù	月球
Istanbul	伊斯坦堡
Ó̤-ciŭ	澳大利亚
Ŭk-lī	物理学
Argentina	阿根廷
Peru	秘鲁
Dièu-siēng Mìng-ciō-ciō-ngiê Ìng-mìng Gê̤ṳng-huò-guók	朝鲜民主主义人民共和国
Gāng-puŏ-câi	柬埔寨
Gū-làng-gĭng	古兰经
Kṳ̄ng-lṳ̀ng	恐龙
Ĭ-sṳ̆-làng-gáu	伊斯兰教
Lì	梨
Lùng-lùng	輪
Huò-bìng	和平
Nṳ̄-gái	女性
Gū-chiŏng-kĕ̤ng	肛门
Nìng-mùng	柠檬
Bă-ciĕu	香蕉
Huă	花
Napoléon Bonaparte	拿破仑一世
Sĕng-lī	生理学
Hèng-sĭng	恒星
Nĭk-tàu	太阳
Victor Hugo	维克多·雨果
Dâi-iòng-ciŭ	大洋洲
Tái-iòng-hiê	太阳系
Ngāi	牙齒
Kĭng	氢
Wiki Gê̤ṳng-hiōng	维基共享资源
Cṳ̆	图书
Nĭk	日
Dĕ̤ng Timor	东帝汶
Màng-buŏ	晚上
Nièng	年
Ó̤-sṳ̆-lṳ̆k	奥斯陆
Lī-sṳ̆-buōng	里斯本
Táng	碳
Dâng	氮
Iōng	氧
Giàng-sĭng	行星
Kleopatra 7-sié	克娄巴特拉七世
Ĭng-ngŏk	音乐
É-dâi-lé-ngṳ̄	意大利语
Séng Peterburg	圣彼得堡
Chad	乍得
Lé̤ṳ	铝
Sĭng-să̤-làng	新西兰
Éng-dô	印度
Tuvalu	圖瓦盧
Tiék	铁
Tonga	東加
Samoa	萨摩亚
Solomon Gùng-dō̤	所罗门群岛
Vanuatu	瓦努阿图
Papua New Guinea	巴布亚新几内亚
William Shakespeare	威廉·莎士比亚
Palau	帛琉
Nauru	諾魯
Micronesia Lièng-băng	密克罗尼西亚联邦
Iòng (gĭng-sṳ̆k)	铅
Marshall Gùng-dō̤	馬紹爾群島
Kiribati	基里巴斯
Mūng-gū	蒙古国
Fiji	斐濟
Venezuela	委內瑞拉
Guók-cié chiông-gì	國際象棋
Genghis Khan	成吉思汗
Maine	缅因州
Mā	马
Ū-ké	武器
Dông-ŭk	动物
Suriname	蘇利南
Paraguay	巴拉圭
Guyana	圭亚那
Ecuador	厄瓜多尔
Colombia	哥伦比亚
Hŭk-gáu	佛教
Bolivia	玻利維亞
Dè̤ng	铜
Trinidad gâe̤ng Tobago	千里達及托巴哥
Sĭk-ŭk	植物
Séng Vincent gâe̤ng Grenadines	圣文森特和格林纳丁斯
New Hampshire	新罕布什尔州
Séng Lucia	圣卢西亚
Séng Kitts gâe̤ng Nevis	聖克里斯多福與尼維斯
Cĭng-kṳ̄ng	真菌
Jamaica	牙买加
Grenada	格林纳达
Massachusetts	麻薩諸塞州
Guatemala	危地马拉
Bahamas	巴哈马
Connecticut	康乃狄克州
Giĕ	鸡
Antigua gâe̤ng Barbuda	安提瓜和巴布达
Hawaii	夏威夷州
Honduras	洪都拉斯
Dominica	多米尼克
Dominica Gê̤ṳng-huò-guók	多明尼加
Dṳ̆	家豬
Báe̤k-bĭng-iòng	北冰洋
Haiti	海地
El Salvador	萨尔瓦多
Ĭ-lāng	伊朗
Iraq	伊拉克
Alaska	阿拉斯加州
Costa Rica	哥斯达黎加
Ī-sáik-liĕk	以色列
Panama	巴拿马
Yemen	也门
Bâng-dŭk	病毒
Pŏ̤-làng-ngṳ̄	波兰语
Jordan	约旦
Nicaragua	尼加拉瓜
Florida	佛罗里达州
Kyrgyzstan	吉尔吉斯斯坦
Arizona	亞利桑那州
Kuwait	科威特
Lō̤-kuŏ	老挝
Lebanon	黎巴嫩
Oregon	俄勒冈州
Maldives	马尔代夫
Mī-ciŭ	美洲
Utah	犹他州
Ngù	家牛
Mā-lài-să̤-ā	马来西亚
Miēng-diêng	缅甸
Nepal	尼泊尔
Oman	阿曼
Pakistan	巴基斯坦
Qatar	卡塔尔
Saudi Ā-lá-báik	沙特阿拉伯
Sri Lanka	斯里蘭卡
Joseph Stalin	斯大林
Syria	叙利亚
Platon	柏拉图
Tajikistan	塔吉克斯坦
Dṳ̆ng-huà Mìng-guók	中華民國
Aristoteles	亚里士多德
Tái-guók	泰国
Huōi-chiă	鐵路列車
Turkmenistan	土库曼斯坦
Ā-lá-báik Lièng-hăk Dâi-gŭng-guók	阿拉伯联合酋长国
Băh-gĭng	铂
Uŏk-nàng	越南
Dâi-hàng Mìng-guók	大韩民国
Afghanistan	阿富汗
Gĭng	金
Suez Ông-ò̤	苏伊士运河
Bangladesh	孟加拉国
Mali	马里共和国
Sokrates	苏格拉底
Angola	安哥拉
Bhutan	不丹
Ùng-lài	文莱
Tanzania	坦桑尼亚
Cūi-ngṳ̀ng	汞
Hĭ-lĭ-pĭng	菲律宾
Dṳ̆ng-hĭ Gê̤ṳng-huò-guók	中非共和國
Isaac Newton	艾萨克·牛顿
Albert Einstein	阿尔伯特·爱因斯坦
Uòng-sáik	黄色
Togo	多哥
Tunisia	突尼西亞
Zambia	赞比亚
Zimbabwe	辛巴威
Báe̤k-gĭng	北京市
Nàng Sudan	南蘇丹
Benin	贝宁
Botswana	波札那
Wiki Sĭng-ùng	维基新闻
Burkina Faso	布吉納法索
Burundi	蒲隆地
Comoros	葛摩
Congo Gê̤ṳng-huò-guók	刚果共和国
Congo Mìng-ciō Gê̤ṳng-huò-guók	刚果民主共和国
Djibouti	吉布提
Chiáh-dô̤ Guinea	赤道几内亚
Eritrea	厄立特里亚
Gabon	加蓬
Gambia	冈比亚
Guinea	几内亚
Guinea-Bissau	幾內亞比索
Côte d'Ivoire	科特迪瓦
Cameroon	喀麦隆
Cabo Verde	佛得角
Lesotho	莱索托
Liberia	利比里亚
Libya	利比亚
Madagascar	马达加斯加
Malawi	马拉维
Mauritania	毛里塔尼亚
Mauritius	毛里求斯
Morocco	摩洛哥
Mozambique	莫桑比克
Namibia	纳米比亚
Niger	尼日尔
Nigeria	奈及利亞
Charles Darwin	查尔斯·达尔文
Uganda	乌干达
Rwanda	卢旺达
Séng Tomé gâe̤ng Príncipe	圣多美和普林西比
Senegal	塞内加尔
Seychelles	塞舌尔
Carl Linnaeus	卡尔·林奈
Sierra Leone	塞拉利昂
Somalia	索马里
Julius Caesar	尤利烏斯·凱撒
Sudan	苏丹共和国
Swaziland	斯威士兰
Kê̤ṳng	彩虹
Lièng-hăk-guók	联合国
Dê-cék	地质学
Dê-lī	地理学
Sĭng-câung	心臟
Puòi-hŭ	皮膚
Ngàng-sáik	颜色
Làng-sáik	藍色
Ngṳ̀ng	銀
Sék	锡
Michigan	密歇根州
Illinois	伊利诺伊州
North Dakota	北达科他州
South Dakota	南达科他州
Montana	蒙大拿州
Wyoming	怀俄明州
Idaho	爱达荷州
Washington	华盛顿州
Nevada	内华达州
Éng-dô-iòng	印度洋
Kosovo	科索沃
Colorado	科羅拉多州
分類:Hŭng-lôi	Category:頁面分類
Chicago	芝加哥
Dĕ̤ng-tiĕng	冬季
Chŭng-tiĕng	春季
Hâ-tiĕng	夏季
Chiŭ-tiĕng	秋季
Saddam Hussein	萨达姆·侯赛因
Osama bin Laden	奥萨马·本·拉登
Să̤-băng-ngà-ngṳ̄	西班牙语
Philadelphia	費城
Tĭ-tṳ̆	蜘蛛
Guō-sĭk	果实
Gàu	猴
Cièng	貨幣
Virginia	弗吉尼亚州
West Virginia	西維吉尼亞州
Huăng-ciĕu	辣椒
Niū-iók-ciŭ	纽约州
Rhode Island	羅德島州
Kŏng-tṳ̀ng	昆虫
Maryland	马里兰州
Delaware	特拉华州
Vladimir Lenin	列宁
Ohio	俄亥俄州
Pennsylvania	宾夕法尼亚州
Augustus	奥古斯都
Microsoft Windows	Microsoft Windows
New Jersey	新泽西州
Hŭng-làng-ngṳ̄	芬兰语
Indiana	印第安纳州
Ké-chiă	汽车
Georgia	喬治亞州
Texas	德克萨斯州
North Carolina	北卡罗来纳州
South Carolina	南卡罗来纳州
Manila	马尼拉
Dĕ̤ng-gĭng	東京都
Uòng-lì	菠蘿
Mississippi	密西西比州
Tennessee	田纳西州
New Mexico	新墨西哥州
Ngà-diēng	雅典
Minnesota	明尼蘇達州
Baghdad	巴格达
Wisconsin	威斯康辛州
Iowa	艾奥瓦州
Nebraska	內布拉斯加州
Kansas	堪薩斯州
Hŏng-giāng	香煙
Missouri	密蘇里州
Louisiana	路易斯安那州
Kentucky	肯塔基州
Arkansas	阿肯色州
Oklahoma	奧克拉荷馬州
Madonna	麥當娜
Aceh	亞齊特區
Séng-gĭng	聖經
Phnom Penh	金边
Hù Cé-mìng Chê	胡志明市
Ò̤-nô̤i	河內市
Cĭng Ià-sŭ Gáu-huôi	真耶稣教会
Ĭng-ngṳ̄	英语
Màng-gók	曼谷
Kuala Lumpur	吉隆坡
Bangka Belitung Gùng-dō̤	邦加-勿里洞省
Dài-báe̤k	臺北市
Concepción	康塞普西翁 (智利)
Bengkulu	明古魯省
Końskowola	孔斯科沃拉
Nê-iōng-huá-táng	二氧化碳
Jambi	占碑省
Siè	蛇
Lampung	楠榜省
Guŏng-sók	光速
Riau	廖內省
Riau Gùng-dō̤	廖内群岛省
Nàng Sumatra	南苏门答腊省
Lò̤-mā Dá̤-guók	羅馬帝國
Mì-niōng	微软
Kó-lū-hŭ	库鲁夫
Huá-hŏk	化學
Sièng-sŏng	盐酸
Ôi-sĭng	衛星
Kă-giù	足球
Să̤ Sumatra	西苏门答腊省
Mā-dáik-lī	马德里
Michael Jackson	迈克尔·杰克逊
Cê̤ṳ-iù	自由
Cṳ̆-niòng-giāng	女孩
Sék-nà̤	悉尼
Liŏh-sáik	綠色
È̤ng-sáik	红色
Huōi	火
Sĭng Nàng Wales	新南威爾士州
Nile Ò̤	尼罗河
Banten	万丹省
Dṳ̆ng Jawa	中爪哇省
Chēng-chiū-sĭng	彗星
Dĕ̤ng Jawa	东爪哇省
Jakarta	雅加达
Ăng-kā-lá	安卡拉
Să̤ Jawa	西爪哇省
Yogyakarta	日惹特区
Dṳ̆ng Kalimantan	中加里曼丹省
Dĕ̤ng Kalimantan	東加里曼丹省
Báe̤k Kalimantan	北加里曼丹省
Nàng Kalimantan	南加里曼丹省
Hŏk-hâu	学校
Să̤ Kalimantan	西加里曼丹省
Dâi-hŏk	大學
Wikipedia:Să-buàng	Wikipedia:沙盒
Chió	住宅
Dê-dù	地图
Ò̤	河流
Osasco	奥萨斯库
Chiĕng-lī-giáng	望远镜
分類:Dài-uăng lĭk-sṳ̄	Category:台灣歷史
Curitiba	庫里奇巴
Sĕng-lìng	森林
分類:Uŏk-nàng lĭk-sṳ̄	Category:越南歷史
Iók-báik-cṳ̆	約伯記
Cĭng-ngiòng	箴言
Kūng-cṳ̄	孔子
Hà	十足目
分類:Só-hŏk	Category:数学
Bali	巴厘岛
Ĕu-nguòng	欧元
Mī-gĭng	美元
Dâi-lièu	辽朝
Hòng-ciŭ	杭州市
Gĭ-dók-gáu	基督教
Dĕ̤ng Nusa Tenggara	東努沙登加拉省
Să̤ Nusa Tenggara	西努沙登加拉省
Dṳ̆ng Sulawesi	中苏拉威西省
Gĭng-guók	金朝
Gorontalo	哥伦打洛省
Báe̤k Sulawesi	北苏拉威西省
Dĕ̤ng-nàng Sulawesi	东南苏拉威西省
Nàng Sulawesi	南苏拉威西省
Să̤ Sulawesi	西苏拉威西省
Seattle	西雅圖
Dêu	稻
Maluku	马鲁古省
Báe̤k Maluku	北马鲁古省
Papua	巴布亚省
Să̤ Papua	西巴布亞省
Cēu	鸟
Siū-dŭ	首都
Può-dò̤-ngà-ngṳ̄	葡萄牙語
Nguŏk	月
Uòng Hiêng-huàng	黄现璠
Cōng	钻石
Nĭk-buōng-ngṳ̄	日语
Báik-kuŏ-ciòng-cṳ̆	百科全书
Tàu Hiĕk	Wikipedia:首页
模板:Ô-lī-kó̤	Template:Good article
Saratov	薩拉托夫
Làng-giù	篮球
Olympic Ông-dông-huôi	奥林匹克运动会
Diòng-gĕ̤ng	长江
Che Guevara	切·格瓦拉
Mò̤ Dĕk-dŭng	毛泽东
Să̤-ăng	西安市
Lá-sák	拉萨市
Séng-gău	性交
Ĭng-dô̤	阴道
Diék-hŏk	哲学
分類:Ché̤ṳk-káik chēng-dṳ̀	Category:快速删除候选
Gáung-kìng	钢琴
Dà	茶
Marco Polo	马可·波罗
Hebe Camargo	赫柏·卡马戈
Gê̤ṳng-sāng-ciō-ngiê	共产主义
Cṳ̆-buōng-ciō-ngiê	资本主义
Guók-gă	国家
Mìng-cŭk	民族
Carthago	迦太基
Uōng-hiĕk liù-lāng-ké	网页浏览器
Siù-cūi	游泳
分類:Tiĕng-ùng	Category:天文学
Hŭk	佛
Lī Bĕk	李白
Dù-cṳ̆-guāng	图书馆
Sĕng-tái	生态学
Céng-dê	政治
Mìng-ciō	民主
Cìng-dièu	秦朝
Nobel Ciōng	诺贝尔奖
Cìng Sṳ̄-huòng	秦始皇
Dṳ̆ng-dĕ̤ng	中东
Háng-dièu	汉朝
Làu Băng	刘邦
Háng Ùng-dá̤	汉文帝
Háng Gīng-dá̤	汉景帝
Háng Ū-dá̤	汉武帝
Sĕng-ŭk	生物
Rabindranath Tagore	罗宾德拉纳特·泰戈尔
Háng Guŏng-ū-dá̤	汉光武帝
Gŭng-ciō-cié-dô	君主制
Siâ-huôi-ciō-ngiê	社会主义
Cṳ̆ng-chói	親吻
Nguòng-dièu	元朝
Háng Hióng-dá̤	汉献帝
Nazi Dáik-guók	納粹德國
Christopher Columbus	克里斯托弗·哥伦布
Dâng Huò	鄭和
Panama Ông-ò̤	巴拿马运河
Céng-dièu	晋朝
Nàng-bĭng-iòng	南冰洋
Uòng-ò̤	黄河
Sṳ̆-mā Ièng	司馬炎
Ngê	耳
Pé	鼻
Mĕ̤k-ciŭ	眼
Hŭng-muòng	蚊
Săi-ngṳ̀	鲨鱼
Lŏk-dò̤	骆驼
Chiông	象
Mā-ngiê	蚂蚁
Sùi-dièu	隋朝
Hò̤-làng-ngṳ̄	荷蘭語
Sùi Ùng-dá̤	隋文帝
Sùi Iòng-dá̤	隋炀帝
Să̤-hâ	西夏
Sóng-dièu	宋朝
Diêu Kuŏng-êng	赵匡胤
Sóng Tái-cŭng	宋太宗
Sóng Cĭng-cŭng	宋真宗
Sóng Ìng-cŭng	宋仁宗
Sóng Sìng-cŭng	宋神宗
Sóng Hŭi-cŭng	宋徽宗
Sóng Gŏ̤-cŭng	宋高宗
Sóng Lī-cŭng	宋理宗
Sóng Duăng-cŭng	宋端宗
Ögedei	窝阔台
Güyük	贵由
Möngke	蒙哥
Kublai	忽必烈
Huă-chái	花椰菜
Giò (sĭk-ŭk)	茄
Siók	雪
Niè-giāng	儿童
Cā-tàu	早晨
Hŭng-cṳ̆ng	分 (时间单位)
Ngò̤-lò̤-sṳ̆-ngṳ̄	俄语
Huák-lŭk	法律
Hièng-huák	宪法
Háng-ngṳ̄	汉语
Sá̤-bàu	细胞
Háik	血液
Hié (ké-guăng)	肺
Romania-ngṳ̄	羅馬尼亞語
Bulgaria-ngṳ̄	保加利亚语
Ṳ̄	雨
Dê-cīng	地震
Cūi-căi	洪灾
Hāi-lâung	海啸
Hùng	云
Hŭng-tăi	熱帶氣旋
Hŭng	風
Georgia-ngṳ̄	格鲁吉亚语
Háng-cê	汉字
Dièu-siēng-cê	諺文
Lá-dĭng cê-mō̤	拉丁字母
Ùng-hŏk	文學
分類:Ĭng-ngŏk	Category:音乐
分類:Ùng-hŏk	Category:文学
È̤ng-làu-máe̤ng	红楼梦
Hù-lì	狐
Harry Potter	哈利·波特
Chiū-ìng	自慰
Siâ-huôi	社会
Gáu-ṳ̆k	教育
Nàng-gái	男性
Ìng-guòng	人权
Temür	元成宗
Gŭng-sê̤ṳ	軍事
Gă-pĭ	咖啡
Săng	山
Khayisan	元武宗
Ayurbarwada	元仁宗
Shidibala	元英宗
Yesün Temür	泰定帝
Sŏng Dṳ̆ng-săng	孫中山
Hiŏng-gē̤ng	香港
Miami	迈阿密
Ragibagh	天順帝
Tugh Temür	元文宗
Kuśala	元明宗
Hàng Ciéng	朝鲜战争
Rinchinbal	元宁宗
Toghon Temür	元順帝
Siū-ék	首爾
Siông-hāi	上海市
Ùng-huá Dâi-gáik-mêng	文化大革命
Chĭng-dièu	清朝
Uŏk-nàng Ciéng-cĕng	越南战争
Thomas Edison	爱迪生
Armenia-ngṳ̄	亚美尼亚语
Ukraine-ngṳ̄	乌克兰语
HTML	HTML
Steven Spielberg	斯蒂芬·斯皮尔伯格
Mŏ̤h-ngiòng	莫言
Sôi-diēng-ngṳ̄	瑞典語
Dăng-măk-ngṳ̄	丹麦语
Nò̤-ŭi-ngṳ̄	挪威语
Luxembourg-ngṳ̄	卢森堡语
Ciék-káik-ngṳ̄	捷克语
Karl Marx	卡尔·马克思
Nĕng-nĕng	乳房
Guŏng	光
Hĭ-lé-nà̤-ngṳ̄	希腊语
Ái-ī-làng-ngṳ̄	愛爾蘭語
Kié-ngò̤	企鵝
Pŏ̤-sṳ̆-ngṳ̄	波斯语
Cŭng-gáu	宗教
Hàng-guók-ngṳ̄	朝鮮語
Cháung-sié-gé	創世記
Chók-Ăi-gĭk-gé	出埃及記
Háng-ngṳ̄ Guăng-uâ	官话
Uŏk-nàng-ngṳ̄	越南语
Sigmund Freud	西格蒙德·弗洛伊德
Tái-guók-ngṳ̄	泰语
Mā-lài-ngṳ̄	马来语
Mūng-gū-ngṳ̄	蒙古语
Bandar Seri Begawan	斯里巴加湾市
Hĭ-báik-lài-ngṳ̄	希伯来语
Ŭi-ī-sê̤ṳ-ngṳ̄	威尔士语
Sŭ-gáik-làng-ngṳ̄	苏格兰盖尔语
Vientiane	永珍
Lō̤-cṳ̄	老子
Găng-câung	肝臟
Sṳ̆-mā Chiĕng	司馬遷
Tó	兔
Ciŏ Hĭ	朱熹
Cìng-gāng	情绪
Dâi-iòng	洋
Victoria Nṳ̄-uòng	维多利亚 (英国君主)
Sék-giă-mèu-nà̤	释迦牟尼
Mŭk-hâng-mĕk-dáik	穆罕默德
Hŭ-ngék	呼吸
Ṳ̀-gă	儒家
Bók-lō̤	腹
Dô̤-gáu	道教
Chói-siĕk	舌
Dâiu-gáuk	頸
Chói	口腔
Elizabeth 2-sié	伊丽莎白二世
Dòng-dièu	唐朝
Dòng Gŏ̤-cū	李渊
Dòng Tái-cŭng	唐太宗
Dòng Gŏ̤-cŭng	唐高宗
Dòng Dṳ̆ng-cŭng	唐中宗
Dòng Iô-cŭng	唐睿宗
Ū Cáik-tiĕng	武则天
Dòng Hièng-cŭng	唐玄宗
Dòng Sé̤ṳk-cŭng	唐肅宗
Dòng Dâi-cŭng	唐代宗
Dòng Dáik-cŭng	唐德宗
Cê-mō̤	字母
Siēu-hŏk	小学
Mìng-dièu	明朝
Ciŏ Nguòng-ciŏng	朱元璋
Ronald Reagan	罗纳德·里根
Gióng-ùng Huòng-dá̤	建文帝
Īng-lŏk Huòng-dá̤	明成祖
Hùng-hĭ Huòng-dá̤	明仁宗
Sŏng-dáik Huòng-dá̤	明宣宗
Mìng Ĭng-cŭng	明英宗
Gīng-tái Huòng-dá̤	景泰帝
Sìng-huá Huòng-dá̤	明宪宗
Hùng-dé Huòng-dá̤	明孝宗
Céng-dáik Huòng-dá̤	明武宗
Gă-cêng Huòng-dá̤	明世宗
Lè̤ng-kéng Huòng-dá̤	明穆宗
Uâng-lĭk Huòng-dá̤	明神宗
Tái-chiŏng Huòng-dá̤	明光宗
Tiĕng-kiē Huòng-dá̤	明熹宗
Sùng-dĭng Huòng-dá̤	崇禎帝
Gĭng Céng-nĭk	金正日
Nguòng-só ciŭ-gĭ-biēu	元素周期表
Chăng-màng	失明
Sá̤-kṳ̄ng	细菌
Chéu	树
Può-dò̤	葡萄
Huăng-giāng-sṳ̀	马铃薯
Tòng	食糖
Uòng-dâu	大豆
Séng-sék	信息
Bó̤-cāi	報紙
Diêng-uâ	电话
Ùng-huá	文化
Huáng-ngṳ̄	梵语
Dâi-diòng	大肠
Siēu-diòng	小肠
Ĭ-hŏk	医学
Sièng	食盐
Huá-hŏk nguòng-só	化學元素
Unix	UNIX
Ùi-gì	围棋
Káh-dièu-nó̤h	玩具
Diêng-īng	电影
Gĭng-sṳ̆k	金属
Kă-dăk-chiă	自行車
Mièng-huă	棉花
Sók-dô	速度
Sì-găng	时间
Cāi	纸
Só-lâiu	塑料
Miêng-cék	面积
Gŭng-chióh	米 (单位)
Iù-diĕng-bău	玉米
Duâi-măk	大麦
Dĕ̤ng-nàng-ā	东南亚
Sīng-iòng	沈阳市
Tṳ̀ng-kéng	重庆市
Tiĕng-cĭng	天津市
Ū-háng	武汉市
Gū Ăi-gĭk	古埃及
Gū Hĭ-lé-nà̤	古希腊
Hṳ̀ng	熊科
Britney Spears	布蘭妮·斯皮爾斯
Ngàng	癌症
Măk	小麦
Cié-sē̤	高粱屬
Pó̤-sióng	身心障礙
Lĭk-huák	历法
Sìng-gĭng-bâng	精神病
Gregorius Lĭk-huák	公历
Tutankhamun	图坦卡蒙
Nguŏk-gĭng	月經
Mà-chiók	麻将
Ông-ò̤	运河
Detroit	底特律
Diòng-siàng	长城
Gĭng-cê-ták	金字塔
Osman Dá̤-guók	奥斯曼帝国
Guók-nô̤i sĕng-sāng cūng-dĭk	国内生产总值
Diêng	電
Ché̤ṳng	枪械
Lòng-gĭ-ché̤ṳng	机枪
Sáung-buàng	算盘
Tāng-káik	坦克
Chāu-muòi	草莓
Liĕk-chiĕ	荔枝
Ià-cī	椰
Tò̤	桃
Cáung-ngṳ̄	壮语
Siŏng-ngṳ̄	湘语
Mì-ngù-ī-ngṳ̄	维吾尔语
Lâung-gŏ̤	蛋糕
Wiki Ŭk-cṳ̄ng	維基物種
Nĕng-dáe̤k	胸罩
Ā-lá-báik-ngṳ̄	阿拉伯语
Cūng-lī	总理
Dièu-siēng Tái-cŭng	朝鲜太宗
Lù Ū-hièng	盧武鉉
Páuk Céng-hĭ	朴正熙
Siĕng-ìng-ciōng	仙人掌
Siŏh-tàu-lâung	鵝卵石
Iòng-bék	铅笔
Gă-sĭ	家具
Dó̤h	桌子
Ó̤-muòng	澳門
Liòng Cīng-ĭng	梁振英
Iē-giāng	椅
Hù Gīng-dò̤	胡锦涛
Sĭk Gê̤ṳng-bìng	习近平
Dòng-gêng-lĕ̤k	长颈鹿
Chĭng-dáung	深圳市
Guōng-dĕ̤ng	广东省
Guōng-să̤	广西壮族自治区
Sŭ-lièng	苏联
Kiák-sióng-gĭ	照相機
Kagoshima-gâing	鹿儿岛县
C ngṳ̄-ngiòng	C语言
Kă	脚
Ciēng	壁虎
Dô-dâing	蜥蜴
Giĕng-tàu	肩
Wikipedia:Bō̤-ciéng hō̤ ùng	Wikipedia:特色条目
模板:Link FA	Template:Link FA
Sié-gái	世界
Wikipedia:Duâi chéu â	Wikipedia:互助客栈
Busan	釜山廣域市
Lèng-huă	莲
Vermont	佛蒙特州
Denver	丹佛
Guōng-ciŭ	广州市
Ciōng Gái-sĭk	蔣中正
Gŏng Dĕk-mìng	江泽民
Ŭng Gă-bō̤	温家宝
Nàng-gĭng	南京市
Làu Dáik-huà	劉德華
Diŏng Hŏk-iū	张学友
Báe̤k-gĭng Dâi-hŏk	北京大学
Chĭng-huà Dâi-hŏk	清华大学
Ŭ-lū-mŭk-cà̤	乌鲁木齐市
Gŏng-sŭ	江苏省
Ciék-gŏng	浙江省
Dâing Siēu-bìng	邓小平
Lò̤-mā Gê̤ṳng-huò-guók	罗马共和国
Câung-kṳ̆	藏区
Să̤-câung	西藏自治区
Ciŭ Ŏng-lài	周恩来
Dṳ̆ng-guók Gê̤ṳng-sāng-dōng	中国共产党
Chiū-gĭ	移动电话
Dò̤-nēu	鸵鸟
Kŏng-hĭ Huòng-dá̤	康熙帝
Dièu-siēng	朝鲜 (称谓)
Lī Káik-giòng	李克强
Gŏ̤ Hèng-giông	高行健
Ciŏ Ṳ̀ng-gĭ	朱镕基
Lī Bèng	李鹏
Lòng	狼
Bìng-iōng	平壤
Sĭng-iók Séng-gĭng	新約聖經
9	9
Kiék	蠍子
Gièng-lè̤ng Huòng-dá̤	乾隆帝
Dṳ̆ng-guók Dâi-lṳ̆k	中国大陆
Háik-lṳ̀ng-gĕ̤ng-sēng	黑龙江省
Mā Ĭng-gāu	馬英九
Lè̤	驴
Wikipedia:Cék-liông ô-lī-kó̤ gì ùng-ciŏng	Wikipedia:優良條目
Sé-chiŏng	四川省
Gô-iók Séng-gĭng	旧约圣经
Séng-dáng-cáik	圣诞节
Săng-gáe̤k-hìng	三角形
Muammar Gaddafi	穆阿迈尔·卡扎菲
Lâu-hū	虎
Daejeon	大田广域市
Daegu	大邱廣域市
Sié-cŭng Dĕk-biék Cê̤ṳ-dé-chê	世宗特別自治市
Incheon	仁川廣域市
Gyeonggi Dô̤	京畿道
Bô-uăk-cáik	復活節
Ò̤-báe̤k	河北省
Bŏk Hĭ-lài	薄熙来
GNU Cê̤ṳ-iù Ùng-dáung Hṳ̄-kō̤-céng	GNU自由文档许可证
Uŏng Cĭng-ôi	汪精卫
Dìng Cūi-biēng	陳水扁
Dài-uăng	臺灣
À̤	鞋
Ngṳ̀ng-hòng	銀行
Lū Séng	鲁迅
7	7
8	8
Lĕ̤k	鹿科
Hù	湖泊
Sáung-tàu	蒜
Chái-guă	黄瓜
Dō̤	島嶼
Băh-sáik	白色
Ŭ-sáik	黑色
6	6
Moshchena	穆夏那
Huăng-kê	番茄
George H. W. Bush	乔治·赫伯特·沃克·布什
Paltoga	帕托加
Quảng Bình	廣平省
Atlanta	亚特兰大
Benito Mussolini	贝尼托·墨索里尼
Sṳ̀-diēng	詞典
Tàu	头
Hiê-lìng-dóng	惠灵顿
Dâi Bók-liĕk-diĕng Dō̤	大不列顛島
Las Vegas	拉斯维加斯
10	10
Alfred Nobel	阿尔弗雷德·诺贝尔
Tàu-sĕ̤	梳篦
Guòng-lĭk	權力
Mà-hùng-cēu	貓頭鷹
Dēng-cṳ̆ng	小时
Ké-chiông	气象学
Đà Nẵng	岘港市
Káh-chiók	喜鹊
Làng-huă	蘭科
Gă-săk	蟑螂
Ngáuk-ngṳ̀	鳄目
Lā-lì	穿山甲
Nàng-muōi-sĭng	萤科
Holocene	全新世
Hāi-báu	海豹
Bà̤-bá-cēu	鹪鹩
Ciáh-giāng	麻雀
Niccolò Cusano Dâi-hŏk	尼可罗库萨诺大学
Long An	隆安省
Thái Nguyên	太原省
Herodotus	希羅多德
Othello	奧賽羅
Nĭk-buōng-hāi	日本海
Dĕ̤ng-ā	东亚
Dĕ̤ng-ĕu	东欧
Vĩnh Phúc	永福省
Chĕ̤ng	葱
Liù-giù-guók	琉球国
Dièu-siēng uòng-dièu	李氏朝鲜
Gŏ̤-là̤	高麗 (918年－1392年)
Dâi-hàng Dá̤-guók	大韓帝國
Buŏk-hāi-guók	渤海国
Gŏ̤-gău-là̤	高句丽
Bì-bà-dâu-giék	蝙蝠
Báik-cá̤	百济
Sĭng-lò̤	新罗
Tàu-huók	頭髮
Hàng Hĭ	韩非
Uòng-dá̤	黄帝
Diéu-ngṳ̀-dài Liĕk-dō̤	釣魚臺列嶼
Gê̤ṳng-huò-dōng (Mī-guók)	共和黨 (美國)
Dṳ̆ng-guók	中國
Mìng-ciō-dōng (Mī-guók)	民主党 (美国)
Cūi-tiák	歐亞水獺
Sìng-dŭ	成都市
Buò-gŭng-ĭng	蒲公英
Tá	水母
Dâng-ciŭ	郑州市
Cūng-tūng	總統
Muāng-ciŭ-guók	满洲国
Gù-cŭi	斑鸠属
Só̤h	繩
Dṳ̆ng-guók Guók-mìng-dōng	中國國民黨
Hiăng-diê ciā-muói	兄弟姊妹
Ngâng	鸿雁
Ĕng-gŏ̤	鹦形目
Gŏ̤-giāng-hié	歌仔戲
Gă-huák	加法
Dài-uăng-sēng	臺灣省
Dŏ̤	小刀
Băng-mā	斑馬
Guók-cié biĕu-cūng cṳ̆-hô̤	国际标准书号
Đồng Nai	同奈省
Sóc Trăng	朔莊省
Quảng Ngãi	廣義省
Hà Tĩnh	河靜省
Cà Mau	金甌省
Quảng Nam	廣南省
Bến Tre	檳椥省
Khánh Hòa	慶和省
Káh-gă-ngṳ̄	客家语
Sơn La	山羅省
Huŏng-ngiòng	方言
Lev Trotsky	列夫·达维多维奇·托洛茨基
Quảng Ninh	廣寧省
Lạng Sơn	諒山省
Bắc Ninh	北寧省
Gáng-ngṳ̄	贛語
Sṳ̆-mā Guŏng	司马光
Mà-hṳ̀ng	大熊猫
Muāng-ngṳ̄	满语
Chiū	手
Dô Hū	杜甫
Gùng-dō̤	群島
Niŏh-niŏh	葉
Bŭk-buó	瀑布
Yasser Arafat	亚西尔·阿拉法特
Chṳ̆ng-sìng-ngṳ̄	沖繩語
Câung-ngṳ̄	標準藏語
Ngù-ngṳ̄	吴语
Tasmania	塔斯馬尼亞州
Ì-cô̤	肥皂
Hŭk-săng	佛山市
Ciĕu-huò Tiĕng-huòng	昭和天皇
Al-Qaeda	基地组织
Mò̤-táuk-chiă	摩托車
Ò̤-mā	河马
Anastacia	安娜塔西亚
Sĕk Gái	十誡
Huă-báu	豹
Să̤-ngiù	犀牛
Lò̤-buàng	指南针
Buáng-dō̤	半岛
Sĭng-giŏng	新疆维吾尔自治区
Mŭk-guă	番木瓜
Mì-sĕng-só	维生素
Gái-làng-chái	捲心菜
Giáng	鏡子
Ciŭ-dièu	周朝
Kāng-muòng-giāng	窗
Băh Gṳ̆ng	白宮
Gīng-chák	警察
Hók-ciŭ-uâ	福州話
Báe̤k-hāi-dô̤	北海道
Giŏng	薑
Nobel Huò-bìng Ciōng	诺贝尔和平奖
Sáu	咳嗽
Hák-chê	噴嚏
Káung-mìng	睡眠
Gèng-hāi	鹹海
Dé̤ṳk	竹
Hù Cé-mìng	胡志明
Hòa Bình	和平省
Sŭ Sék	苏轼
Queensland	昆士蘭州
Tù	土壤
Ù-huă-guō	無花果
Hưng Yên	興安省 (越南)
Dòng-dô	长度
Kon Tum	崑嵩省
Hậu Giang	後江省
Máe̤ng	夢
Yên Bái	安沛省
Bắc Giang	北江省
Thừa Thiên-Huế	承天順化省
Bắc Kạn	北𣴓省
Lai Châu	萊州省
Hà Nam	河南省 (越南)
Lào Cai	老街省
Mìng-dĕ̤ng-ngṳ̄	閩東語
Hannibal	汉尼拔
Mìng-báe̤k-ngṳ̄	闽北语
Mìng-nàng-ngṳ̄	闽南语
Thanh Hóa	清化省
Kiên Giang	堅江省
Quảng Trị	廣治省
Nghệ An	乂安省
An Giang	安江省
Tây Ninh	西寧省
Phú Thọ	富壽省
Duâi-sĭng-sĭng	大猩猩
Trà Vinh	茶榮省
Bạc Liêu	薄遼省
Gia Lai	嘉萊省
Tiền Giang	前江省
Bình Phước	平福省
Đồng Tháp	同塔省
Thái Bình	太平省
Hà Giang	河江省
Đắk Lắk	多樂省
Cáung-cŭk	壮族
Bình Định	平定省
Lâm Đồng	林同省
Đắk Nông	得農省
Phú Yên	富安省
Hải Dương	海陽省
Dièu-ciŭ-uâ	潮州话
Iók-hâng Hók Ĭng	約翰福音
Dài-uăng-uâ	臺灣話
Muòng	門 (建築部件)
Chiēng-gák	指甲
Cao Bằng	高平省
Bình Dương	平陽省
Bình Thuận	平順省
Bà Rịa-Vũng Tàu	巴地頭頓省
Ninh Bình	寧平省
Ninh Thuận	寧順省
Nam Định	南定省
Điện Biên	奠邊省
Sìng-lṳ̀ng	成龍
Méng	臉
Ùng-ngiòng-ùng	文言文
Gāng-lāng	橄欖 (木樨科)
Săng-ôi-ék-tā̤	三位一體
Sŏng-cṳ̄	孙武
Sĭng-săng	教师
Cleveland	克里夫蘭 (俄亥俄州)
Dăk-lâi Lā-mà	达赖喇嘛
Huă-sĕng	花生
100	100
Kă-kók-tàu	膝
Hâing	杏
Ngāng-giáng	眼鏡
Cê̤ṳ-lài-huōi	火柴
Chê-diòng	市场
Nàng Dṳ̆ng-guók Hāi	南海
Dièu-siēng Sié-cŭng	朝鮮世宗
Hăk-gĭng	合金
Bĭng-siŏng	冰箱
Nobel Ùng-hŏk Ciōng	诺贝尔文学奖
Huăng-sṳ̀	番薯
Uòng-hāi	黄海
Akihito	明仁
Newton ông-dông-hŏk dêng-lŭk	牛顿运动定律
Să̤-guă	西瓜
Biobío Dâi-hŏk	比奥比奥大学
Huòng-dá̤	皇帝
Ìng-mìng-bê	人民币
Tā̤-cék	体积
Cèng-sáik	橙色
Gă-sĭ-huă	工具
Ĭ-sĕng	医生
Iéng (cēu)	燕科
Kó	褲
Lô-gă Hók Ĭng	路加福音
Mìng-ciō-dōng	民主党
Ciŏng-tàu	磚
Tiō-uòng	椭圆
Sìng-huák	乘法
Sé̤ṳ-dù Hèng-diông	使徒行传
Uòng-dô̤ Sĕk-nê Sĭng-cô̤	黃道帶
Huá-siŏh	化石
Gēng-huák	減法
Cī-cī	種子
Chiĕk	螃蟹
Gă-dŏ̤	剪刀
Niêu	尿
Ăng-hŭi	安徽省
Ngiăh	前额
Sĭ-piĕng	詩篇
Chungcheong Báe̤k-dô̤	忠清北道
Chungcheong Nàng-dô̤	忠清南道
Gangwon Dô̤ (Dâi-hàng Mìng-guók)	江原道 (韓國)
Nô̤i Mūng-gū	内蒙古自治区
Gĭng Nĭk-sìng	金日成
Gyeongsang Nàng-dô̤	庆尚南道
Gyeongsang Báe̤k-dô̤	庆尚北道
Jeolla Báe̤k-dô̤	全羅北道
Jeolla Nàng-dô̤	全羅南道
Jeju Dĕk-biék Cê̤ṳ-dé-dô̤	濟州特別自治道
Huăng-cièng-giāng	硬幣
Bă-biĕk-ták	巴別塔
Ulsan	蔚山广域市
Gwangju	光州廣域市
Chó	醋
Kangwŏn Dô̤ (Dièu-siēng Mìng-ciō-ciō-ngiê Ìng-mìng Gê̤ṳng-huò-guók)	江原道 (朝鮮)
Michael Jordan	迈克尔·乔丹
Lé-ê-gé	利未記
Gṳ̆ng-gṳ̆ng	根
Bì-bà (cūi-guō)	枇杷
Hamlet	哈姆雷特
Huà Guók-hŭng	华国锋
Sāng	傘
Làu Hiēu-pŏ̤	刘晓波
Hók-gióng	福建省
Mūng-gū-cŭk	蒙古族
Mĕk-sê Liŏh	启示录
Hièng-câung	玄奘
Gū-chiŏng	臀
Mìng-chòng	床
Hāi-nàng	海南省
Háng-ngṳ̄ Pĭng-ĭng	汉语拼音
Uōng-dĕ̤ng	遠東
Băh-gák	原鸽
Găng-sé̤ṳk	甘肃省
Taliban	塔利班
Huŏi-sáik	灰色
Sĭng-mêng-gé	申命記
Sŭ-ciŭ	苏州市
Ŭng-ciŭ	温州市
Háng-cŭk	汉族
Nìng-pŏ̤	宁波市
Chói-chiŭ	鬍鬚
Cāi-iêu	风筝
Hăk-ī-bĭng	哈尔滨市
Mā-kì	蚂蟥
1000	1000
Mìng-só-gé	民數記
Cáu-sèng	廚房
Hùng-nàng	云南省
Lō̤-uă	乌鸦
Guók-lĭk Gău-tŭng Dâi-hŏk	國立交通大學
Guók-lĭk Chĭng-huà Dâi-hŏk	國立清華大學
Săng-dĕ̤ng	山东省
È̤ng-ĕ̤ng	蜈蚣
Ò̤-nàng	河南省
Mì-mò̤	眉毛
Bók-sài	肚脐
Lièu-nìng	辽宁省
Hióng-liông	矢量
Cretaceous	白垩纪
Tochigi-gâing	栃木縣
Chói-mò̤-cēu	翠鸟
Dàu	骰子
Cūi-nà̤	水泥
Gék-lìng	吉林省
Dĕ̤ng Dṳ̆ng-guók Hāi	东海
Hāi-chĕk	海盗
Gūi	鬼
Lè̤ng-ū Huòng-dá̤	隆武帝
Bóng-dó̤	垃圾
Hù-nàng	湖南省
Jurassic	侏罗纪
Chĭng-hāi	青海省
Mì-ngù-ī-cŭk	维吾尔族
Ă-piéng	鸦片
Chiū-cī	戒指
Hù-báe̤k	湖北省
Săng-să̤	山西省
Cĕ̤ng-sáik	褐色
Giòng-găng	强奸
Gói-ciŭ	贵州省
Triassic	三叠纪
Sék-sáuk	蟋蟀
Cāi-piéu	紙幣
SQL	SQL
Hù Sék	胡適
Iók-cṳ̆-ā-gé	約書亞記
Cŏng-cṳ̄	庄子
Cṳ̀-hĭ Tái-hâiu	慈禧太后
Kan Naoto	菅直人
Miyagi-gâing	宮城縣
模板:Commons category	Template:Commons category
Lò̤-mā Cṳ̆	羅馬書
Pău-ŭk-siáng	抛物线
Dô̤-dáik	道德
Iwate-gâing	岩手县
Ĭ-siòng-chiă	縫紉機
Dièu-siēng Lò̤-dông-dōng	朝鲜劳动党
Nàng-báe̤k-dièu	南北朝
Chái Ĭ-lìng	蔡依林
Pì-lĭk-bī Cṳ̆	腓立比書
Ngā-gŏ-cṳ̆	雅歌
Mā-lăk-gĭ-cṳ̆	瑪拉基書
模板:Taxobox	Template:Taxobox
分類:Gŭng-ciō	Category:君主
Diŏng Ngiê-mèu	张艺谋
模板:Dṳ̆ng-guók lĭk-sṳ̄	Template:中国历史
Gĭng Céng-ŏng	金正恩
Liù-giù-ngṳ̄	琉球語
Mìng-dṳ̆ng-ngṳ̄	闽中语
Céng-ngṳ̄	晋语
Mìng-ngṳ̄	闽语
Buò-siĕng-ngṳ̄	莆仙語
Dài-uăng Mìng-nàng-ngṳ̄ Lò̤-mā-cê Pĭng-ĭng Huŏng-áng	臺灣閩南語羅馬字拼音方案
Gŏng-să̤	江西省
Dài-uăng-sēng (Dṳ̆ng-huà Ìng-mìng Gê̤ṳng-huò-guók)	台湾省 (中华人民共和国)
Nìng-hâ	宁夏回族自治区
Lùng-sùng	龍舟
Noda Yoshihiko	野田佳彥
Yingluck Shinawatra	英樂·欽那瓦
Siŏh-gă-cŏng	石家庄市
Kuóh-dà̤	福州疍民
Chṳ̄	鼠
Ciŏ-hāi	珠海市
Sáng-tàu	汕头市
Dâng-gŏng	湛江市
Mùi-ciŭ	梅州市
Chĭng-uōng	清远市
Dĕ̤ng-uāng	东莞市
Dṳ̆ng-săng-chê	中山市
Dièu-ciŭ	潮州市
Tàng-táik	鮎形目
Gé̤ṳk-huă	菊属
Mĕ̤k-lê-huă-dà	茉莉花茶
Sofie gì Sié-gái	蘇菲的世界
Ordovician	奥陶纪
Silurian	志留紀
Hók-gióng-sēng (Dṳ̆ng-huà Mìng-guók)	福建省 (中華民國)
Mièu-lĭk	苗栗縣
Dāng-nòng	胆囊
Devonian	泥盆纪
Hók-ciŭ	福州市
Nàng-bìng	南平市
Buò-dièng	莆田市
Săng-mìng	三明市
Ciòng-ciŭ	泉州市
Â-muòng	厦门市
Ciŏng-ciŭ	漳州市
Lṳ̀ng-ngàng	龙岩市
Nìng-dáik	宁德市
Să̤-nìng	西宁市
Să̤-iù-gé	西游记
Săng-guók Iēng-ngiê	三国演义
Cūi-hū	水浒传
Ā-dŏng	亞當
Aomori-gâing	青森縣
Fukushima-gâing	福岛县
Tái-nguòng	太原市
Hải Phòng	海防市
Sĭng-dé̤ṳk (gâing)	新竹縣
Dâi-lièng	大连市
Hĭ-Pŏ̤ Ciéng-cĕng	波希战争
Permian	二叠纪
Biēu-chĭng	表親
Cambrian	寒武纪
Iòng-ciók	蜡烛
Chiba-gâing	千葉縣
Pău	柚子
Lô-dáik-gé	路得記
Mà-hù	蜻蜓
Dáng-ī-lī	但以理書
Páuk-káik	撲克
Mô̤	帽子
Gŏ̤-lìng-dŏ̤ Cièng Cṳ̆	哥林多前書
Aichi-gâing	愛知縣
Lī-ngṳ̀	鯉
Muāng-ciŭ	满洲地区
Sê̤ṳ-sṳ-gé	士師記
Pŏ̤-lìng-chái	菠菜
Akita-gâing	秋田县
Pièu-gĕng	匙
Dê̤ṳ	筷子
Mĕ̤k-lê	素馨属
Nàng-dàu	南投縣
Gié-tiàng-chiă	出租車
Â-hài	頷
Gŭ	蕈類
Ibaraki-gâing	茨城縣
Lài-gŭng	雷
Siĕu-sŏng	硝酸
Ngù-giāng-kó	牛仔裤
Bō̤-siŏh	寶石
Lièu-că̤ Cé-ê	聊齋志異
Gáu-kuŏ-cṳ̆	教科書
Chāu-māng	草蜢
Dâng Gĭng	鄭經
Diòng-chŭng	长春市
Milan Kundera	米兰·昆德拉
Lâung	蛋
Ū-ì-săng-chê	武夷山市
Lĕ̤k-sé Sê̤ṳ-giông	六四事件
Diêu Ciē-iòng	赵紫阳
Hù Iêu-băng	胡耀邦
Fukuda Yasuo	福田康夫
Sṳ̀ng-chéu (Sṳ̀ng-báh)	松科
Gī-hò̤-chiă	圆规
Táng-sŏng	碳酸
Liòng-chióh	尺子
Chăng-màng-chṳ̄	鼴科
Dṳ̆ng-hâ Iâ cĭ Máe̤ng	仲夏夜之夢
Tié-tàu-să-hô	理发师
Mā-kō̤ Hók Ĭng	馬可福音
Diê (dông-ŭk)	牡蠣
Kaesŏng	开城特级市
Hwanghae Báe̤k-dô̤	黄海北道
P'yŏng'an Báe̤k-dô̤	平安北道
Hamgyŏng Báe̤k-dô̤	咸镜北道
Hamgyŏng Nàng-dô̤	咸镜南道
P'yŏng'an Nàng-dô̤	平安南道
Namp'o	南浦特別市
Ryanggang Dô̤	两江道
Tò̤-huòng	桃園市
Sŭk-mī	糯稻
Nguòng-siĕu-uòng	湯圓
Gĭng-dŭ	京都府
Ōsaka-hū	大阪府
Cék-ngṳ̀	鲫鱼
Fukuoka-gâing	福冈县
Ehime-gâing	爱媛县
Gŏ̤-lìng-dŏ̤, Hâiu Cṳ̆	哥林多後書
Gàu-ūng	蚯蚓
Sā̤-ĭ-gĭ	洗衣機
Gék	橘
Gé̤ṳ	鋸
Yamagata-gâing	山形县
Éu-dê-huòng	幼稚園
Dài-uăng Hāi-hiĕk	台灣海峽
Lù-guói	芦荟
Yamaguchi-gâing	山口县
Kanagawa-gâing	神奈川縣
Nagano-gâing	长野县
Iĕng-huă	烟火
Mì-pŏ̤-lù	微波炉
Saitama-gâing	埼玉縣
Mie-gâing	三重县
Hĭ-báik-lài Cṳ̆	希伯來書
Gă-lăk-tái Cṳ̆	加拉太書
Muàng-ngṳ̀	鰻
Céng-gŏng	晋江市
Siŏng-dièu	商朝
Gunma-gâing	群馬縣
Hyōgo-gâing	兵库县
Miyazaki-gâing	宮崎縣
Kumamoto-gâing	熊本縣
Ă-cì	蝉
Koizumi Jun'ichirō	小泉纯一郎
Liĕk-uòng-gé-liŏk Siông	列王紀上
Ī-sê̤ṳ-táik-cṳ̆	以斯帖記
Diòng-dô-cṳ̆	傳道書
Hatoyama Yukio	鳩山由紀夫
Gŏ̤-lò̤-să̤ Cṳ̆	歌羅西書
Ngā-gáuk Cṳ̆	雅各書
Iók-hâng Ék Cṳ̆	約翰一書
Pì-lé-muòng Cṳ̆	腓利門書
Táik-sák-lò̤-nà̤-giă, Hâiu Cṳ̆	帖撒羅尼迦後書
Táik-sák-lò̤-nà̤-giă Cièng Cṳ̆	帖撒罗尼迦前书
Bī-dáik Cièng Cṳ̆	彼得前書
Bī-dáik Hâiu Cṳ̆	彼得後書
Tì-mò̤-tái Cièng Cṳ̆	提摩太前書
Dòng-lòng	螳螂
Gifu-gâing	岐阜县
Ishikawa-gâing	石川縣
Nara-gâing	奈良县
Wakayama-gâing	和歌山县
Shizuoka-gâing	靜岡縣
Shiga-gâing	滋贺县
Iók-hâng Nê Cṳ̆	約翰二書
Ī-suói-ā-cṳ̆	以賽亞書
Iók-hâng Săng Cṳ̆	約翰三書
Iù-dâi Cṳ̆	猶大書
Tì-mò̤-tái Hâiu Cṳ̆	提摩太後書
Tì-dŏ̤ Cṳ̆	提多書
Nùng-mìng	農夫
Ià-lé-mī-cṳ̆	耶利米書
Ī-sê̤ṳ-lá-cṳ̆	以斯拉記
Nà̤-hĭ-mī-cṳ̆	尼希米記
Iók-ngī-cṳ̆	約珥書
Băh-lô	白鹭
Chŭng-cáik	春節
Sō-siè	鑰匙
Abe Shinzō	安倍晋三
Asō Tarō	麻生太郎
Séng-cṳ̆-tā̤	圣书体
Niigata-gâing	新潟县
Yamanashi-gâing	山梨县
Shimane-gâing	岛根县
Toyama-gâing	富山縣
Okayama-gâing	岡山縣
Kă-tōi	腿
Piăng	背
Piĕ	书信
Sáik-màng	色盲
Carboniferous	石炭纪
Ciŏng-huá	彰化縣
Fukui-gâing	福井縣
Ōita-gâing	大分县
Tottori-gâing	鳥取縣
Nùng-lĭk	農曆
Kōchi-gâing	高知县
Uâng-iū īng-lĭk dêng-lŭk	牛顿万有引力定律
Chèng-gēng	蚕
Dài-uăng Nĭk-buōng Sì-dâi	台灣日治時期
Páuk Gê̤ṳng-hiê	朴槿惠
Dài-nàng	臺南市
Cĕng	針
Muāng-cŭk	满族
Kìng-giāng	鉗
Anna Karenina	安娜·卡列尼娜
Tài-nè̤ng	杀人
Gáung-gṳ̆ng	鋼筋
Tiè-mà	哭
Swadesh hŏk-sĭng-sṳ̀ liĕk-biēu	斯瓦迪士核心詞列表
Dŭng-nìng-guók	明鄭時期
Hùng-lìng	雲林縣
Diāng	锅
Kă-cāi	腳趾
Lāng	唾液
Diò-să-hô	廚師
Bĭng-lòng	檳榔
Dâi-céng Tiĕng-huòng	大正天皇
Băng-sièng Lā-mà	班禅额尔德尼
Mŭk-gê̤ṳng	木槿
Muòi-huă	梅
Cĕ̤ng-chéu	棕榈
Muòi-kṳ̄ng	黴菌
Gĭng-cá̤	经济
Sĕ̤ng-săng-giāng	雙胞胎
Mĕ̤k-tiák	睫毛
Nguòng-cṳ̄-bék	原子筆
Norodom Sihanouk	諾羅敦·西哈努克
Saga-gâing	佐贺县
Tokushima-gâing	德岛县
Lòng-dâung	天仙子 (植物)
Lòi-sĭ-gā	螺钉旋具
Kēng-muōi-dăi	小米
Sĭk-sĭk	翅膀
Kagawa-gâing	香川县
Mū-dăng	牡丹
Thaksin Shinawatra	達新·欽那瓦
Uòng-dăi	黍
Kê	柿
Săng-guók (Dièu-siēng)	朝鲜三国时代
Bék	筆
Ŭng-dìng	灰塵
Huăng-siŏh-liù	番石榴
Duâi-tàu-giáng	放大鏡
Gă-ngiê (gâing)	嘉義縣
Ĭ-gŭng	祖父母
Puái-dáu	中午
Huōi-căi	火災
Chiū-ló̤h	手套
Nagasaki-gâing	长崎县
Hâ-dièu	夏朝
Cá̤-nàng	济南市
Dṳ̆ng-guók Káung-nĭk Ciéng-cĕng	中国抗日战争
Sarawak	砂拉越
Hŭng-cūi	風水
Chiéu	笑
Ngô̤-mâng gâe̤ng Piĕng-giéng	傲慢與偏見
Oda Nobunaga	織田信長
Dăng-hù	珊瑚
Lī Sìng-uāng	李承晚
Iòng-bék-chó̤	橡皮擦
Nàng-chiŏng	南昌市
Tokugawa Ieyasu	德川家康
Bók-séu-gáung	不鏽鋼
Sáu-chiū	帚
Dŭk-cài	独裁
Kŭng-dièu	空氣調節
Diòng-să	长沙市
Pèng	涂料
Mìng-dê Tiĕng-huòng	明治天皇
Kă-âu-dăng	踵
Ā-mò̤-sê̤ṳ-cṳ̆	阿摩司書
Ŏ̤-bă-dī-ā-cṳ̆	俄巴底亞書
Itō Hirobumi	伊藤博文
Nguŏh	玉
Só-gé̤ṳ-kó guāng-lī hiê-tūng	数据库管理系统
Dâu-hô	豆腐
Mì-hèu	獼猴
Mī-giă-cṳ̆	彌迦書
Bù-sák	菩萨
Hăk-gĭ-cṳ̆	哈該書
Ī-să̤-giék	以西結書
Chiū-biēu	手表
ASP.NET	ASP.NET
Iók-nā-cṳ̆	約拿書
Sabah	沙巴
Ià-lé-mī-ăi-gŏ̤	耶利米哀歌
Tái-gáng	宦官
Nàng-nìng	南宁市
Ê-só	味精
Nā-ŭng-cṳ̆	那鴻書
Hăk-bă-gók-cṳ̆	哈巴谷書
Sák-gā-lé-ă-cṳ̆	撒迦利亞書
Guók-gê̤ṳng Nô̤i-ciéng	国共内战
Uŏk-nàng Gê̤ṳng-huò-guók	越南共和国
Chiĕu-chê	超級市場
Ciŏng Cṳ̄-ì	章子怡
Lák-tàu	禿頭
Gulliver Lṳ̄-hèng-gé	格列佛遊記
Gŏ̤-hṳ̀ng	高雄市
Naha-chê	那霸市
Buŏk-hāi	渤海
Báh-chói	哈欠
Hâung Ṳ̄	项羽
Putrajaya	布城
Kŏng-mìng	昆明市
Nĭk-guŏng-dĕng	螢光燈
Jane Eyre	简·爱
Johor	柔佛州
Ngâung	智能障礙
Huòi-cŭk	回族
Làng-ciŭ	兰州市
Hŏ̤-să̤-cṳ̆	何西阿書
Tiék-cĭng	铁锈
Dĕ̤ng-kiĕ	乌贼
Lìng Cáik-sṳ̀	林则徐
Săng-guók	三国
Chŭng-chiŭ Sì-dâi	春秋时期
Ciéng-guók Sì-dâi	戰國
Puō-ngì	溥仪
Mā-lăk-gă	马六甲
Oracle	Oracle数据库
Hăk-bùi	合肥市
Huák-lùng-gŭng	法轮功
Kelantan	吉兰丹
Lŏk-iòng	洛阳市
Toyotomi Hideyoshi	丰臣秀吉
Kana	日語假名
Câung-cŭk	藏族
Pulau Pinang	槟城
Hamasaki Ayumi	濱崎步
Să̤-huăng-ngā-cṳ̆	西番雅書
Dâi-nĭk-buōng Dá̤-guók	大日本帝国
Hṳ̆ng-nù	匈奴
Mâing-cṳ̄	孟子
Kedah	吉打
Perak	霹靂州
Hŏk-ôi	学位
Gié-lìng	桂林市
Terengganu	登嘉樓
Selangor	雪蘭莪
Iòng (dông-ŭk)	羊亚科
Hāi-kāu	海口市
Chāu-buōng sĭk-ŭk	草本植物
Pahang	彭亨
Bă-là̤ Séng-mū-iêng (Siēu-siók)	巴黎聖母院 (小說)
Chiông-gì	象棋
Yun Chi-ho	尹致昊
Gói-iòng	贵阳市
Gáung-bék	鋼筆
Ngù Dìng-iēng	吳廷琰
Gô-dā̤	過去
Dĭng-hiŏng-kó̤	鳀科
Miêng	面条
Hiêng-câi	現在
Lèng-gēng	龙眼
Mì-lĕk-hŭk	彌勒菩薩
Guăng-ĭng	觀世音菩薩
Bìng-dĕ̤ng	屏東縣
Gēu-gī	枸杞
Lĕ̤k-dèu-gáuk	肋骨
Ciŏng-bìng	漳平市
Ciŏng-puō	漳浦县
Ciéu-ăng	诏安县
Dâng Sìng-gŭng	鄭成功
Céng-huò	政和县
Ciá-ìng	柘荣县
Nguŏk-biāng	月饼
Ciŭ Īng-kŏng	周永康
Ciŭ-nìng	周宁县
Cṳ̆-gák Liông	诸葛亮
Ció-ĭng Hù-hô̤	注音符號
Pàng-hù-gâing	澎湖縣
Tù-kēng	螻蛄
Dṳ̆ng-guók Ìng-mìng Gāi-huóng-gŭng	中国人民解放军
Sìng-ū Tiĕng-huòng	神武天皇
Kūng-chiók	孔雀
Ciē-chái	海苔
Dennis Rodman	丹尼斯·罗德曼
È̤ng-dà	红茶
Cò̤ Chó̤	曹操
Lièng-gŏng	连江县
Tài-tàu	斬首
Cūi-ngù	天牛
Hiŏng-siàng	芗城区
Buŏi	飛行
Ŭi-nà̤-sṳ̆ Sĕng-lī-nè̤ng	威尼斯商人
Ū-ì-săng	武夷山脉
Ŭ-sŭ-lī-gĕ̤ng	乌苏里江
Dĕ̤ng-cé	冬至
Tiĕng-huòng	天皇
Kăi-hŭng	开封市
Sĭng-dài-bê	新臺幣
Sák-mū-ngī-gé-hâiu-cṳ̆	撒母耳記下
Liĕk-uòng-gé-liŏk Hâ	列王紀下
Mièu-cŭk	苗族
Nguòng Sié-kāi	袁世凯
Gă-lṳ̀ng Huòng-dá̤	阮福映
John Wesley	約翰·衛斯理
Siăh	進食
Perlis	玻璃市
Negeri Sembilan	森美兰
Labuan	纳闽
Lṳ̀ng	龙
Iòng-iù-gàu	煤油燈
Cần Thơ	芹苴市
Gĭng-cŭk	京族
Ciĕng-bò̤	占婆
Diòng-gáu-sê̤ṳ	传教士
Uōng-dâi Cièng-tiàng	远大前程
Niōng-bēng	天花板
Rasŏn	羅先特別市
Guăng Ṳ̄	关羽
Ŭ-gŭi	龜
Tá̤	抽屜
Gê̤ṳng-huò-dōng	共和党 (消歧义)
Bō̤-dâi Huòng-dá̤	保大帝
Siê-iù	酱油
Ŭ-lṳ̀ng-dà	乌龙茶
Huōi-lṳ̀ng-guō	火龙果
Gê̤ṳng-sāng-dōng	共产党
Chái Ĭng-ùng	蔡英文
Băh-cṳ̄ng-nè̤ng	白人
Ŏ̤-mì-tò̤-hŭk	阿弥陀佛
Ngiè-làng	宜蘭縣
Ciŭ Giĕk-lùng	周杰倫
Orhan Pamuk	奥尔汗·帕穆克
Hà-puō	霞浦县
Carpineto Romano	卡皮内托罗马诺
Ngū-dâi Sĕk-guók	五代十国
Cō̤	枣
Tā̤-ṳ̆k	体育
Sĭng-báe̤k	新北市
Dài-dṳ̆ng	臺中市
Làu Bê	刘备
Huă-lièng	花蓮縣
Gĭng-muòng	金門縣
Lièng-gŏng-gâing (Dṳ̆ng-huà Mìng-guók)	連江縣 (中華民國)
Dài-dĕ̤ng	臺東縣
Sĭng-dé̤ṳk (chê)	新竹市
Gă-ngiê (chê)	嘉義市
Giĕ-lè̤ng	基隆市
Săi	SAI
Jun Ji-hyun	全智賢
Ngiè	鹅
Dièu-siēng Gŏ̤-cŭng	朝鮮高宗
Hók-chiăng	福清市
Gáuk-gáuk	骨骼
Amuro Namie	安室奈美惠
Diêng-tù	电池
Gê̤ṳ-gê̤ṳ	拐杖
Nakashima Mika	中島美嘉
Hù-lì-mà	黄鼬
Gŏ̤-ák-guŏ	壓力鍋
Chagang Dô̤	慈江道
Óng-chái	蕹菜
Ké̤ṳk-siăh	行乞
Sŏng-ngù	孫吳
Băh-cŭk	白族
Siông Cĭng	尚真王
Mùi-liĕk	梅列区
Gū-săng	鼓山
Â-dáu	下午
Huòng Tái-gĭk	皇太極
Guŏng-sê̤ṳ Huòng-dá̤	光绪帝
Alan Dawa Dolma	阿兰·达瓦卓玛
Ngù-mō̤-ngù-giāng	蜗牛
Takeshi Kaneshiro	金城武
Sông-dê Huòng-dá̤	顺治帝
Nū-ī-hăk-cà̤	努尔哈赤
Iòng-muòi	杨梅
Sŏng Guòng	孙权
Cò̤ Pī	曹丕
Ciōng Gĭng-guók	蔣經國
Uòng Mì	王维
Lī Dĕng-hŭi	李登輝
Ṳ̆ng-céng Huòng-dá̤	雍正帝
Dùng-dê Huòng-dá̤	同治帝
Dŭng-huòng	敦煌市
Să-mŏk	沙漠
Hiŏng-iòng-guă	佛手瓜
Uòng Ăng-sĭk	王安石
Tokugawa Yoshimune	德川吉宗
Săng-ā	三亚市
Dài-uăng Mìng-ciō-guók	臺灣民主國
Seo Jae-pil	徐載弼
Guók-ngṳ̄	國家語言
Sṳ̆k-háng	蜀汉
Cò̤-ngôi	曹魏
Hiŏng-gŭ	香菇
Mŭk-ngī	黑木耳
Sā̤-tŏng	洗澡
Gă-kéng Huòng-dá̤	嘉庆帝
Páuk Hièng-īng	朴宪永
Dièu-siēng Sié-cū	朝鮮世祖
Dô̤-guŏng Huòng-dá̤	道光帝
Hièng-hŭng Huòng-dá̤	咸丰帝
Hùng Séu-ciòng	洪秀全
Gĭng-kiŏk	京剧
Bău Cīng	包拯
Duâi-siók	大雪
Báik-guá	八卦
Sṳ̆-mā Hé	司马懿
Áng-pŭng	扁頭泥蜂
Hŭng-sṳ̆k	風俗
Ièu-cŭk	瑶族
Bĭng-sĭng	冰心
Biék	鳖
Dièu-siēng Tái-cū	李成桂
Báik-nguŏk-cáik	中秋节
Guŏng-Dṳ̆ng Huòng-dá̤	阮惠
Lò̤ Giĕk-sôi	罗杰瑞
Ngà̤ Táuk-sĭng	倪柝声
Liŏh-chiông-gĭ	錄影機
Dâng-chái	贻贝
Gā-cō̤	跳蚤
Dài-uăng Muāng-chĭng Sì-dâi	臺灣清治時期
Mā-tái Hók Ĭng	馬太福音
Sĕk-cê-gá	十字架 (基督教)
Tè̤ng-chō̤	冬虫夏草
Tŭi-guōng Pū-tŭng-uâ	推广普通话
Ī-hók-sū Cṳ̆	以弗所書
Mā-cū (Sìng)	媽祖
Uŏk-nàng Gê̤ṳng-sāng-dōng	越南共产党
10000	10000
Kū-guă	苦瓜
Mìng-miâng Huòng-dá̤	明命帝
Chék Gié-guŏng	戚继光
Dĭk Ìng-giĕk	狄仁杰
Dṳ̆ng-huà Mìng-guók Guók-gŭng	中華民國國軍
Ì-cŭk	彝族
Gāu-nguŏk-gāu	重陽節
Dâing Lâ̤-gŭng	鄧麗君
Mìng-sìng Huòng-hâiu	明成皇后
Natsukawa Rimi	夏川里美
Lṳ̄ Séu-lièng	呂秀蓮
Sṳ̀ng-chéu (Hók-ciŭ chê-chéu)	榕亞屬
Sê̤ṳ-dáik Huòng-dá̤	嗣德帝
Lìng Hŭi-ĭng	林徽因
Cṳ̀-ciŏng	瓷砖
Ngù Săng-gié	吴三桂
Hĭng-sŏng Dâi-iêng-gŭng	兴宣大院君
Gŏ̤ Dé-sêng	高智晟
Dêu-uòng	帝辛
Hàng Hàng	韩寒
Hók-ciŭ Dâi-hŏk	福州大学
Huăng-giāng	外國人
Tiăng-dŏng	客廳
Ók-dāu	熨斗
Liŏh-dà	綠茶
Liŏh-dâu	绿豆
Dièu-siēng-cŭk	朝鲜族
Yu Kil-chun	兪吉濬
Mò̤-bék	毛笔
Páuk Hông-ciŏ	朴奉珠
Hŭk-dáng Dâi-hŏk	复旦大学
Kŭmgang-săng Guăng-guŏng Dê-kṳ̆	金刚山观光地区
Páuk Dṳ̀ng-iòng	朴重陽
Lêng Gié-hĕk	令计划
Hòng-ciŭ Să̤-hù	西湖
Gă-săk-giāng	都市車
Gái-chái	芥菜
Siông-hāi Gău-tŭng Dâi-hŏk	上海交通大学
Bù-sìng	蠅
Diŏng Hiēu-kĭng	張曉卿
Ciū-ciòng	酒泉市
Hŭ-huò-hô̤-dĕk	呼和浩特市
Ngù Chĭng-nguòng	吳清源
Hà-iù	魚露
Băh-ngiê	白蟻
Băh-uâ-cê	白話字
Ngièng Hók	嚴復
Páu-diông	爆竹
Hṳ̆ng-dòng	胸
Mā-cū (Dō̤)	馬祖列島
Ăng-kă̤	安溪县
Să̤-cŏng	西裝
Hiroshima-gâing	廣島縣
Chiēng-cāi	手指
Hwanghae Nàng-dô̤	黄海南道
Hók-tīng	福鼎市
Siĕu-ciū	白酒
Dùng-cé	革命同志
Hŭng-tiŭ	打氣筒
Gióng-iòng	建阳区
Dáng-mìng	蜑家
Mìng-kă̤	明溪县
Guōng-guă	冬瓜
Sīng Bō̤-dĭng	沈葆楨
Hùng-siĕu	云霄县
Káh-gă	客家民系
Bâng-ā	啞
Nàng-gĭng Dâi-hŏk	南京大学
Gìng-ièu	瓊瑤
Chék-nguŏk-buáng	中元節與盂蘭盆節
Uòng Sĭng-lìng	王心凌
Hù-siŭ	泥鳅
Cò̤ Sĭk	曹植
Ciŭ Ùng-uòng	周文王
Huò-sĭng	和珅
Bō̤-sĕng Dâi-dá̤	保生大帝
Siĕ Lòng	施琅
Giŏng Tái-gŭng	太公望
Dìng Bō̤-tĭng	陳寶琛
Tái-sông	泰顺县
Diêu Dò̤	赵佗
Dâng Dùng	鄭迵
Chŏng-nàng	苍南县
Mìng-nàng-nè̤ng	闽南民系
Lī Siòng-sêu	李常受
Ngṳ̀-uòng	鱼丸
Lìng Sĕng	林森
Lī Còng-hé̤ṳk	唐庄宗
Siĕ Mìng-dáik	施明德
Uòng Sīng-dĭ	王審知
Chái-tàu-guōi	蘿蔔糕
Buò-gì	蒲葵
Lī Lièng-ĭng	李連英
Cūi-giĕ	虎皮蛙
Dìng Gēng	陳煚
Dièu-siēng Buáng-dō̤ lĭk-sṳ̄	朝鲜历史
Cáe̤ng	粽
Iù-cák-guōi	油条
Sinŭiju Dĕk-biék Hèng-céng-kṳ̆	新義州特別行政區
Guók-lĭk Dṳ̆ng-iŏng Dâi-hŏk	國立中央大學
Tūng-ék Sĭng-lò̤	统一新罗
Sák Déng-bĭng	萨镇冰
Dìng Gīng-ê̤ṳng	陈景润
ISO 639-1	ISO 639-1
Lìng Chṳ̆	林紓
Huá-huá	八哥
Mī-hūng	米粉
Háng-cê Ùng-huá-kuŏng	漢字文化圈
Lī Gŭng-ūng	李公蘊
Hók-gióng tū-làu	福建土楼
Dṳ̆ng-huà Dâi-hŏk	中華大學
Chĭng-mìng	清明
Nê-hù	二胡
Pū-tŭng-uâ	現代標準漢語
Siă-cŭk	畲族
Mē̤ng-giāng	蛾蚋科
Mĭk-pŭng	蜜蜂
Okinawa-gâing	沖繩縣
Diòng-lŏ̤h	长乐市
Nàng-ā	南亚
Báh-uŏk	百越
Guòng-lé	权利
Gióng-nìng	建宁县
Gŭng-sĭ	公司
Tì-kŭ	白腹鯖
Ŭ-cṳ̄ng-nè̤ng	黑人
Nàng-uŏk-guók	南越国
Hâ-uă	夏娃
Gă-ngiê	嘉義
Chèng-chṳ̄	田鼠
Kiŏng-cŭk	羌族
Uòng-lièng	黄连
Chèng	耕地
Bànguâpedia	Wikipedia:閩東語維基百科
Wiki Bô-lâung-diòng	Wikipedia:維基孵育場
Chái Ŭng	蔡溫
Nà̤-gŭ	比丘尼
Guŏng-biāng	光饼
Bĭng-dê̤ṳ	冰棒
Wikipedia:Sū-iū ngṳ̄-ngiòng bēng-buōng gì Wikipedia	Wikipedia:维基百科语言列表
Ngṳ̆k-huòng-dâi-dá̤	玉皇大帝
Ngù-sāi-gŭi	蜣螂
Chiók	飲
À̤-liák	拖鞋
Lī-dièu	李朝 (越南)
Cé̤ṳk	粥
Mìng-ciō Céng-buô-dōng	民主進步黨
Siông Mŭk	尚穆王
Siông Dáik	尚德王
Siông Nguòng	尚元王
Siông Ṳ̆k	尚育王
Siông Nìng	尚寧王
Ì-cô̤-hūng	洗衣粉
Tĕng	竹蟶科
Pàng-hù Gùng-dō̤	澎湖群島
Hāi-chŏng	海沧区
Muōi-sì	荸荠
Hāi-nàng-ngṳ̄	海南话
Dĕ̤ng-săng	东山县
Cĭk-mī	集美区
Mìng-gĕ̤ng	闽江
Dùng-ăng	同安区
Dài-gĕ̤ng	台江区
Lṳ̀ng-hāi	龙海市
Siŏh-săi	石狮市
Siòng-ăng	翔安区
Mìng-âu	闽侯县
Siêu-ū	邵武市
Ôi	胃
Chŏng-săng	仓山区
Măh Lé-huò	麦利和
Siông Géng	尚敬王
Hāi-gēu	海狗
Sibu	詩巫
Lù Gŭng-mìng	卢公明
Siông Ŭng	尚溫王
Lū-bék	白頭鵯
Ciŭ Ū-uòng	周武王
Diòng-tái	长泰县
Diòng-tĭng	长汀县
Cṳ̆-dó̤h	书桌
Siàng-siŏng	城厢区
Chèng-lòi	田螺
Nàng-hāi	南海 (消歧義)
Siông Ièng	尚圓王
Lī-siàng	鲤城区
Ciòng-gē̤ng	泉港区
Siông Hô̤	尚灝王
Niŏh-hâ-ciŏ	叶下珠
Chiă-ngò̤	文蛤
Aragaki Yui	新垣結衣
Siông Chĭng	尚清王
Siông Tái-giū	尚泰久王
Sô̤i	坐
Siĕu	笛子
Lĭk-chiŭ	立秋
Mā-lái-iè	白額高腳蛛
Duâi-sṳ̄	大暑
Sŏng-gáung	霜降
Chṳ̄-sṳ̄	处暑
Mòng-cṳ̄ng	芒种
Sêu-nìng	寿宁县
Káh-dièu	玩耍
Lŏk-gŏng	洛江区
Â-muòng Dâi-hŏk	厦门大学
Dô̤-sê̤ṳ	道士
Kŭ-chèng	古田县
Dâi-dièng	大田县
Dáik-huá	德化县
Siŏh-màng	昨天
Siēu-sṳ̄	小暑
Siēu-siók (cáik-ké)	小雪
Siēu-hàng	小寒
Cáik-ké	节气
Siēu-muāng	小满
Băh-ló	白露
Lĭk-hâ	立夏
Lĭk-dĕ̤ng	立冬
Mìng (Sĕk-guók)	闽 (十国)
Gák-lì	蛤蜊
Hàng-ló	寒露
Hà-mà-chāu	车前
Là̤ Lé	黎利
Găng-chō̤	甘草
Gū-piéu	股票
Huà-ăng	华安县
Nìng-huá	宁化县
Iù-kă̤	尤溪县
Chĭng-liù	清流县
Să-gâing	沙县
Chiŭ-hŭng	秋分
Gāi-gáik Kăi-huóng	改革开放
Lièng-siàng	连城县
Sông-chiŏng-gâing	顺昌县
Lò̤-nguòng	罗源县
Bìng-nàng	屏南县
Bìng-tàng	平潭县
Nàng-ăng	南安市
Mìng-dáng	明天
Dṳ̀-huák	除法
Hù-lù	葫芦
Ciŏng-lŏk	将乐县
Sĭng-dé̤ṳk	新竹
Gĭng-dĭk	惊蛰
Diêng-dĕng	电灯
Gók-ṳ̄	谷雨
Duâi-hàng	大寒
Īng-lĭk Huòng-dá̤	永历帝
Tiék-guăng-ĭng	铁观音
Hù-lī	湖里区
Īng-dêng	永定区 (龙岩市)
Sṳ̀ Cài-hâiu	徐才厚
Céng-ăng	晋安区
Gū-làu	鼓楼区 (福州市)
Séu-sê̤ṳ	秀屿区
Īng-chŭng	永春县
Ciĕu-siàng	蕉城区
Siĕng-iù	仙游县
Iòng-bìng-kṳ̆	延平区
Sĭng-lò̤-kṳ̆	新罗区
Puō-siàng	浦城县
Săng-nguòng	三元区
Hàng-gŏng	涵江区
Hŭng-dĕk	丰泽区
Lié-siàng	荔城区
Siông-hòng-gâing	上杭县
Sṳ̀ng-kă̤-gâing	松溪县
Ū-bìng	武平县
Nàng-cêng	南靖县
Chŭng-hŭng	春分
Lĭk-chŭng	立春
Ṳ̄-cūi	雨水
Lè̤ng-ê̤ṳ Tái-hâiu	隆裕太后
Siông Bă-cé	尚巴志王
Siông Tái	尚泰王
Hók-ăng	福安市
Mìng-chiăng	闽清县
Gióng-ĕu	建瓯市
Mā-muōi	马尾区
Īng-tái	永泰县
Lṳ̀ng-ùng	龙文区
Sṳ̆-mìng	思明区
Hiê-ăng	惠安县
Bìng-huò	平和县
Tái-nìng	泰宁县
Guŏng-dĕk	光泽县
Īng-ăng	永安市
Ùng-dé̤ṳk	文竹
分類:Dáik-guók	Category:德国
分類:É-dâi-lé	Category:意大利
分類:Mī-guók	Category:美国
分類:Ngò̤-lò̤-sṳ̆	Category:俄罗斯
分類:Dṳ̆ng-guók	Category:中国
分類:Nĭk-buōng	Category:日本
分類:Ó̤-ciŭ	Category:澳大利亚
Iĕk-cūi-ké	热水器
分類:Éng-nà̤	Category:印尼
分類:Hàng-guók	Category:大韓民國
分類:Tái-guók	Category:泰國
分類:Uŏk-nàng	Category:越南
分類:Buô-ṳ̄ dông-ŭk	Category:哺乳類
分類:Bà-hèng dông-ŭk	Category:爬行動物
分類:Cēu	Category:鸟类
分類:Cĭng-kṳ̄ng	Category:真菌
分類:Sĭk-ŭk	Category:植物
分類:Ŭk-lī	Category:物理学
分類:Huá-hŏk	Category:化学
分類:Lĭk-sṳ̄	Category:历史
分類:Dê-lī	Category:地理
分類:Siâ-huôi	Category:社会
分類:Mī-sŭk	Category:視覺藝術
分類:Cŭng-gáu	Category:宗教
分類:Tā̤-ṳ̆k	Category:体育
分類:Kuŏ-hŏk	Category:科学
分類:Gióng-dé̤ṳk-ŭk	Category:建築物
Gū Lò̤-mā	古罗马
Liù-giāng	蜆
Chŭng-lièng	春貼
Mìng-uŏk	閩越
Cūi-kì	蛞蝓
分類:Sĕng-tái	Category:生態學
Sák-mū-ngī-gé-cièng-cṳ̆	撒母耳記上
Săng-sáiu	生肖
分類:Disambig	Category:消歧义
分類:Diék-hŏk	Category:哲学
分類:Sĭng-lī	Category:心理学
分類:Hŭk-gáu	Category:佛教
分類:Gĭ-dók-gáu	Category:基督教
分類:Ĭ-sṳ̆-làng-gáu	Category:伊斯兰教
分類:Iù-tái-gáu	Category:犹太教
Tiĕng-cĭng Dâi-hŏk	天津大学
Dĭ-dă	唢呐
Uòng Iòng-hâng	王延翰
Uòng Gié-bèng	王繼鵬
Uòng Iòng-gĭng	王延鈞
Hô-dê̤ṳ	腐皮
Gùng	裙
Báik Sáng Ĭk Mìng	八姓入闽
Uòng Iòng-hĭ	王延曦
Uòng Nāi-siòng	黄乃裳
Ciòng-ciŭ-uâ	泉州话
Cháe̤	丝瓜
Tuyên Quang	宣光省
Lìng Sié-gŭng	林世功
Hióng Dáik-hèng	向德宏
Dák-huói-cièng	壓歲錢
Iraq gâe̤ng Levant Ĭ-sṳ̆-làng-guók	伊斯兰国
Pàng-kì	相手蟹科
Dâu-mò̤-chái	豆芽
Hèu Dáik-bōng	侯德榜
Giū-mī-chŏng	久米村
Ì-ngṳ̄	彝语
Cièng-cāi	紙錢
Lìng Gáuk-mìng	林觉民
Â-muòng-uâ	廈門話
Tău-dò̤-nó̤h	偷竊
Ciĕ-muài	芝麻
Abu Bakr al-Baghdadi	阿布·贝克尔·巴格达迪
Nṳ̆k-ṳ̀ng	肉鬆
Sé-sáik-bà̤	四色牌
Kăi-nguòng-sê	开元寺 (福州)
分類:Ùng-huá	Category:文化
分類:Dê-cék	Category:地质学
Dìng-dièu	陳朝 (越南)
Wikipedia:Dŏng-nièng gĭng-dáng	Wikipedia:历史上的今天
模板:Tái-iòng-hiê	Template:太阳系
Holopedia	閩南語維基百科
Gì-chái	苋
Kō̤-cṳ̆	考试
Ciē-sáik	紫色
Gŏ̤-gák-hié	高甲戏
Kī-mā-sŭ	萨其马
Káh-dièu-bŏng	朋友
Bàng-uâ-cê	平話字
Hù-siông	和尚
Màng-gōng	蛮讲
Tái-bìng-tiĕng-guók	太平天国
Gâng	汗液
Sìng (bòng-hâ̤)	锯缘青蟹
Ià-huò-huà	耶和華
Sók-lŭk	速率
Ák	鸭
Dìng Nguòng-guŏng	陳元光
Duâi-tàu-chái	芜菁
Huăng-siông	芒果
分類:Dáik-guók ìng-ŭk	Category:德国人
分類:Mī-guók ìng-ŭk	Category:美国人
分類:Iēng-uòng	Category:演员
分類:Ĭng-guók ìng-ŭk	Category:英国人
分類:Huák-guók ìng-ŭk	Category:法国人
模板:Chess diagram	Template:Chess diagram
模板:Tl	Template:Tl
Káh-ngṳ̄ Băh-uâ-cê	客語白話字
分類:Guók-gă	Category:国家
Wikipedia:Hèng-céng Ìng-uòng	Wikipedia:管理员
分類:Dṳ̆ng-guók mìng-cŭk	Category:中华民族
分類:Ìng-ŭk	Category:人物
分類:Cék-ngiĕk	Category:職業
Wikipedia:Gĭ-ké-nè̤ng	Wikipedia:机器人
分類:Sì-găng	Category:时间
分類:Gĕ̤ng-tiàng	Category:工程學
分類:Cài-lâiu	Category:材料
分類:Ĭ-hŏk	Category:医学
分類:Céng-dê	Category:政治
分類:Gáu-ṳ̆k	Category:教育
Ăi-gĭk	埃及
模板:Bot	Template:Bot
Gă-nā-dâi	加拿大
分類:Iù-hié	Category:游戏
Hók-gióng Sṳ̆-huâng Dâi-hŏk	福建师范大学
分類:Ĕu-ciŭ guók-gă	Category:欧洲国家
分類:Ĕu-ciŭ	Category:欧洲
模板:Documentation	Template:Documentation
Huà-lìng-sê	华林寺
分類:Ê̤ṳng-hô	Category:用户语言
Sìng Câi-gĭ	成在基
模板:Softredirect	Template:軟重定向
Wikipedia:維基數據	Wikipedia:维基数据
模板:Chēng	Template:Delete
分類:Ngṳ̄-ngiòng	Category:语言
分類:Lĭk-huák	Category:曆法
分類:Wikipedia	Category:维基百科
Wikipedia:Mò̤ hô-cáik sĭng-mìng	Wikipedia:免责声明
分類:未索引其頁面	Category:不可索引页面
Dâi-chṳ̄	袋鼠
Hâ Chák-lī	夏察理
Tiĕng-ăng-dòng	天安基督教堂
Huòng-huō Diòng-siàng	防火长城
模板:!-	Template:!-
模板:Smallcaps	Template:Smallcaps
模板:Nowrap	Template:Nowrap
Wikipedia:Ék-chiék Wikipedia dŭ găi-dŏng ô gì ùng	Wikipedia:基礎條目
分類:Hĭ-ciŭ	Category:非洲
模板:Wikisource	Template:Wikisource
模板:Babel	Template:Babel
模板:Commons	Template:Commons
模板:Reflist	Template:Reflist
Hók-ciŭ-huòng	福州園
Wikipedia:列明來源	Wikipedia:列明来源
模板:Stub	Template:Stub
Gēng Cĭng-dṳ̆ng	耿精忠
模板:User eo-1	Template:User eo-1
模板:User eo-3	Template:User eo-3
模板:User de	Template:User de
模板:User de-1	Template:User de-1
模板:User es	Template:User es
模板:User de-3	Template:User de-3
模板:User en-3	Template:User en-3
模板:User en-1	Template:User en-1
模板:User en-2	Template:User en-2
模板:User eo-2	Template:User eo-2
模板:User en-4	Template:User en-4
模板:User en	Template:User en
模板:User de-2	Template:User de-2
模板:User es-1	Template:User es-1
模板:User fr-1	Template:User fr-1
模板:User it-3	Template:User it-3
模板:User fr-2	Template:User fr-2
模板:User ja	Template:User ja
模板:User ja-1	Template:User ja-1
模板:User it-1	Template:User it-1
模板:User fr	Template:User fr
分類:Ā-ciŭ	Category:亚洲
分類:Nàng Mī-ciŭ	Category:南美洲
分類:Mā-lài-să̤-ā	Category:马来西亚
模板:Mod	Template:Mod
模板:SIL	Template:SIL
模板:User it	Template:User it
模板:User es-2	Template:User es-2
模板:Huăng-ngìng	Template:Welcome
分類:Dièu-lâiu	Category:調味料
模板:Click	Template:Click
分類:User fr-1	Category:Fr-1 使用者
模板:Image label	Template:Image label
模板:Category handler	Template:Category handler
模板:Wiki gĕ̤ng-tiàng	Template:维基媒体项目
模板:Niék-sé cáik-ké	Template:二十四节气
Guóh Guók-tĭng	郭国汀
模板:Steady	Template:Steady
模板:Guók-gă	Template:國家基礎資訊
模板:Documentation/docname	Template:Documentation/docname
模板:Cite journal	Template:Cite journal
模板:Infobox 公司	Template:Infobox Company
模板:Wikibooks	Template:Wikibooks
模板:Dablink	Template:Dablink
模板:Hō̤ gì ùng-ciŏng	Template:Featured article
分類:User en-4	Category:En-4 使用者
分類:User en	Category:En 使用者
分類:User zh	Category:Zh 使用者
分類:User zh-M	Category:Zh 母语使用者
分類:User en-2	Category:En-2 使用者
模板:Infobox	Template:Infobox
模板:User eo	Template:User eo
模板:User zh	Template:User zh
分類:Gáuk-guók gì lĭk-sṳ̄	Category:各國歷史
Wikipedia:Dŏng-nièng gĭng-dáng/09 nguŏk 23 hô̤	Wikipedia:历史上的今天/9月23日
Wikipedia:Dŏng-nièng gĭng-dáng/09 nguŏk 22 hô̤	Wikipedia:历史上的今天/9月22日
模板:Legend	Template:Legend
Wikipedia:Dŏng-nièng gĭng-dáng/09 nguŏk 17 hô̤	Wikipedia:历史上的今天/9月17日
Wikipedia:Dŏng-nièng gĭng-dáng/10 nguŏk 15 hô̤	Wikipedia:历史上的今天/10月15日
模板:Cite web	Template:Cite web
Wikipedia:Dŏng-nièng gĭng-dáng/09 nguŏk 28 hô̤	Wikipedia:历史上的今天/9月28日
模板:Ombox	Template:Ombox
Wikipedia:Dŏng-nièng gĭng-dáng/10 nguŏk 22 hô̤	Wikipedia:历史上的今天/10月22日
Wikipedia:Dŏng-nièng gĭng-dáng/11 nguŏk 2 hô̤	Wikipedia:历史上的今天/11月2日
Wikipedia:Dŏng-nièng gĭng-dáng/11 nguŏk 9 hô̤	Wikipedia:历史上的今天/11月9日
模板:Country data	Template:Country data
Wikipedia:Dŏng-nièng gĭng-dáng/10 nguŏk 1 hô̤	Wikipedia:历史上的今天/10月1日
Wikipedia:Dŏng-nièng gĭng-dáng/10 nguŏk 5 hô̤	Wikipedia:历史上的今天/10月5日
Wikipedia:Dŏng-nièng gĭng-dáng/10 nguŏk 8 hô̤	Wikipedia:历史上的今天/10月8日
分類:Īng-sĭk	Category:飲食
模板:MongolUnicode	Template:MongolUnicode
Wikipedia:Dŏng-nièng gĭng-dáng/10 nguŏk 6 hô̤	Wikipedia:历史上的今天/10月6日
Wikipedia:Dŏng-nièng gĭng-dáng/10 nguŏk 17 hô̤	Wikipedia:历史上的今天/10月17日
Wikipedia:Dŏng-nièng gĭng-dáng/10 nguŏk 2 hô̤	Wikipedia:历史上的今天/10月2日
Wikipedia:Dŏng-nièng gĭng-dáng/09 nguŏk 16 hô̤	Wikipedia:历史上的今天/9月16日
Wikipedia:Dŏng-nièng gĭng-dáng/09 nguŏk 19 hô̤	Wikipedia:历史上的今天/9月19日
Wikipedia:Dŏng-nièng gĭng-dáng/10 nguŏk 25 hô̤	Wikipedia:历史上的今天/10月25日
Wikipedia:Dŏng-nièng gĭng-dáng/11 nguŏk 10 hô̤	Wikipedia:历史上的今天/11月10日
Wikipedia:Dŏng-nièng gĭng-dáng/10 nguŏk 21 hô̤	Wikipedia:历史上的今天/10月21日
Wikipedia:Dŏng-nièng gĭng-dáng/09 nguŏk 15 hô̤	Wikipedia:历史上的今天/9月15日
Wikipedia:Dŏng-nièng gĭng-dáng/09 nguŏk 4 hô̤	Wikipedia:历史上的今天/9月4日
Wikipedia:Dŏng-nièng gĭng-dáng/09 nguŏk 8 hô̤	Wikipedia:历史上的今天/9月8日
Wikipedia:Dŏng-nièng gĭng-dáng/10 nguŏk 4 hô̤	Wikipedia:历史上的今天/10月4日
Wikipedia:Dŏng-nièng gĭng-dáng/09 nguŏk 1 hô̤	Wikipedia:历史上的今天/9月1日
Wikipedia:Dŏng-nièng gĭng-dáng/09 nguŏk 6 hô̤	Wikipedia:历史上的今天/9月6日
Wikipedia:Dŏng-nièng gĭng-dáng/09 nguŏk 25 hô̤	Wikipedia:历史上的今天/9月25日
Wikipedia:Dŏng-nièng gĭng-dáng/09 nguŏk 10 hô̤	Wikipedia:历史上的今天/9月10日
Wikipedia:Dŏng-nièng gĭng-dáng/09 nguŏk 26 hô̤	Wikipedia:历史上的今天/9月26日
Wikipedia:Dŏng-nièng gĭng-dáng/09 nguŏk 20 hô̤	Wikipedia:历史上的今天/9月20日
Wikipedia:Dŏng-nièng gĭng-dáng/11 nguŏk 4 hô̤	Wikipedia:历史上的今天/11月4日
Wikipedia:Dŏng-nièng gĭng-dáng/09 nguŏk 30 hô̤	Wikipedia:历史上的今天/9月30日
Wikipedia:Dŏng-nièng gĭng-dáng/10 nguŏk 7 hô̤	Wikipedia:历史上的今天/10月7日
Wikipedia:Dŏng-nièng gĭng-dáng/10 nguŏk 19 hô̤	Wikipedia:历史上的今天/10月19日
Wikipedia:Dŏng-nièng gĭng-dáng/09 nguŏk 27 hô̤	Wikipedia:历史上的今天/9月27日
Wikipedia:Dŏng-nièng gĭng-dáng/09 nguŏk 11 hô̤	Wikipedia:历史上的今天/9月11日
Wikipedia:Dŏng-nièng gĭng-dáng/11 nguŏk 8 hô̤	Wikipedia:历史上的今天/11月8日
Wikipedia:Dŏng-nièng gĭng-dáng/11 nguŏk 1 hô̤	Wikipedia:历史上的今天/11月1日
Wikipedia:Dŏng-nièng gĭng-dáng/11 nguŏk 7 hô̤	Wikipedia:历史上的今天/11月7日
Wikipedia:Dŏng-nièng gĭng-dáng/10 nguŏk 11 hô̤	Wikipedia:历史上的今天/10月11日
Wikipedia:Dŏng-nièng gĭng-dáng/11 nguŏk 3 hô̤	Wikipedia:历史上的今天/11月3日
Wikipedia:Dŏng-nièng gĭng-dáng/10 nguŏk 20 hô̤	Wikipedia:历史上的今天/10月20日
Wikipedia:Dŏng-nièng gĭng-dáng/10 nguŏk 16 hô̤	Wikipedia:历史上的今天/10月16日
Wikipedia:Dŏng-nièng gĭng-dáng/10 nguŏk 14 hô̤	Wikipedia:历史上的今天/10月14日
Wikipedia:Dŏng-nièng gĭng-dáng/10 nguŏk 18 hô̤	Wikipedia:历史上的今天/10月18日
Wikipedia:Dŏng-nièng gĭng-dáng/10 nguŏk 24 hô̤	Wikipedia:历史上的今天/10月24日
Wikipedia:Dŏng-nièng gĭng-dáng/10 nguŏk 3 hô̤	Wikipedia:历史上的今天/10月3日
Wikipedia:Dŏng-nièng gĭng-dáng/09 nguŏk 7 hô̤	Wikipedia:历史上的今天/9月7日
分類:Săng	Category:山
模板:IPA	Template:IPA
分類:Céng-dê-gă	Category:政治人物
分類:Mī-ciŭ	Category:美洲
Tàng	痰
分類:Gáuk-guók gì ìng-ŭk	Category:各國人物
模板:Wiki-huá	Template:Wikify
分類:Gŭng-sê̤ṳ	Category:军事
模板:Increase	Template:Increase
模板:Ciŭ-gĭ-biēu	Template:元素週期表
模板:User nl	Template:User nl
模板:Infobox 網站	Template:Infobox Website
Wikipedia:Dŏng-nièng gĭng-dáng/10 nguŏk 12 hô̤	Wikipedia:历史上的今天/10月12日
模板:Decrease	Template:Decrease
模板:User no-2	Template:User no-2
模板:Image label end	Template:Image label end
模板:Documentation subpage	Template:Documentation subpage
Wikipedia:Dŏng-nièng gĭng-dáng/11 nguŏk 5 hô̤	Wikipedia:历史上的今天/11月5日
Wikipedia:Dŏng-nièng gĭng-dáng/10 nguŏk 13 hô̤	Wikipedia:历史上的今天/10月13日
Wikipedia:Dŏng-nièng gĭng-dáng/09 nguŏk 3 hô̤	Wikipedia:历史上的今天/9月3日
Wikipedia:Dŏng-nièng gĭng-dáng/09 nguŏk 24 hô̤	Wikipedia:历史上的今天/9月24日
模板:Purge	Template:Purge
模板:Lang-la	Template:Lang-la
分類:Cìng-gāng	Category:情緒
模板:Dṳ̆ng-huà Ìng-mìng Gê̤ṳng-huò-guók Hèng-céng-kṳ̆	Template:中华人民共和国省级行政区
模板:Userpage	Template:Userpage
模板:Non-free logo	Template:Non-free logo
模板:User	Template:User
Wikipedia:Dŏng-nièng gĭng-dáng/09 nguŏk 12 hô̤	Wikipedia:历史上的今天/9月12日
Wikipedia:Dŏng-nièng gĭng-dáng/09 nguŏk 2 hô̤	Wikipedia:历史上的今天/9月2日
Wikipedia:Dŏng-nièng gĭng-dáng/11 nguŏk 6 hô̤	Wikipedia:历史上的今天/11月6日
Wikipedia:Dŏng-nièng gĭng-dáng/09 nguŏk 18 hô̤	Wikipedia:历史上的今天/9月18日
Wikipedia:Dŏng-nièng gĭng-dáng/10 nguŏk 10 hô̤	Wikipedia:历史上的今天/10月10日
Wikipedia:Dŏng-nièng gĭng-dáng/10 nguŏk 9 hô̤	Wikipedia:历史上的今天/10月9日
Wikipedia:Dŏng-nièng gĭng-dáng/10 nguŏk 23 hô̤	Wikipedia:历史上的今天/10月23日
模板:Image label small	Template:Image label small
模板:User fr-3	Template:User fr-3
模板:Allcaps	Template:Allcaps
模板:Gô-dā̤ gì guók-gă	Template:Infobox Former Country
Wikipedia:Tiăng-dŏng	Wikipedia:Guestbook for non-Chinese speakers
Hakkâpedia	Wikipedia:客家語維基百科
分類:User ja-M	Category:Ja 母语使用者
模板:Gì-ngiê	Template:Disambig
模板:Smallcaps all	Template:Smallcaps all
分類:Dièu-siēng lĭk-sṳ̄	Category:朝鮮半島歷史
模板:User no-3	Template:User no-3
模板:User nan	Template:User nan
模板:User nan-1	Template:User nan-1
模板:Lang-grc	Template:Lang-grc
模板:User ksh	Template:User ksh
模板:User yue-3	Template:User zh-yue-3
模板:AUS	Template:AUS
模板:User yue-1	Template:User zh-yue-1
模板:Lifetime	Template:BD
模板:Lang-en	Template:Lang-en
分類:Sĕng-ŭk	Category:生物
模板:ISO 639 name conversion template doc	Template:ISO 639 name conversion template doc
Wikipedia:Dŏng-nièng gĭng-dáng/9 nguŏk	Wikipedia:历史上的今天/9月
Kŏ̤-lìng	柯林
Wikipedia:Dŏng-nièng gĭng-dáng/09 nguŏk 14 hô̤	Wikipedia:历史上的今天/9月14日
Wikipedia:Dŏng-nièng gĭng-dáng/09 nguŏk 9 hô̤	Wikipedia:历史上的今天/9月9日
Wikipedia:Dŏng-nièng gĭng-dáng/09 nguŏk 13 hô̤	Wikipedia:历史上的今天/9月13日
Wikipedia:Dŏng-nièng gĭng-dáng/10 nguŏk	Wikipedia:历史上的今天/10月
分類:User vi-3	Category:Vi-3 使用者
模板:User la-1	Template:User la-1
分類:User wuu	Category:Zh-wuu 使用者
分類:User fr	Category:Fr 使用者
分類:User ja	Category:Ja 使用者
分類:User la	Category:La 使用者
分類:User fr-3	Category:Fr-3 使用者
分類:User it-3	Category:It-3 使用者
分類:User ja-3	Category:Ja-3 使用者
分類:User fr-2	Category:Fr-2 使用者
分類:User it-2	Category:It-2 使用者
分類:User ja-2	Category:Ja-2 使用者
分類:User la-2	Category:La-2 使用者
分類:User wuu-M	Category:Zh-wuu 母語使用者
分類:User ko-M	Category:Ko 母語使用者
分類:User fr-M	Category:Fr 母語使用者
分類:User it-M	Category:It 母語使用者
分類:User nl-M	Category:Nl 母語使用者
模板:User yue	Template:User zh-yue
分類:Ùng-cê	Category:文字
分類:Dô̤-gáu	Category:道教
分類:Dō̤	Category:岛屿
分類:User de	Category:De 使用者
分類:User de-2	Category:De-2 使用者
分類:User de-3	Category:De-3 使用者
分類:User de-M	Category:De 母語使用者
分類:User en-3	Category:En-3 使用者
分類:User en-M	Category:En 母语使用者
分類:User es	Category:Es 使用者
分類:User es-1	Category:Es-1 使用者
分類:User es-2	Category:Es-2 使用者
分類:User es-3	Category:Es-3 使用者
分類:User es-M	Category:Es 母语使用者
分類:Chió	Category:房屋
分類:User it	Category:It 使用者
分類:User it-1	Category:It-1 使用者
分類:User ja-1	Category:Ja-1 使用者
分類:User ko	Category:Ko 使用者
分類:Mī-guók gì ciŭ	Category:美国州份
分類:User ko-1	Category:Ko-1 使用者
分類:User ko-2	Category:Ko-2 使用者
分類:User ko-3	Category:Ko-3 使用者
分類:User ksh	Category:Ksh 使用者
分類:User ksh-M	Category:Ksh 母語使用者
分類:User la-1	Category:La-1 使用者
Wikipedia:Dŏng-nièng gĭng-dáng/09 nguŏk 29 hô̤	Wikipedia:历史上的今天/9月29日
分類:User la-3	Category:La-3 使用者
Wikipedia:Dŏng-nièng gĭng-dáng/09 nguŏk 5 hô̤	Wikipedia:历史上的今天/9月5日
模板:Distinguish	Template:Distinguish
模板:Internal link helper	Template:Internal link helper
模板:Information	Template:Information
分類:Huâng-cô̤i	Category:犯罪
Sáik-mō̤	蝨毛目
分類:Séng-sék	Category:信息学
分類:Hāi	Category:海洋
Hŭng-siéng	风扇
分類:Guōng-dĕ̤ng	Category:广东
分類:Hók-gióng	Category:福建
分類:Gĭng-cá̤	Category:经济
分類:Ciék-ciĕ dông-ŭk	Category:节肢动物门
分類:User nan	Category:Nan 使用者
分類:User nan-1	Category:Nan-1 使用者
分類:User nan-2	Category:Nan-2 使用者
分類:User nan-3	Category:Nan-3 使用者
分類:User nan-M	Category:Nan 母语使用者
Hók-ciŭ-nè̤ng	福州民系
分類:Hĭ-ciŭ guók-gă	Category:非洲国家
分類:Gáuk-guók gì gáu-ṳ̆k	Category:各國教育
Wikipedia:Dŏng-nièng gĭng-dáng/11 nguŏk	Wikipedia:历史上的今天/11月
模板:User ja-2	Template:User ja-2
模板:User ja-3	Template:User ja-3
分類:User vi	Category:Vi 使用者
分類:User vi-1	Category:Vi-1 使用者
分類:User vi-2	Category:Vi-2 使用者
分類:User vi-M	Category:Vi 母語使用者
分類:Ciék-gŏng	Category:浙江
分類:Ĭng-ngŏk-gă	Category:音乐家
模板:Lang	Template:Lang
Wikipedia:Dŏng-nièng gĭng-dáng/09 nguŏk 21 hô̤	Wikipedia:历史上的今天/9月21日
分類:Hŏk-sŭk	Category:学术
Mìng-dŭ Biék Gé	閩都別記
Bì-bà (ngŏk-ké)	中國琵琶
分類:Wikimedia gĕ̤ng-tiàng	Category:维基媒体工程
Diê-biāng	蛎饼
分類:Gì-lôi	Category:棋类
Hók-gióng lĭk-sṳ̄	福建历史
Lâng-gá-siăng	福州外地移民
Găng Guók-bō̤	甘國寶
Gáu-huôi Lò̤-mā-cê	教會羅馬字
Â-gāu-cáik	拗九节
Â-gāu-cé̤ṳk	拗九粥
模板:Nocaps	Template:Nocaps
Ăng-kiŏng Báik-ĭng	安腔八音
分類:Hŭng-sṳ̆k	Category:習俗
Sĕ̤ng-pău-giò	双抛桥
Làu Iòng-hŭng	劉揚芬
Săng-huŏng-chék-háe̤ng	三坊七巷
Huài-dáik	怀德
模板:Infobox Language/family-color	Template:Infobox Language/family-color
分類:Ò̤	Category:河流
Cūi-siĕng	水仙
模板:User la-2	Template:User la-2
模板:User no-1	Template:User no-1
模板:User zh-1	Template:User zh-1
模板:User zh-2	Template:User zh-2
模板:User zh-3	Template:User zh-3
Nùng-mìng-gĕ̤ng	民工
分類:Dâi-hàng Mìng-guók ìng-ŭk	Category:韓國人
分類:Sôi-diēng ìng-ŭk	Category:瑞典人
分類:Nĭk-buōng ìng-ŭk	Category:日本人
分類:Dài-uăng ìng-ŭk	Category:台灣人
分類:User nl	Category:Nl 使用者
分類:User zh-1	Category:Zh-1 使用者
分類:User zh-3	Category:Zh-3 使用者
分類:User zh-2	Category:Zh-2 使用者
分類:Cāi	Category:紙
分類:Cáik-ké	Category:節氣
分類:Ông-ò̤	Category:運河
分類:Uŏk-nàng ìng-ŭk	Category:越南人
分類:Sùi-dièu huòng-dá̤	Category:隋朝皇帝
分類:Sóng-dièu huòng-dá̤	Category:宋朝皇帝
分類:Dòng-dièu huòng-dá̤	Category:唐朝皇帝
分類:Mìng-dièu huòng-dá̤	Category:明朝皇帝
分類:Săng-guók huòng-dá̤	Category:三國皇帝
分類:Ngò̤-lò̤-sṳ̆ ìng-ŭk	Category:俄罗斯人
分類:Hiŏng-gē̤ng ìng-ŭk	Category:香港人
分類:Ciĕk-káik ìng-ŭk	Category:捷克人
分類:Tái-guók ìng-ŭk	Category:泰國人
Uŏk-ngṳ̄	粤语
分類:Sáng	Category:姓氏
分類:Dièu-siēng Mìng-ciō-ciō-ngiê Ìng-mìng Gê̤ṳng-huò-guók	Category:朝鮮民主主義人民共和國
分類:Dṳ̆ng-guók ìng-ŭk	Category:中国人
分類:Dièu-siēng	Category:朝鮮半島
分類:Dài-uăng	Category:台灣
分類:Dièu-siēng Mìng-ciō-ciō-ngiê Ìng-mìng Gê̤ṳng-huò-guók ìng-ŭk	Category:朝鮮民主主義人民共和國人物
分類:Liù-giù-guók	Category:琉球國
分類:Hók-gióng-nè̤ng	Category:福建人
分類:Dâi-iòng-ciŭ guók-gă	Category:大洋洲国家
分類:Báe̤k Mī-ciŭ guók-gă	Category:北美洲國家
分類:Ngṳ̀	Category:鱼类
分類:Cūi-guō	Category:水果
分類:Niōng-tā̤ dông-ŭk	Category:软体动物门
分類:Só-cê	Category:数字
分類:Gióng-dé̤ṳk cài-lâiu	Category:建筑材料
分類:Dông-ŭk	Category:动物
分類:Ciáh-tùi dông-ŭk	Category:脊椎動物亞門
分類:Guòng-lé	Category:權利
分類:Ìng-guòng	Category:人權
分類:Ū-ké	Category:武器
分類:Nàng Mī-ciŭ guók-gă	Category:南美洲國家
Mìng-nàng	閩南
分類:Gă-sĭ	Category:家具
分類:Mìng-nàng-ngṳ̄	Category:閩南語
Chŏng-hà-ciŭ Gĭ-dók-dòng	苍霞洲基督堂
分類:Ké-chiông	Category:气象学
分類:Dṳ̆ng Mī-ciŭ	Category:中美洲
分類:Hiŏng-gē̤ng	Category:香港
分類:Ĭ-siòng	Category:服裝
分類:Cáik-nĭk	Category:节日
分類:Kuàng-ciék dông-ŭk	Category:环节动物门
分類:Bâng	Category:疾病
分類:Gùng-dō̤	Category:群島
分類:Ciŭ-dièu guók-uòng	Category:周朝君主
分類:Káh-dièu-nó̤h	Category:玩具
分類:Gă-dìng	Category:家庭
Mìng dṳ̆ng sĕk ék	福州十邑
Hók-ăng-uâ	福安話
分類:Dṳ̆ng-guók huòng-dá̤	Category:中国皇帝
分類:Huòng-dá̤	Category:皇帝
分類:Nguòng-dièu huòng-dá̤	Category:元朝皇帝
分類:Céng-dièu huòng-dá̤	Category:晋朝皇帝
分類:Chĭng-dièu huòng-dá̤	Category:清朝皇帝
分類:Háng-dièu huòng-dá̤	Category:漢朝皇帝
Cié-cáu	祭灶节
分類:Báe̤k Mī-ciŭ	Category:北美洲
分類:Gŏ̤-chiū	Category:歌手
分類:Hù	Category:湖泊
分類:Só-hŏk-gă	Category:数学家
模板:Infobox ngṳ̄-ngiòng	Template:Infobox Language
分類:Dâi-iòng-ciŭ	Category:大洋洲
Dák-cāi	掃墓
分類:Tiĕng-căi	Category:自然灾害
分類:Gô-dā̤ gì guók-gă	Category:已不存在的國家
Ŭ-ták	崇妙保圣坚牢塔
Kié-dâ̤	契兄弟 (同性戀)
Săng-sĕk-màng-buŏ	除夕
Hĭng-huá-nè̤ng	兴化人
Chék Lìng Báik Ĭng	戚林八音
Vĩnh Long	永隆省
分類:Sié-gái	Category:世界
分類:Dṳ̆ng-huà Ìng-mìng Gê̤ṳng-huò-guók	Category:中华人民共和国
Cāi-puŏi	瓦通紙
分類:Giông-kŏng	Category:健康
Hâ-cé	夏至
分類:Sáng Uòng (王)	Category:王姓
分類:Sĕng-lī	Category:生理學
Bóng-kăng-chió	廁所
分類:Sáng Lī	Category:李姓
分類:Â-muòng	Category:廈門
Trojany	特洛疆尼
模板:Infobox color	Template:Infobox color
分類:Ngū-dâi Sĕk-guók gì huòng-dá̤ gâe̤ng guók-uòng	Category:五代十國君主
Uòng Iòng-céng	王延政
Hók-gióng Uōng-mìng Áng	福建网民案
分類:Ā-ciŭ guók-gă	Category:亚洲国家
分類:Mī-ciŭ guók-gă	Category:美洲国家
Ciŏng-ciŭ-uâ	漳州话
模板:User yue-2	Template:User zh-yue-2
模板:User nan-2	Template:User nan-2
模板:User la	Template:User la
模板:User cdo-3	Template:User cdo-3
模板:User cdo-2	Template:User cdo-2
模板:User cdo-1	Template:User cdo-1
模板:User cdo	Template:User cdo
模板:ISO 639 name zh	Template:ISO 639 name zh
模板:ISO 639 name en	Template:ISO 639 name en
分類:Ŭng-ciŭ	Category:温州
分類:Huák-lŭk	Category:法律
Sĭng-bô	兒媳
分類:Káh-gă	Category:客家
Puòi-à̤	皮鞋
Dìng Siók-sĕng	陳雪生
Iòng Chŭi-sĕng	楊綏生
分類:Cò̤-ngôi huòng-dá̤	Category:曹魏皇帝
分類:Dṳ̆ng Mī-ciŭ guók-gă	Category:中美洲國家
分類:Sŏng-ngù huòng-dá̤	Category:東吳皇帝
分類:Bēng-guòng	Category:版权
分類:Hók-gióng ùng-huá	Category:福建文化
分類:Biēu-cìng	Category:面部表情
分類:Hók-ciŭ	Category:福州
分類:Káh-gă ùng-huá	Category:客家文化
分類:Hók-gióng lĭk-sṳ̄	Category:福建歷史
分類:Ôi-sĕng	Category:卫生
分類:Hâiu-dòng huòng-dá̤	Category:後唐皇帝
分類:Ciòng-ciŭ	Category:泉州
分類:Mìng-dĕ̤ng-ngṳ̄	Category:闽东语
分類:Dṳ̆ng-huà Mìng-guók	Category:中華民國
分類:Nìng-dáik	Category:宁德
分類:Hók-ciŭ-nè̤ng	Category:福州人
分類:Sṳ̆k-háng huòng-dá̤	Category:蜀漢皇帝
分類:User cdo	Category:Cdo 使用者
分類:User cdo-M	Category:Cdo 母語使用者
模板:Image label begin	Template:Image label begin
模板:Dṳ̆ng-huà Mìng-guók Hèng-céng-kṳ̆	Template:中華民國自由地區行政區劃
分類:Diêng-ké	Category:電器
分類:Hŭng-cūi	Category:风水
分類:Sĕng-uăk	Category:生活
分類:User cdo-1	Category:Cdo-1 使用者
分類:User cdo-2	Category:Cdo-2 使用者
分類:User cdo-3	Category:Cdo-3 使用者
分類:Săng-mìng	Category:三明
Uòng-pŭng	黄蜂
Sĕk-huăng	十番
分類:Gáuk cék-ngiĕk gì ìng-ŭk	Category:人物 (依職業區分)
Âu-gă̤	南后街
分類:Sáng Làu	Category:刘姓
分類:Nàng-bìng	Category:南平
分類:Sáng Sṳ̆-mā	Category:司马姓
分類:Sáng Ngù (吳)	Category:吴姓
分類:Sáng Ciŭ	Category:周姓
模板:User vi	Template:User vi
分類:Sáng Sŏng	Category:孙姓
分類:Sáng Cò̤	Category:曹姓
分類:Sáng Diŏng	Category:张姓
分類:User en-1	Category:En-1 使用者
分類:User de-1	Category:De-1 使用者
分類:Mìng-nàng	Category:閩南
分類:Gă-sĭ-huă	Category:工具
分類:Sáng Gŏ̤	Category:高姓
分類:Ciŏng-ciŭ	Category:漳州
分類:Sáng Mò̤	Category:毛姓
分類:Mìng-cŭk	Category:民族性
分類:Sáng Dìng	Category:陈姓
分類:Lṳ̀ng-ngàng	Category:龙岩
分類:Mìng-guók guók-uòng gâe̤ng huòng-dá̤	Category:閩國君主
分類:Sáng Ciŏ	Category:朱姓
分類:Sáng Iòng	Category:杨姓
Nā-gŭng	拿公
Gì-săng	旗山国家森林公园
Hùng-săng-giò	洪山桥
Băh-mā-cŏng-uòng	白馬尊王
Lìng-cūi-nā̤	臨水夫人
Mìng-kiŏk	闽剧
Wikipedia:失效鏈接	Wikipedia:失效链接
Guă-cī	瓜子
分類:Sáng Lìng	Category:林姓
分類:Sáng Hàng	Category:韩姓
分類:Sáng Hùng	Category:洪姓
分類:Hĭng-huá ùng-huá	Category:莆田文化
Săng-săng-cé	三山志
Dĕ̤ng-ĕu-guók	东瓯国
Dṳ̆ng-ciŭ Gĭ-dók-gáu-dòng	中洲基督教堂
Ŭ-săng	乌山 (福州)
Ṳ̀-săng	于山
Ṳ̀-siêng	余善
Có̤ buáng-dâung	做半段
Guŏng-liŏh-huŏng	光禄坊
Báik-siĕng-dó̤h	八仙桌
Liù-giù	琉球群岛
Nàng-uŏk	南越
Băh-mā-ò̤	白马河 (闽江)
Gék-puòi-lô	吉庇路
Ták-háe̤ng	塔巷
Niè-sái	女婿
Ăng-mìng-háe̤ng	安民巷
模板:User nan-3	Template:User nan-3
模板:User wuu	Template:User zh-wuu
Sêu-săng-siŏh	寿山石
Séng-ìng-miêu	福州文庙
Diāng-biĕng-gù	鼎边糊
Ngù-nèng	牛奶
Diŏng Báik-ngṳ̆k	张伯玉
Giòng-cié cháik-chiĕng	强制拆迁
Biēng-nṳ̆k-iéng	扁肉燕
Băh-ták	报恩定光多宝塔
Cĕu Ièu	搖 (東甌王)
Siŭ-ĭng-gĭ	收音机
Ùng-ṳ̀-huŏng	文儒坊
Lṳ̆k-dê	陆地
Ù-cṳ̆	无诸
Céng-ăng-ò̤	晋安河
Ciŏ-ciē-huŏng	朱紫坊
Iòng-giò-lô	杨桥路
Iù-uōng-ĭk	柔远驿
Ṳ̄ng-ciòng-sê	涌泉寺 (福州)
Uòng-háe̤ng	黄巷
Mī	米 (消歧義)
Să̤-hù	西湖 (消歧义)
Hāi-chái	海帶
Mìng-ìng Săng-sĕk-lĕ̤k-sáng	閩人三十六姓
Gĭng-dáng	今天
模組:Citation/CS1/Whitelist	模块:Citation/CS1/Whitelist
Gŭng-ô-nguòng	公務員
Hù-diĕk	蝴蝶
模板:Hók-gióng	Template:福建行政区划
Chái-tàu	萝卜
模板:HideH	Template:HideH
Nguòng-siĕu-cáik	元宵节
Bìng-săng	屏山 (福州)
模板:Infobox Language/genetic	Template:Infobox language/genetic
Dṳ̆ng-săng	中山
Sì	𥻵 (福州)
模板:ISO 639 name cdo	Template:ISO 639 name cdo
模板:User cdo-0	Template:User cdo-0
分類:Sáng Gŏng	Category:江姓
分類:Sáng Hù	Category:胡姓
分類:Sáng Diêu	Category:赵姓
分類:Sáng Dâing	Category:邓姓
分類:Sáng Dâng	Category:郑姓
分類:Sáng Uòng (黃)	Category:黄姓
Lò̤-sĭng-ták	罗星塔
分類:Buò-dièng	Category:莆田
Wikipedia:Unicode擴展漢字	Wikipedia:Unicode扩展汉字
模板:Ping	Template:Reply to
Uô-guōi	芋粿
模板:Internal link helper/en	Template:Internal link helper/en
Yun Hyon-seok	六友堂
模板:Ruby	Template:Ruby
Ngô-nguŏk-cáik	端午节
Chék-nguŏk-chék	七夕
模組:Arguments	模块:Arguments
特殊:最近其改變	Special:最近更改
模組:Citation/CS1	模块:Citation/CS1
模組:Citation/CS1/Configuration	模块:Citation/CS1/Configuration
模組:TableTools	模块:TableTools
模組:HtmlBuilder	模块:HtmlBuilder
模組:Coordinates	模块:Coordinates
模組:Math	模块:Math
模組:Infobox	模块:Infobox
模板:China Expwy Name	Template:China Expwy Name
模組:China Expwy Name/ImageRefs	模块:China Expwy Name/ImageRefs
模組:China Expwy Name/NameFromCode	模块:China Expwy Name/NameFromCode
模組:China Expwy Name/Province	模块:China Expwy Name/Province
模組:China Expwy Name/TranslateCode	模块:China Expwy Name/TranslateCode
分類:Sáng Ū	Category:武姓
Liĕk-chiĕ-nṳ̆k	荔枝肉
Hók-chiăng-uâ	福清話
Hà-puō-uâ	霞浦话
Ĕu Hò̤	欧豪
Gāi-huóng-dâi-giò	解放大桥 (福州)
Dìng Ùng-lṳ̀ng	陳文龍
Déng-hāi-làu	镇海楼 (福州)
Cĕu Tīng	郢 (閩越國王)
Să̤-sièng-sê	西禅寺
Dâing Mâiu-chék	邓茂七
Gŏ̤ Sê̤ṳ-gì	高士其
Huōi-chiòng	闽东封火墙
Ăng-tái-ò̤	安泰河
Hók-ciŭ Să̤-hù	福州西湖
Dĕ̤ng-hāi	东海 (消歧义)
Gṳ̆ng-háe̤ng	宫巷 (福州)
Mìng-dĕ̤ng	闽东
Mìng-báe̤k	闽北
Mìng-să̤	闽西
Bŏ̤-bŏ̤-guōi	菠菠粿
Gĭng-săng-sê	金山寺 (福州)
Làu-giè-dō̤	琅岐岛
Ĭ-gīng-huŏng	衣锦坊
Gê-nṳ̄	娼妓
模組:China Expwy Name	模块:China Expwy Name
分類:Sĕk-ék ùng-huá	Category:福州文化
Gāu-siĕng-gŭng	何氏九仙
Băh-guōi	白粿
Làu Cĕng-éng	劉增應
分類:Mìng-nàng ùng-huá	Category:閩南文化
Só̤h-miêng	线面
Hĭng-huá Bàng-uâ-cê	興化平話字
Ì-sông-gŏ̤ cióh-dé	贻顺哥烛蒂
Nìng-dáik-uâ	寧德話
Mìng-dĕ̤ng-ngṳ̄ Nàng-piéng	侯官片
Mìng-dĕ̤ng-ngṳ̄ Báe̤k-piéng	福宁片
Kŭ-chèng-uâ	古田话
分類:Mìng-dĕ̤ng	Category:閩東
Cáu-gŭng	灶君
Gióng-nìng Lò̤-mā-cê	建寧羅馬字
分類:Dŭng-nìng guók-uòng	Category:鄭氏王朝君主
