Mo'hetaneho'e	非洲
Norway	挪威
Ireland (Republic)	爱尔兰共和国
Spain	西班牙
United States	美国
Poland	波兰
Lithuania	立陶宛
Italy	意大利
Switzerland	瑞士
Austria	奥地利
Turkey	土耳其
Héesevo'tamahpe	啤酒
Hóxovê-hooma	欧洲
Asia	亚洲
Wikipedia	维基百科
Netherlands	荷兰
Vášêtaëno	华盛顿哥伦比亚特区
San Francisco	旧金山
Los Angeles	洛杉矶
Tséohketoetanóto	電子計算機
Netse Ôhmo'ôhtávaestse	贝拉克·奥巴马
Má'xeme	苹果
Paris	巴黎
Mé'šeeséve'ho'évenó	墨西哥
California	加利福尼亚州
Péhpe'énanóse'hame	狮
France	法国
Oeškese	犬
United Kingdom	英国
China (People's Republic of China)	中华人民共和国
Manestôtse	酒
Russia	俄罗斯
Ma'evé'ho'éno	德国
Ame'hahtôtse'	固定翼飛機
Ukraine	乌克兰
Czechia	捷克
Slovakia	斯洛伐克
Slovenia	斯洛文尼亚
Roma	罗马
Croatia	克罗地亚
Wolfgang Amadeus Mozart	沃尔夫冈·阿马德乌斯·莫扎特
Mo'hetaneho'e hánêsóvóne	南非
Mahpe	水
Chile	智利
Serbia	塞尔维亚
Taa'é-eše'he	月球
Tsésáa-nanóhehane ame'hahtôtse	不明飞行物
Vé'ôhkêheóvemá'xeme	柠檬
Vóhka'émene	香蕉
Hotohke	恒星
Éše'he	太阳
Chihuahua	奇瓦瓦州
Tonga	東加
Nauru	諾魯
Mo'éhno'ha	马
Hova	动物
Kokêhéaxa	鸡
Arizona	亞利桑那州
Amérika	美洲
Utah	犹他州
Republic of China	中華民國
Ma'aataemeo'o	鐵路列車
Vietnam	越南
Véhone-ma'kaata	金
Tanzania	坦桑尼亚
Zambia	赞比亚
Zimbabwe	辛巴威
Republic of the Congo	刚果共和国
Democratic Republic of the Congo	刚果民主共和国
Madagascar	马达加斯加
Malawi	马拉维
Namibia	纳米比亚
Julius Caesar	尤利烏斯·凱撒
South Dakota	南达科他州
Ho'honáéšé'e	蒙大拿州
Wyoming	怀俄明州
Nevada	内华达州
Colorado	科羅拉多州
Tseohke-pano'ohe	果醬
Category:Wikipedia content	Category:頁面分類
Chicago	芝加哥
Mene	果实
Mákohe	猴
Meškêso	昆虫
Amâho'hestôtse	汽车
Toháano'ého'ëva	德克萨斯州
Buenos Aires	布宜諾斯艾利斯
Barcelona	巴塞罗那
Šéstotó'emeno	菠蘿
Ma'xeé'ome'tää'e	密西西比河
Caracas	卡拉卡斯
Nebraska	內布拉斯加州
Kansas	堪薩斯州
Heévȧhetanéno	奧克拉荷馬州
Ma'heónemôxe'êstoo'o	聖經
Ho Chi Minh City	胡志明市
Dong Hoi	同海市
Concepción	康塞普西翁 (智利)
Še'šenovôtse	蛇
Madrid	马德里
Santiago (Chile)	圣地亚哥-德智利
Hévoetanâháve'ho'éotoa'e	乳牛
Mé'hahtsékósa	家山羊
Ho'ësta	火
Antofagasta	安托法加斯塔
Brazzaville	布拉柴维尔
Copiapó	科皮亞波
Moxe'estonemaheo'o	学校
Oomâhóoné-mâhéó'o	住宅
Ó'he'e	河流
Eschweiler	埃施韦勒
Dong Hoi Airport	同海機場
Curitiba	庫里奇巴
Talca	塔爾卡
Corbin Bleu	柯賓·布魯
Vôhe'so	巢
Ve'kese	鸟
Almazán	艾爾瑪善鎮
Va'ohtama	Wikipedia:首页
Hohtsemo	篮球
Ho'honáá'e Tsé'amoo'êse	洛磯山脈
Hóoma	被子
Category:Candidates for speedy deletion	Category:快速删除候选
Véhpotséhohpe	茶
Axenôhonestôtse	吉他
Hotohke tséana'ôhtse	流星体
Mâhtovoo'ôtse	耳
Kosa	綿羊
Pa'e'pa'onáhe	骆驼
Tsêhe'êseeséhe	象
Háhnoma	蜂族
Hésta'se	雪
Ka'êškone	儿童
Kóhkonêhëö'o	麵包
O'êhnémâhéó'o	馬桶
Nelson Mandela	纳尔逊·曼德拉
Vo'e	云
Ma'xêhevovetäso	龍捲風
Mahpe hevovetäso	熱帶氣旋
Category:Némenestôtse	Category:音乐
Mó'soonêó'he'e	阿肯色河
Ma'êhóóhe	赤狐
Mo'ôhtávêhohpe	咖啡
Matana	乳
Bilbao	毕尔巴鄂
Sevilla	塞维利亚
Valencia	巴倫西亞
Vohkoohe	兔
No'kéeho	松鼠
Ronald Reagan	罗纳德·里根
Ma'xetoeneško	北斗七星
Éškôseeséhotame	猪属
Hoohtsêstse	树
Hohpâháa'éheme	葡萄
Háhnomápano'êhasëö	蜂蜜
Aéstomemésêhestôtse	马铃薯
Vé'keemahpe	食糖
Hóo'xevávôxe'êstoo'o	報紙
Aseéestsestôtse	电话
Lugo	卢戈 (西班牙)
Vóhpoma'ôhtse	食盐
Onéhavo'e	鼓
Amo'a'óvâhtsestôtse	自行車
Vóhpeeva	棉花
Môxe'êstoo'o	纸
Ová'kemâhaemenôtse	玉米
Náhkohe	熊科
Hoéstoneéše'he	历法
E'kôsé'haseo'o	可麗餅
Hóxovôho'o	橋
Hualpén	瓦爾彭
Jalisco	哈利斯科州
Hohpâhtsenámenôtse	葡萄乾
Tsétóno	冰淇淋
Vé'keekóhkonôhëö'o	曲奇
Vé'keahonoo'o	蛋糕
Asêséoneo'amestôtse	弹弓
Tsé'ôhke -évo'sóévôse ka'êškóneho	體育館
Santiago de Compostela	聖地亞哥-德孔波斯特拉
Oviedo	奥维耶多
Heškóvemata	仙人掌
Hoohëö'o	旗幟
Táxemésêhestôtse	桌子
Heóvâhá'enëö'o	烤面包机
Táxe'êséestôtse	椅
Tsêhe'êsenotováhe	长颈鹿
Nuevo León	新萊昂州
Freddie Mercury	弗雷迪·默丘里
Template:Link FA	Template:Link FA
Denver	丹佛
Austin (Texas)	奧斯汀
Naa'émâhéó'o	醫院
Sacramento	沙加緬度
Vonomóhtâhestôtse	阿司匹林
Hó'nehe	狼
Bien Hoa	边和市
Manëhe	鹈鹕
Nha Trang	芽莊市
Breinigerberg	贝瑞宁格堡
He'kone'éemâsono	通心粉
Vung Tau	頭頓市
Aruba	阿魯巴
Néške'ësta	花栗鼠
Mo'kêhanôtse	鞋
Hestaahtsémeno	茶藨子科
Váótséva	鹿科
Má'ome	冰
Heškóvemâhöö'o	黄瓜
Xaóenêhéstâhévo	洋蔥
Moshchena	穆夏那
Paltoga	帕托加
Mérida (Venezuela)	梅里達市
Ho'ose	煤
Vé'kêséhemêstaa'e	貓頭鷹
Ca Mau	金瓯市
Poeso	猫科
Curaçao	库拉索
Tôhohko	槌
Tâhpe'âséhahnoma	熊蜂
He'haéheséeo'ôtse	蓍
Vó'ho'kâsénoma'ne	萤科
Tsêhe'êsevotoná	雉鸡
Sint Maarten	荷屬聖馬丁
Heo'këso	麝鼠
Héna'e	加拿大雁
Sósone'e	休休尼人
Mâhóomoehá-vé'késo	鷗
Nanomóne-éšeëva	國殤紀念日
Ôhtaenémâhéó'o	酒店
Mâhpé-aénohe	银鸥
Hevavâhkema	鱗翅目
Méšenonetsénóne	蝙蝠
Tsé-tó'hovane	三明治
Kingdom of the Netherlands	荷兰王国
Heóvêstséávó'êstse	蒲公英
Anonévee'tose	野胡萝卜
Ónonevóneške	草原犬鼠
Avril Lavigne	艾薇兒·拉維尼
Hoéstónéó'o	计算器
Motšêške	小刀
Nêškovávo'ha	斑馬
Vóhpenáhkohe	北極熊
Oaxaca	瓦哈卡州
Heóveamêške	黄油
Meo'o	道路
Anastacia	安娜塔西亚
Henenó'e	蔷薇属
Albuquerque	阿布奎基 (新墨西哥州)
Tequixquiac	特基斯基阿克
Ma'xepóno'e	奧克拉荷馬市
Môxe'êstóonémâhéó'o	郵政局
Nanóse'hame	美洲狮
Mâhpémo'éhe	駝鹿
Vo'kome-mâheo'o	白宮
Boise	博伊西
Semo	艇
Vóhkooheme	無花果
Thanh Hoa	清化市
Puerto Montt	蒙特港
Mo'otsenahkohe	棕熊
Toóneohëö'o	钉子
Ma'aataéve'éxanéstotôtse	眼鏡
Campora San Giovanni	肯波拉圣吉奥瓦尼
Tono'sëö'o	冰箱
Ka'énêhótame	斗牛犬
Éškôsénéhe	格雷伊獵犬
Nêxo'mévéhe	西瓜
Vótâháéno tsénéma'ó'á'ha	風車 (動力機)
Péhpe'éoeškëso	贵宾犬
Hóhkeehe	小鼠属
Heséeotséve'ho'e	医生
Ma'o'hoáá'e	磚
Tó'too'he	金雕
Môxe'a'xémâhéó'o	電影院
Ma'xêheóvema'xemeno	葡萄柚
Hohpe	汤
Hovéo'kôheo'	傘
Talcahuano	塔爾卡瓦諾
Šéeše-stôtse	床
Ma'emonêškeho	菜豆
Tsé-éškôsa'évetováto	圆锥
Péhpe'épóéso	波斯貓
Johnny Cash	約翰尼·卡什
Homôse-mâheo'o	廚房
Ma'xeamóvôhtó'hestôtse	载货汽车
Ókohke	乌鸦
Háestôheóhtáhe	蜈蚣
Vótâháéno	井
Hotóa'ôxhoo'êstse	坐牛
Ma'kaataevé'késo	蜂鸟
Ma'xêhë'ne	火雞
Ó'kôhóme	郊狼
Jim Morrison	吉姆·莫里森
Sonora	索諾拉州
Guanajuato	瓜納華托州
Ma'kaatohko	水桶
Ována'xaetanohtôtse	寧靜禱文
Móxêšéne	薄荷
Héne'enovâhétane	学生
Hahpenó'estôtse	縫紉機
Mo'ôhtameöhtsêstse	非裔美国人
Coahuila	科阿韋拉州
Baja California	下加利福尼亞州
Ȧxeohōva	鮎形目
Chiapas	恰帕斯州
Guerrero	格雷羅州
Yucatán	尤卡坦州
Colima	科利馬州
Hovë'še	威氏鹬
Morelos	莫雷洛斯州
San Luis Potosí	聖路易斯波托西州
Sóhkomevó'ho'kâsenestôtse	蜡烛
Querétaro	克雷塔羅州
Michoacán	米却肯州
Durango	杜蘭戈州
Nayarit	納亞里特州
Puebla	普埃布拉州
Aguascalientes	阿瓜斯卡連特斯州
Tamaulipas	塔毛利帕斯州
Quintana Roo	金塔納羅奧州
Sinaloa	錫那羅亞州
Zacatecas	薩卡特卡斯州
Alla Pugacheva	阿拉·普加乔娃
Hidalgo	伊達爾戈州
Campeche	坎佩切州
Tabasco	塔巴斯科州
Monterrey	蒙特雷
Hóma'e	美洲河狸
Ma'xeméstaa'e	大雕鴞
Tlaxcala	特拉斯卡拉
Hotoa'e	美洲野牛
Xäö'o	臭鼬科
Grand Theft Auto: San Andreas	俠盜獵車手：聖安地列斯
Háhkota	草蜢
Môhtséheonetane	阿帕契族
É'koo'óhtotôtse	双筒望远镜
Sena'kaneo'o	切羅基人
Oo'kóhtâxová-mâhéó'o	理发师
Ho'óhomö'e	苏族
Man o' War	鬥士 (馬)
Óova'e	云母
Vétapâhaetó'eo'o	基奧瓦人
Matšeškome	浣熊
Mo'ôhtáenáhkohe	美洲黑熊
Hohtâhé-noma'he	鲫鱼
Ho'éméhne	蚯蚓
Vóaxáa'e	白頭海鵰
Tónovâhonónestôtse	平底锅
Nêševâhá'eneo'o	微波炉
Vétaneo'hé'e	南普拉特河
Tamena'éveéstse'he	T恤
Mohkave	短尾貓
Ta'ta'ôhëö'o	鑰匙
Grand Theft Auto	俠盜獵車手系列
Vée'e	梯皮
Vé'ho'êškóovo'hestôtse	針
He'konö'êstse	野牛草
Vétánó'êstse	宽叶香蒲
Oó'xôseonéame	花生酱
Hóxâhtsenáesëö'o	马辔
Tsé'amóneane	圍欄
Onéma'ó'aneo'o	扳手
Vé'ôhkemahpe	红河 (密西西比河)
Otá'tavö'êstse	紫花苜蓿
Heóvemo'ôhta'e	蕪菁甘藍
Pachuca de Soto	帕丘卡
Onéma'táo'aneo'o	螺钉旋具
Motsé'eonôtse	茅香
Mótó'e	美国红梣
Me'êškema	梣叶槭
Hohnóhkâ-heséeo'ôtse	金露梅
Mo'ôhtáemâhoo'o	笋瓜
Pó'po'êho'hémâhaemenôtse	玉米花
Hoxo'ôhtséveotá'tavo'honáá'e	绿松石
Hevéesénoma'ne	白斑狗魚
É'êxováhtóva	比靈斯
Caselle Landi	卡塞莱兰迪
Vé'ho'éome	帳篷
Vóhpâhtse-náhkohe	灰熊
Hoeseonó'e	床垫
Xamaesémo	獨木舟
Môxéhéó'o	帚
Veracruz	韦拉克鲁斯 (韦拉克鲁斯州)
Tootómôhéó'o	空氣調節
Ho'êstásémo	蒸汽船
Tséx-háenaotséstove	1918年流感大流行
Mo'éhe	加拿大馬鹿
Vóetséna'évôxe'êstónestôtse	白堊岩
Heškóvoneanëö'o	铁丝网
Hova'ó'xestôtse	鞍
Terry	特里 (蒙大拿州)
Vé'ho'éotóaho'évohkôtse	牛肉
Ma'xeamâho'hestôtse	廂型車
Banovci (Nijemci)	巴諾夫齊
Otá'tavâho'hé-vé'késo	冠蓝鸦
Mo'e'évetoo'o	籃
Hoho	手镯
Mo'e'évôhkêha'e	草帽
Âxeetoo'é'hasëö'o	鱼钩
Tsé'ôhke-énâhenéstove	加油站
Ama'éno'hamémôxe'êstoo'o	駕駛執照
Nøtterøy	內特島
Háeohémahpe	拉皮德城 (南达科他州)
Tooxo'hamëso	昔德蘭矮種馬
Hesto'tono'kêhanôtse	雪鞋
Vé'keehoohtsêstse	糖楓 (植物)
Amóvôhtó'hestôtse	皮卡
Vo'êstane	個人
Hoóneanatóe-vó'ho'kâsénâhnestôtse	煤油燈
Oómêsta'hasené-váótséva	白尾鹿
Séavóneške	美洲旱獺
Ma'ëno	龜
Nêhpo'aneo'o	锁
Ma'háhko'e	美洲獾
Asêséeéstse'he	毛衣
Vé'ho'e	白人
Vó'ho'êho'hóvahtôtse	手電筒
Ôxa'ôhévo'kêhanôtse	莫卡辛鞋
Sáhea'eo'o	欧及布威族
Kóhkonôheonané-mâhéó'o	麵包糕餅店
Hestóhkáhne	角蜥
He'óonéma'ëno	擬鱷龜
Náhkôhevee'e	魔鬼塔
Tsétsêhéstâhese	夏安族
Ne'potátse	大藍鷺
Hoxomôho'haméstotôtse	乾草
Mo'éheo'hé'e	黃石河
Monêškeho	豆类
Amo'xestôtse	露营
Ma'êšenévé'késo	旅鶇
A'o'tsémêstaa'e	穴鴞
Homenó'e	美国榆
Hesó'xôhéó'o	熨斗
Aésto'épeeneo'o	攪拌機
Vóhkoohévoomâheo'o	派尤特人
Hoehasené-amó'eneo'o	篷車
Hesó'xêšé'hóno	桌布
Vóo'kooma	红头啄木鸟
He'évánó'êstse	冷蒿
Ma'xemené-mahpe	蘋果汁
Pénôheoné-mâhéó'o	麵粉廠
Aéstomevé'keemahpe	甜味剂
Meneo'hé'e	普拉特河
Vó'aehno'xâhtóhonôtse	打底褲
Oévêheséeo'ôtse	一枝黃
Ama'éno'hamestôtse	方向盘
Mo'ôhtáevánó'êstse	豚草
Amêsema'ëno	箱龜屬
Heovese'tahe	棉尾兔属
Hetóhkoné-hohtóvá-mâhéó'o	五金店
Háestôhe'šeméhe	小嘲鶇
Aenohe	鹰
Mo'óhkonavekóhkonôheo'o	梳打餅
Tsévó'névóvâtse	棗色 (馬)
Ho'óseo'hé'e	科尔斯特里普 (蒙大拿州)
Broadus	布罗德斯 (蒙大拿州)
Red Lodge	雷德洛治 (蒙大拿州)
Joliet	乔利埃特 (蒙大拿州)
Ma'xemâhoévé'ho'eno	迈尔斯城 (蒙大拿州)
Tšêške'mâhoéve'ho'éno	福塞斯 (蒙大拿州)
He'konemâhoeve'ho'eno	哈丁 (蒙大拿州)
Ho'xó'mâhoéve'ho'éno	谢里登 (怀俄明州)
Mâhtóhtôhéé'êše Tsé'ôhkêhenove	滕斯利普 (怀俄明州)
Sonic The Hedgehog	刺猬索尼克系列
Heškóvó'êstse	風滾草
Heóvôhkâho'hé-vé'késo	黃腹紋霸鶲
Honóvóhko	肉乾
Vó'omeoó'omêše	大果櫟
Hotóao'hé'e	锡马龙河
Otaesétaneo'o	內茲佩爾塞人
Tó'êstó'ono	牛仔靴
Utsunomiya Line	宇都宮線
Ónonevonêške-móxêšéne	同花母菊
Heškovêstse	豪豬
A'kêstséahe	銅頭蝮
Mo'éhemóxêšéne	茴藿香
Honóxeäse	西草地鷚
Category:Ma'evé'ho'éno	Category:德国
Category:Italy	Category:意大利
Category:Russia	Category:俄罗斯
Category:Canada	Category:加拿大
Category:United Kingdom	Category:英国
Category:Spain	Category:西班牙
Category:Meško	Category:墨西哥
Category:Mo'hetaneho'e hánêsóvóne	Category:南非
Category:Egypt	Category:埃及
Category:Austria	Category:奧地利
Category:Democratic Republic of the Congo	Category:剛果民主共和國
Category:Poland	Category:波蘭
Category:Switzerland	Category:瑞士
Category:Tanzania	Category:坦尚尼亞
Category:Ukraine	Category:烏克蘭
Category:Vietnam	Category:越南
Category:Ve'kêseho	Category:鸟类
Category:Buildings	Category:建築物
Ma'ováhe	沙色 (馬)
Vé'ȯhkėheséeo'ȯtse	拟美国薄荷
Tonôhené-mâhéó'o	鐵匠
Mo'xôhtse	镞
Vétanovéo'hé'e	唐河 (蒙大拿州)
Tsévovó'hásêstse	白斑色 (馬)
Ho'sâhtsenáénâhéno	燕麥片
Netse	鵰
Ireland	愛爾蘭 (消歧義)
Yuka Ueno	上野優花
Séno'êhaseo'o	发夹
Héheotsé-heséeo'ôtse	加拿大薄荷
Tó'êsemónêškeho	四季豆
No'aneonó'e	光滑漆樹
Tsé-tšêške'óomoëha	池塘
Nomá'héškéso	米諾魚
Ho'honáéšé'e tséhestoo'emanese oo	蒙大拿州议会
Category:Manȧhého'e	Category:国家
Category:Héstanêheo'o	Category:人物
Egypt	埃及
Tónovêšé'hóno	帆布
Template:Bot	Template:Bot
Canada	加拿大
Category:Slovakia	Category:斯洛伐克
Category:Slovenia	Category:斯洛維尼亞
Category:Hóxovê-hooma	Category:欧洲
Category:Wikipedia help	Category:帮助文档
Template:Documentation	Template:Documentation
Wikipedia:Community Portal	Wikipedia:机器人/申请
Sung Jae-ki	成在基
Template:Softredirect	Template:軟重定向
Template:Delete	Template:Delete
Pónoeo'hé'e	大桑迪河
Wikipedia:Statistics	Wikipedia:统计
Category:Mo'hetaneho'e	Category:非洲
Template:Babel	Template:Babel
Template:Reflist	Template:Reflist
Template:Stub	Template:Stub
Template:User en-2	Template:User en-2
Template:User en	Template:User en
Category:Asia	Category:亚洲
Category:Chile	Category:智利
Category:Máhtáme	Category:食品
Template:Mod	Template:Mod
Template:User es-2	Template:User es-2
Category:User en	Category:En 使用者
Template:Documentation/start box	Template:Documentation/start box
Template:Documentation/end box2	Template:Documentation/end box2
Template:Documentation/start box2	Template:Documentation/start box2
Template:Template other	Template:Template other
Category:Máhtáme naa tsémâhpév-oom	Category:飲食
Template:Pp-template	Template:Pp-template
Category:Vose	Category:山
Template:IPA	Template:IPA
Category:Amérika	Category:美洲
Wikipedia:Nospam	Wikipedia:被保护的标题
Template:Coord/link	Template:Coord/link
Template:Coord	Template:Coord
Category:Wyoming	Category:怀俄明州
Category:User en-N	Category:En 母语使用者
Mâ-htáeme	蝨毛目
Category:Mahpe	Category:水
Category:Tsémâhpév-oom	Category:饮料
Category:Heévȧhetanéno	Category:奧克拉荷馬州
Category:Mâhoestôtse	Category:城市社區
Pano'êhasëö'o	糖漿
Category:Hoohtsêstse	Category:树
Náhkôhematôtse	梅乾
Template:Coord/dec2dms/dm	Template:Coord/dec2dms/dm
Category:Nebraska	Category:內布拉斯加州
Category:North Dakota	Category:北达科他州
Category:South Dakota	Category:南达科他州
Category:Idaho	Category:爱达荷州
Category:Alaska	Category:阿拉斯加州
Category:Oregon	Category:俄勒冈州
Category:Kansas	Category:堪薩斯州
Category:Colorado	Category:科罗拉多州
Category:Toháano'ého'ëva	Category:得克萨斯州
Category:Šé'hóno	Category:紡織
Category:Poeso	Category:貓科
Category:Malawi	Category:马拉维
Category:Namibia	Category:纳米比亚
Category:Republic of the Congo	Category:剛果共和國
Category:Ho'honáéšé'e	Category:蒙大拿州
Template:Citation/core	Template:Citation/core
Category:Ó'he'e	Category:河流
Category:Zambia	Category:赞比亚
Category:Zimbabwe	Category:津巴布韦
Category:Nomá'ne	Category:鱼类
Category:Énano'émâhtáme	Category:蔬菜
Category:Mene	Category:水果
Category:Mo'éhno'häme	Category:馬
Category:Hovahne	Category:动物
Category:Še'šenovôtse	Category:蛇亚目
Category:Hoohëö'o	Category:旗帜
Ménôhe'éhestatseo'o	鏟子
Category:Váótséva	Category:鹿科
Anonévee'tose (énano'émâhtáme)	胡萝卜
Template:Coord/sub doc	Template:Coord/display/inline,title
China	中國 (消歧義)
Trojany	特洛疆尼
Category:Vášêtaëno	Category:华盛顿哥伦比亚特区
Category:Náhkohe	Category:熊科
Category:Homôse-mâheo'o	Category:廚房
Category:User chy-0	Category:Chy-0 使用者
Category:User chy	Category:Chy 使用者
Heóvêháhnoma	黄蜂
Hóxeeséeto'hamestôtse	笼头
Special:RecentChanges	Special:最近更改
