非洲	非洲
日本	日本
南美洲	南美洲
Nò-vî	挪威
Sû-kak-làn	蘇格蘭
Vî-ngì-sṳ̂	威爾士
Pet Oi-ngì-làn	北爱尔兰
Hiûng-ngà-li	匈牙利
Sî-pân-ngà	西班牙
Mî-koet	美国
Pí-li-sṳ̀	比利时
Lù-sêm-pó	卢森堡
Yî-chhiu	宇宙
Thi-khiù	地球
Sâng-miang	生命
Ngìn-lui	人
George Washington	乔治·华盛顿
Fûn-làn	芬兰
Shuì-tién	瑞典
Tan-ma̍k	丹麦
Pô-làn	波兰
Li̍p-thâu-vón	立陶宛
Yi-thai-li	意大利
Shuì-sṳ	瑞士
O-thi-li	奥地利
Hî-lia̍p	希腊
Thú-ngí-khì	土耳其
Phù-thò-ngà	葡萄牙
歐洲	欧洲
亞洲	亚洲
北美洲	北美洲
南極洲	南极洲
Vì-kî Pak-khô	维基百科
Hò-làn	荷兰
Néu-yok-sṳ	纽约
Fà-sṳ̀n-tun Kô-lùn-pí-â Thi̍t-khî	华盛顿哥伦比亚特区
Khiu-kîm-sân	旧金山
Pak-lìm	柏林
Lo̍k-chhám-kî	洛杉矶
Thien-nó	電子計算機
Mióng-chi-mióng-lu	互联网
Barack Obama	贝拉克·奥巴马
Vû-lâ-kûi	乌拉圭
Lùn-tûn	伦敦
Phìn-kó	苹果
Pâ-lì-sṳ	巴黎
Â-pak-lâ-hón Lìm-khén	亚伯拉罕·林肯
Google	Google
Me̍t-sî-kô	墨西哥
Thai-sî-yòng	大西洋
Thai-phìn-yòng	太平洋
Kâ-li-fuk-nì-â	加利福尼亚州
Pô-sṳ-tun	波士顿
Fó-sên	火星
Âi-set-ngò-pí-â	埃塞俄比亚
Sṳ̂-é	狮
Fap-koet	法国
Sṳ-kie-ngî	世界语
Kiéu-è	犬
Yîn-koet	英国
Meu-é	猫
中華人民共和國	中华人民共和国
Fap-ngî	法语
Ǹg-è	鱼
Pâ-sî	巴西
François Hollande	弗朗索瓦·奥朗德
Ngò-lò-sṳ̂	俄罗斯
Kîn-ǹg	鯨目
Chang-fông-hìn	正方形
Tô-lùn-tô	多伦多
Â-lâ-pâ-mâ	亚拉巴马州
Québec-sén	魁北克
Boeing 747	波音747
Jimmy Wales	吉米·威爾斯
Tet-koet	德国
Pha̍k-ngò-lò-sṳ̂	白俄罗斯
Tet-ngî	德语
Pên-tó	冰岛
Song-ti	神 (一神教)
Oi-sâ-nì-â	爱沙尼亚
David Cameron	戴维·卡梅伦
Thú-sên	土星
Ku-thin-yi̍t Fî-kî	固定翼飛機
1	1
2	2
3	3
4	4
5	5
George W. Bush	乔治·沃克·布什
Lâ-thot-vì-â	拉脫維亞
Vû-khiet-làn	乌克兰
Tshia̍p-khiet	捷克
Sṳ̂-lo̍k-vì-nì-â	斯洛文尼亚
Lò-mâ-nì-â	羅馬尼亞
Pó-kâ-li-â	保加利亚
Lò-mâ	罗马
Mâ-khì-tun	馬其頓共和國
Â-ngì-pâ-nì-â	阿尔巴尼亚
Khiet-lò-âi-sî-â	克罗地亚
Pô-sṳ-nì-â lâu Het-set-kô-vì-ná	波斯尼亚和黑塞哥维那
Â-set-pai-kiông	阿塞拜疆
Set-phû-lu-sṳ̂	賽普勒斯
Kak-lû-kit-â	格鲁吉亚
Hâ-sat-khiet-sṳ̂-thán	哈萨克斯坦
Mí-li-thai	马耳他
Mô-na̍p-kô	摩纳哥
Mùng-thi̍t-nui-kô-lò	蒙特內哥羅
Sṳn Mâ-li-nok	圣马力诺
Kú-pâ	古巴
Eiffel Thiet-thap	艾菲爾鐵塔
Yin-thu-nì-sî-â	印度尼西亚
Wolfgang Amadeus Mozart	沃尔夫冈·阿马德乌斯·莫扎特
Pi-tô-fûn	路德维希·范·贝多芬
Thú-ngí-khì-ngî	土耳其语
Nàm-fî	南非
Vû-tsṳ̂-phe̍t-khiet-sṳ̂-thán	乌兹别克斯坦
Pô-tsṳ-nàm	波茲南
Fà-sâ	华沙
Súi	水
Thien-sṳ	电视
Chṳ-li	智利
Yâ-sû	耶稣
Súi-sên	水星
Li̍t-sṳ́	历史
Phìn-kó Kûng-sṳ̂	蘋果公司
Kîm-sên	金星
Ngî-ngièn	語言
Muk-sên	木星
Thiên-vòng-sên	天王星
Pu-lie̍t-thap-nì	布列塔尼半岛
Hói-vòng-sên	海王星
Thiên-vùn-ho̍k	天文學
Sîn-kâ-po	新加坡
Khô-ho̍k	科学
Montréal	蒙特利尔
Lie̍t-kî-tûn-sṳ-tên	列支敦斯登
Kiam-khiâu	劍橋
Thi-ngi-chhṳ Sṳ-kie Thai-chan	第二次世界大战
Cologne	科隆
Kak-tên-nì-â	格丁尼亚
Sṳ̍p-chhiet-chhiâng	什切青
Sṳ-ho̍k	数学
Lâ-tên-ngî	拉丁语
Pâ-lìm	巴林
Â-mî-nì-â	亞美尼亞
Set-ngì-vì-â	塞尔维亚
Ngie̍t-khiù	月球
Àu-thai-li-â	澳大利亚
Vu̍t-lî-ho̍k	物理学
Â-kîn-thìn	阿根廷
Pi-lû	秘鲁
Sâng-vu̍t-ho̍k	生物学
Tsêu-siên Mìn-tsú Tsú-ngi Ngìn-mìn Khiung-fò-koet	朝鲜民主主义人民共和国
Kán-pu-chhài	柬埔寨
Khiúng-liùng	恐龙
Yî-sṳ̂-làn-kau	伊斯兰教
Lech Wałęsa	莱赫·瓦文萨
Lin-é	輪
Lyon	里昂
Êu-chû Lièn-mèn	欧洲联盟
Rhône-Alpes	罗纳-阿尔卑斯
Chhiòn-khiù Chṳ̂-sín Mióng	万维网
Ńg-ngìn	女性
Khiûng-tsiâu	香蕉
Fâ	花
Mâ-lî-â-na̍p-hói	马里亚纳海沟
Chû-mu̍k-lòng-mâ-fûng	珠穆朗瑪峰
Sàng-sṳ	城市
Nâ-pho-lùn yit-sṳ	拿破仑一世
Ngit-tèu	太阳
Pâ-sṳ-tet	路易·巴斯德
大洋洲	大洋洲
Thai-yòng Hì	太阳系
Pô-lò-tit-hói	波罗的海
Ngâ-chhṳ	牙齒
Khîn	氢
Hoi (氦)	氦
Angela Merkel	安格拉·默克爾
Lî	锂
Phì	铍
Si	图书
Ngit	日
Ngièn	年
Sṳ-ki	世纪
Lò-tsṳ (Pô-làn)	罗兹 (波兰)
Khà-thok-vì-chṳ	卡托维兹
Ngie̍t-sû-fû	热舒夫
Phìn	硼
Thàn	碳
Tham	氮
Yòng	氧
Hàng-sên	行星
Yîm-ngo̍k	音乐
Rennes	雷恩 (伊勒-维莱讷省)
Mo̍k-sṳ̂-khô	莫斯科
Fuk	氟
Yi-thai-li-ngî	意大利语
Nái	氖
Sṳn Pí-tet-páu	圣彼得堡
Na̍p	钠
北	北
Mî	镁
Lî (鋁)	铝
Néu Sî-làn	新西兰
南	南
Yin-thu	印度
Si̍t	硅
Fap	钫
Lìn	磷
Thiet	铁
Tûng-kâ	東加
西	西
Liù-vòng	硫
東	東
Liu̍k	氯
Pâ-pu-â Néu-kí-nui-â	巴布亚新几内亚
Vî-lièn Sâ-sṳ-pí-â	威廉·莎士比亚
Â (氬)	氩
Kap	钾
Koi	钙
Yèn	铅
Mùng-kú-koet	蒙古国
Khong (鈧)	钪
Thai	钛
Genghis Khan	成吉思汗
Fàm	钒
Mien-yîn	缅因州
Kok	铬
Mâ	马
Thûng-vu̍t	动物
Sû-li-nàm	蘇利南
Màng	锰
Pâ-lâ-kûi	巴拉圭
Koi-â-nâ	圭亚那
Ngi-su̍t	艺术
Lòi	铼
Kô-lùn-pí-â	哥伦比亚
Kû	钴
Vû	钨
Ngiap (鎳)	镍
Fu̍t-kau	佛教
Pô-li-vì-â	玻利維亞
Tshṳ̀-nì-tha̍t lâu Tô-pâ-kô	千里達及托巴哥
Chhṳ̍t-vu̍t	植物
Sîn	锌
Néu Hàn-pu-ha	新罕布什尔州
Pí-â-vùi-sṳ̂-thok-khiet	比亚韦斯托克
Ngà-mâi-kâ	牙买加
Mà-sat-chû-set	麻薩諸塞州
Drenthe-sén	德伦特省
Overijssel-sén	上艾瑟尔省
Kûa-thi-mâ-là	危地马拉
Gelderland-sén	海尔德兰省
Pâ-hâ-mâ	巴哈马
Không-nái-tí-khiet-chû	康乃狄克州
Kiê-é	鸡
Ha-vî-yî	夏威夷州
Fùng-tû-lâ-sṳ̂	洪都拉斯
Tô-mí-nì-kâ	多米尼克
Tô-mí-nì-kâ Khiung-fò-koet	多明尼加
Kâ-chû (Thung-vu̍t)	家豬
Hói-thi	海地
Sat-ngì-ngá-tô	萨尔瓦多
Yî-lóng	伊朗
Yî-là-khiet	伊拉克
Â-lâ-sṳ̂-kâ	阿拉斯加州
Kô-sṳ̂-tha̍t Lì-kâ	哥斯达黎加
Yî-set-lie̍t	以色列
Pâ-nâ-mâ	巴拿马
Ya̍p-mùn	也门
Phiang-thu̍k	病毒
Pô-làn-ngî	波兰语
Yok-tan	约旦
Nì-kâ-lâ-kûa	尼加拉瓜
Fu-lò-lî-tha̍t	佛罗里达州
Kit-ngí-kit-sṳ̂-thán	吉尔吉斯斯坦
Â-li-sông-ná	亞利桑那州
Khô-vî-thi̍t	科威特
Liàu-koet	老挝
Lì-pâ-nun	黎巴嫩
O-le̍t-kông	俄勒冈州
Gi-tuk-gaau zung geh sin	基督教的神
Mâ-ngì-thoi-fû	马尔代夫
Yù-thâ	犹他州
Mâ-lòi-sî-â	马来西亚
Mién-thien	缅甸
Nì-pok	尼泊尔
Â-man	阿曼
Pâ-kî-sṳ̂-thán	巴基斯坦
Khà-tha̍t	卡塔尔
Mióng-khiù	网球
Sâ-vû-thi Â-lâ-pak	沙特阿拉伯
Sṳ̂-lî-làn-khà	斯里蘭卡
Si-li-â	叙利亚
Kâ	镓
Thap-kit-khiet-sṳ̂-thán	塔吉克斯坦
中華民國	中華民國
YouTube	YouTube
Châ	锗
Thai-koet	泰国
Sṳ̂n	砷
Thú-khû-man-sṳ̂-thán	土库曼斯坦
Abakan	阿巴坎
Sî	硒
Yî	铱
Â-lâ-pak Lièn-ha̍p Thai-kûng-koet	阿拉伯联合酋长国
Tshiù (溴)	溴
Pha̍k (鉑)	铂
Ye̍t-nàm	越南
Thai-hòn Mìn-koet	大韩民国
Khiet	氪
Â-fu-hon	阿富汗
J. R. R. Tolkien	J·R·R·托尔金
Lù	铷
Kîm	金
Men-kâ-lâ-koet	孟加拉国
Ufa	烏法
Ôn-kô-lâ	安哥拉
Vùn-lòi	文莱
Kúng	汞
Fî-li̍t-pîn	菲律宾
Thò	铊
Ngie-sat-khiet Ngiù-tun	艾萨克·牛顿
Albert Einstein	阿尔伯特·爱因斯坦
Sṳ̂	锶
Yet	钇
Pit	铋
Vòng-set	黄色
Tsan-pí-â	赞比亚
Sîn-pâ-pu-vî	辛巴威
北京	北京市
Tuva Khiung-fò-koet	图瓦共和国
Pok-tshṳ-ngá-na̍p	波札那
Pho (釙)	钋
Bayern	巴伐利亚
Baden-Württemberg	巴登-符腾堡
Ngo (砈)	砹
Lòi-sò-thok	莱索托
Mâ-tha̍t-kâ-sṳ̂-kâ	马达加斯加
Mâ-là-vî	马拉维
Stuttgart	斯图加特
Màu-li-thap-nì-â	毛里塔尼亚
Pô-làn-ngìn	波蘭人
Mo̍k-sông-pí-khiet	莫桑比克
Na̍p-mí-pí-â	纳米比亚
Nai-khi̍p-li-â	奈及利亞
Ko	锆
Nì	铌
Yû-li-vû-sṳ̂ Khái-sat	尤利烏斯·凱撒
Sṳ̂-vî-sṳ-làn	斯威士兰
Muk	钼
Thap	锝
Hamburg	汉堡
Thoi-chhia	代谢
Miên-yi̍t Hì-thúng	免疫系统
Lièn-ha̍p-koet	联合国
Sîm-chhong	心臟
Thèu-nó	脑
Phì-fû	皮膚
Ló	铑
Làm-set	藍色
Pâ	钯
Ngiùn	銀
Kak	镉
Yîn	铟
Siak	锡
Yu	鈾
Thi (銻)	锑
Ti	碲
Pu	钚
Tièn	碘
Nai	镎
Set	铯
Phù	镤
Pi	钡
Thú	钍
Kap (鉿)	铪
Than (鉭)	钽
Luì	镭
Tûng	氡
Alsace	阿尔萨斯
Auvergne	奥弗涅
Ôn-tet-là-pâng	安得拉邦
Me̍t-hiet-kîn	密歇根州
Burgundy	勃艮第
Aquitaine	阿基坦
Schleswig-Holstein	石勒苏益格-荷尔斯泰因
Hâ Saxony	下萨克森
Pet Rhine-Westphalia	北莱茵-威斯特法伦
Saxony	萨克森自由州
Yî-li-nò	伊利诺伊州
Thuringia	图林根
Saxony-Anhalt	萨克森-安哈尔特
Pet Tha̍t-khô-thâ	北达科他州
Brandenburg	勃兰登堡
Bremen-chû	不來梅州
Nàm Tha̍t-khô-thâ	南达科他州
Mùng-thai-nâ	蒙大拿州
Fài-ngò-mìn	怀俄明州
Yâ-lu-sat-lâng	耶路撒冷
Oi-tha̍t-hòt	爱达荷州
Fà-sṳn-tun	华盛顿州
Lù (鑪)	鑪
Nui-fà-tha̍t	内华达州
Hàn (𨧀)	𨧀
Hí (𨭎)	𨭎
Yin-thu-yòng	印度洋
Khô-sò-vok	科索沃
Kâ-le̍t-pí-hói	加勒比海
Pô (𨨏)	𨨏
Het (𨭆)	𨭆
Phan Kî-vùn	潘基文
Ma̍k (䥑)	䥑
Khô-lò-là-tô	科羅拉多州
Tha̍t	鐽
Siau-pâng	弗雷德里克·肖邦
Lùn	錀
Kô (鎶)	鎶
分類:Chú-yeu fûn-lui	Category:頁面分類
Chi-kâ-kô	芝加哥
Arnhem	阿纳姆
Tûng-kui	冬季
Sî-pân-ngà-ngî	西班牙语
Fî-là-thiet-fî	費城
Tî-tû	蜘蛛
Hèu-è	猴
Kîm-tshièn	貨幣
Vì-kit-nì-â	弗吉尼亚州
Sî Vì-kit-nì-â	西維吉尼亞州
Tshiâng-tséu	辣椒
Néu-yok-chû	纽约州
Sṳ (鈰)	铈
Phú	镨
Lò-tet-tó	羅德島州
Ńg	钕
Khûn-chhùng	昆虫
Mâ-lî-làn	马里兰州
Thi̍t-lâ-ngá	特拉华州
Yû (銪)	铕
Ngò-hài-ngò	俄亥俄州
Vì-kit-ngì	维吉尔
Machiavelli	尼可罗·马基亚维利
Pîn-sé-fap-nì-â	宾夕法尼亚州
Uetersen	于特森
O-kú-sṳ̂-tû	奥古斯都
Néu Chhe̍t-sî-chû	新泽西州
Fûn-làn-ngî	芬兰语
Yin-thi-ôn-na̍p	印第安纳州
Vì-sṳ̂-pha-siên	韦斯巴芗
Thù-là-chṳ̂n	圖拉真
Hâ-tet-liòng	哈德良
Khièu-tshṳ-â	喬治亞州
Mâ-khù-sṳ̂ O-lie̍t-lî-vû-sṳ̂	馬爾庫斯·奧列里烏斯
Zagreb	萨格勒布
Tet-khiet-sat-sṳ̂	德克萨斯州
Thai-mí-ngì-na̍p-tet-pâng	泰米尔纳德邦
Pet Khà-lò-lòi-na̍p	北卡罗来纳州
Nàm Khà-lò-lòi-na̍p	南卡罗来纳州
Loire-sén	卢瓦尔河
Pâ-set-lò-nâ	巴塞罗那
Vòng-lî	菠蘿
Me̍t-sî-sî-pí	密西西比州
Thièn-na̍p-sî	田纳西州
Néu Me̍t-sî-kô	新墨西哥州
Mìn-nì-sû-tha̍t	明尼蘇達州
Vî-sṳ̂-không-sîn	威斯康辛州
Oi-hò-fà	艾奥瓦州
Nui-pu-lâ-sṳ̂-kâ	內布拉斯加州
Khâm-sat-sṳ̂	堪薩斯州
Yin-thi-ngî	印地语
Me̍t-sû-lî	密蘇里州
Lu-yi-sṳ̂-ôn-ná	路易斯安那州
Khén-thap-kî	肯塔基州
Â-khén-set	阿肯色州
Neil Armstrong	尼尔·阿姆斯特朗
O-khiet-lâ-hò-mâ	奧克拉荷馬州
Pet-hói	北海 (大西洋)
Mo̍k-sṳ̂-khô-chû	莫斯科州
Kiel	基尔
Schwerin	什未林
Potsdam	波茨坦
Hanover	汉诺威
Düsseldorf	杜塞尔多夫
Mainz	美茵茨
Wiesbaden	威斯巴登
Saarbrücken	萨尔布吕肯
Mu-nì-het	慕尼黑
Erfurt	埃尔福特
Dresden	德累斯顿
Kaliningrad-chû	加里宁格勒州
Murmansk-chû	摩爾曼斯克州
Kak-than-sṳ̂-khiet	格但斯克
Fap-làn-khiet-fuk	美茵河畔法蘭克福
Fut-lò-tshṳ-ngá-fû	弗罗茨瓦夫
Làn	镧
Ki (鉕)	钷
Sân	钐
Â-chhè Thi̍t-phe̍t Hàng-chṳn-khî	亞齊特區
Nga̍t (釓)	钆
Thi̍t (鋱)	铽
Tit (鏑)	镝
Sṳn-kîn	聖經
Fó	钬
Ngí (鉺)	铒
Tiû	铥
Yi	镱
Liu	镥
Hò-nui-sṳ	河內市
Chṳ̂n Yâ-sû Kau-fi	真耶稣教会
Yîn-ngî	英语
Màn-kuk	曼谷
Kit-lùng-po	吉隆坡
Pâng-kâ Vú-lî-thung-sén	邦加-勿里洞省
Thòi-pet-sṳ	臺北市
Mî (鋂)	镅
Arkhangelsk-chû	阿尔汉格尔斯克州
Khiu̍k	锔
Thùng-hói-sṳ	同海市
Concepción	康塞普西翁 (智利)
Pet (鉳)	锫
Khà (鉲)	锎
Mìn-kú-lû-sén	明古魯省
Oi	锿
Fi	镄
Mùn	钔
Na	锘
Ontario-sén	安大略
Lò	鐒
Karelia Khiung-fò-koet	卡累利阿共和国
Końskowola	孔斯科沃拉
2002-ngièn	2002年
2008-ngièn	2008年
Charles de Gaulle	夏爾·戴高樂
Cham-pî-sén	占碑省
Komi Khiung-fò-koet	科米共和国
Nâm-póng-sén	楠榜省
Pet Sû-mùn-tap-lia̍p-sén	北苏门答腊省
Syktyvkar	瑟克特夫卡爾
Québec-sṳ	魁北克市
Nenets Chhṳ-chhṳ-khî	涅涅茨自治区
Liàu-nui-sén	廖內省
Leningrad-chû	列宁格勒州
Pskov-chû	普斯科夫州
Liàu-nui Khiùn-tó-sén	廖内群岛省
Nizhny Novgorod-chû	下诺夫哥罗德州
Nàm Sû-mùn-tap-lia̍p-sén	南苏门答腊省
Lò-mâ Ti-koet	羅馬帝國
Mì-ngiôn Kûng-sṳ̂	微软
Tver-chû	特维尔州
Khù-lû-fû	库鲁夫
Fa-ho̍k	化學
Smolensk-chû	斯摩棱斯克州
Yaroslavl-chû	雅羅斯拉夫爾州
Kostroma-chû	科斯特罗马州
Ivanovo-chû	伊万诺沃州
Arnold Schwarzenegger	阿诺·施瓦辛格
Chiuk-khiù	足球
Ryazan-chû	梁赞州
IPhone	IPhone
Sî Sû-mùn-tap-lia̍p-sén	西苏门答腊省
Tula-chû	图拉州
IPad	IPad
Mâ-tet-lî	马德里
Bryansk-chû	布良斯克州
Michael Jackson	迈克尔·杰克逊
Kaluga-chû	卡卢加州
Loire-Atlantique-sén	大西洋卢瓦尔省
Ain-sén	安省 (法國)
Allier-sén	阿列省
Khâm-phì-là	堪培拉
Sông Alpes-sén	上阿尔卑斯省
Oryol-chû	奥廖尔州
Sit-nì	悉尼
Alpes-de-Haute-Provence-sén	上普罗旺斯阿尔卑斯省
Liu̍k-set	綠色
Alpes-Maritimes-sén	滨海阿尔卑斯省
Hâ-tet-sùn-hò	哈德遜河
Me̍t-ngì-pún	墨尔本
Fùng-set	红色
Ardèche-sén	阿尔代什省
Jena	耶拿
Kursk-chû	库尔斯克州
Ariège-sén	阿列日省
Aude-sén	奥德省
Aveyron-sén	阿韦龙省
Sîn Nàm Vî-ngì-sṳ̂-chû	新南威爾士州
Bouches-du-Rhône-sén	罗讷河口省
Àu-thai-li-â Sú-tû Liâng-thi	澳大利亚首都领地
Cantal-sén	康塔爾省
Belgorod-chû	别尔哥罗德州
Côte-d'Or-sén	科多尔省
Côtes-d'Armor-sén	阿摩尔滨海省
Drôme-sén	德龙省
Finistère-sén	非尼斯泰尔省
Voronezh-chû	沃罗涅日州
Sû-mùn-tap-lia̍p	蘇門答臘
Lipetsk-chû	利佩茨克州
Van-tan-sén	万丹省
Chûng Cháu-ôa-sén	中爪哇省
Fùi-sên	彗星
Rostov-chû	罗斯托夫州
Tûng Cháu-ôa-sén	东爪哇省
Ngâ-kâ-tha̍t Sú-tû Thi̍t-khî	雅加达
Sî Cháu-ôa-sén	西爪哇省
Adygea Khiung-fò-koet	阿迪格共和国
Ngit-ngiâ Thi-fông Thi̍t-khî	日惹特区
Gera	格拉
Maykop	邁科普
Cháu-ôa-tó	爪哇岛
Kâ-lî-man-tân-chû	加里曼丹
Séu Sùn-thâ Khiùn-tó	小巽他群岛
Sû-lâ-vî-sî-tó	苏拉威西岛
Mô-lu̍k-kâ Khiùn-tó	摩鹿加群岛
Chûng Kâ-lî-man-tân-sén	中加里曼丹省
Tûng Kâ-lî-man-tân-sén	東加里曼丹省
Nàm Kâ-lî-man-tân-sén	南加里曼丹省
Kâ-li-sî-â	加利西亚 (西班牙)
Sî Kâ-lî-man-tân-sén	西加里曼丹省
Thai-ho̍k	大學
Pretoria	比勒陀利亞
Chok-khiù	乒乓球
Â-sṳ̂-thù-lî-â-sṳ̂	阿斯图里亚斯
Wikipedia:Sandbox	Wikipedia:沙盒
Astrakhan-chû	阿斯特拉罕州
Kham-thap-pu-lî-â	坎塔布里亚
Kalmykia Khiung-fò-koet	卡尔梅克共和国
Weimar	魏玛
Osasco	奥萨斯库
Â-là-kung	阿拉贡自治区
Kak-là-sṳ̂-kô	格拉斯哥
Thùng-hói Kî-chhòng	同海機場
Vú-lîn-ngièn Fûng-kín Miàng-sṳn-khî	武陵源
分類:Thòi-vân li̍t-sṳ́	Category:台灣歷史
Curitiba	庫里奇巴
Chloë Grace Moretz	科洛·莫瑞兹
Khûng-chṳ́	孔子
Corbin Bleu	柯賓·布魯
分類:Sṳ-ho̍k	Category:数学
分類:Ngìn-kûng ngî-ngièn	Category:人工語言
Pâ-lî-sén	巴厘岛
Mî-kîm	美元
Thi-chûng-hói	地中海
Hông-chû-sṳ	杭州市
Kî-tuk-kau	基督教
Tûng Nú-sâ Tên-kâ-là-sén	東努沙登加拉省
Sî Nú-sâ Tên-kâ-là-sén	西努沙登加拉省
Chûng Sû-lâ-vî-sî-sén	中苏拉威西省
Kô-lùn-tá-lo̍k-sén	哥伦打洛省
Pet Sû-lâ-vî-sî-sén	北苏拉威西省
Tûng-nàm Sû-lâ-vî-sî-sén	东南苏拉威西省
Nàm Sû-lâ-vî-sî-sén	南苏拉威西省
Sî Sû-lâ-vî-sî-sén	西苏拉威西省
Vò-é	稻
Mâ-lû-kú-sén	马鲁古省
Pet Mâ-lû-kú-sén	北马鲁古省
Pâ-pu-â-sén	巴布亚省
Sî Pâ-pu-â-sén	西巴布亞省
Dagestan Khiung-fò-koet	达吉斯坦共和国
Sú-tû	首都
Monzón	蒙宗
Phù-thò-ngà-ngî	葡萄牙語
Ngie̍t	月
Mustafa Kemal Atatürk	穆斯塔法·凯末尔·阿塔蒂尔克
Makhachkala	馬哈奇卡拉
Chechnya Khiung-fò-koet	车臣共和国
Grozny	格罗兹尼
Almazán	艾爾瑪善鎮
Vòng Hien-fàm	黄现璠
Ingushetia Khiung-fò-koet	印古什共和国
Magas	馬加斯
Pet Ossetia–Alania Khiung-fò-koet	北奥塞梯-阿兰共和国
Kabardino-Balkaria Khiung-fò-koet	卡巴爾達-巴爾卡爾共和國
Tson-sa̍k	钻石
Bill Gates	比尔·盖茨
Ngi̍t-ngî	日语
Pak-khô-chhiòn-sû	百科全书
頭頁	Wikipedia:首页
Karachay-Cherkessia Khiung-fò-koet	卡拉恰伊-切尔克斯共和国
Saratov	薩拉托夫
Saratov-chû	萨拉托夫州
Orenburg-chû	奧倫堡州
Mordovia Khiung-fò-koet	莫尔多瓦共和国
Saransk	萨兰斯克
Yâ-khiù	棒球
Làm-khiù	篮球
Kirov-chû	基洛夫州
Udmurtia Khiung-fò-koet	乌德穆尔特共和国
Sî-pak-li-â	西伯利亚
Mari El Khiung-fò-koet	马里埃尔共和国
Yoshkar-Ola	约什卡尔奥拉
Stellenbosch	斯泰倫博斯
Sverdlovsk-chû	斯維爾德洛夫斯克州
Cape Town	開普敦
Chuvash Khiung-fò-koet	楚瓦什共和国
Durban	德班
Cheboksary	切博克萨雷
Tat-tat-sṳ̂-thán Khiung-fò-koet	鞑靼斯坦共和国
Penza-chû	奔萨州
Là-fî-ngì	拉斐尔·圣齐奥
Pí-tet Lû-pún-sṳ̂	彼得·保羅·魯本斯
Ulyanovsk-chû	乌里扬诺夫斯克州
Gung-gung-hi-tsaa	公共汽車
Kâ-thai-lò-nì-â	加泰罗尼亚
Bashkortostan Khiung-fò-koet	巴什科尔托斯坦共和国
Chelyabinsk-chû	车里雅宾斯克州
Pâ-lùn-sî-â Chhṳ-chhṳ-khî	巴倫西亞自治區
Khà-sṳ̂-tì-li-â lâu Lòi-ngong	卡斯蒂利亚-莱昂
Kurgan-chû	库尔干州
Mô Chhe̍t-tûng	毛泽东
Tyumen-chû	秋明州
Omsk-chû	鄂木斯克州
Thai-mí-ngì-ngî	泰米尔语
Chet-ho̍k	哲学
分類:Candidates for speedy deletion	Category:快速删除候选
Altai Khiung-fò-koet	阿尔泰共和国
Kòng-khìm	钢琴
Gorno-Altaysk	戈爾諾-阿爾泰斯克
Kemerovo-chû	科麦罗沃州
Hebe Camargo	赫柏·卡马戈
Chṳ̂-pún chú-ngi	资本主义
Koet-kâ	国家
Mìn-chhu̍k	民族
Khanty-Mansi Chhṳ-chhṳ-khî	汉特-曼西自治区
Yamalo-Nenets Chhṳ-chhṳ-khî	亚马尔-涅涅茨自治区
Montpellier	蒙彼利埃
分類:Thiên-vùn-ho̍k	Category:天文学
Khakassia Khiung-fò-koet	哈卡斯共和国
Irkutsk-chû	伊尔库茨克州
Sakha Khiung-fò-koet	萨哈共和国
Khiet-lò-âi-sî-â-ngî	克罗地亚语
Hon-pó	漢堡 (食物)
Buryatia Khiung-fò-koet	布里亞特共和國
Vû-làn Vû-tet	烏蘭烏德
Amur-chû	阿穆尔州
Ngi-sṳ̍p Sṳ-ki	20世纪
Gotha	哥達
Dijon	第戎
Kâ-thai-lò-nì-â-ngî	加泰罗尼亚语
Nordhausen	北豪森
Kit-lò-na̍p-sén	赫罗纳
Eisenach	艾森纳赫
Se-pâu Sâng-vu̍t-ho̍k	细胞生物学
Sṳ-kie Ngiùn-hòng Si̍p-thòn	世界银行
A-la-pak Liên-mên	阿拉伯国家联盟
Mìn-tsú Tsú-ngi	民主
Chhîn-chhèu (秦朝)	秦朝
Pet Thai-sî-yòng Kûng-yok Chû-chṳt	北大西洋公约组织
Chhìn Sṳ Fòng	秦始皇
Hon-chhèu	汉朝
Hon Vú-ti Liù Chha̍t	汉武帝
Sâng-vu̍t	生物
Kiûn-chú-chṳ	君主制
Khiung-fò-koet	共和制
Yí-mô-khiù	羽毛球
Ngièn-chhèu	元朝
Nazi Tet-koet	納粹德國
Yù-thai-ngìn	犹太人
Chang Fò	鄭和
Chìn-chhèu	晋朝
Ngí	耳
Phi	鼻
Ngién	眼
Mûn-é	蚊
Mièn-yòng	綿羊
Lo̍k-thò	骆驼
Phú-nen thung-vu̍t	哺乳动物
Siong	象
Ngie-kûng	蚂蚁
Phûng-é	蜂族
Hò-làn-ngî	荷蘭語
Fà-thi̍t Thit-sṳ-nì Kûng-sṳ̂	华特迪士尼公司
Thot-yong Fu̍t-thông Fu̍t-son	脱氧核糖核酸
Khiô	茄
Siet	雪
Â-pâ	父親
Fûn	分 (时间单位)
Yù-thai Chhṳ-chhṳ-chû	犹太自治州
Ngò-lò-sṳ̂-ngî	俄语
Tûng-nàm-â Koet-kâ Lièn-mèn	东南亚国家联盟
Sakhalin-chû	萨哈林州
Mien-pâu	麵包
Sṳ-kie Mo-yi Chû-chṳt	世界贸易组织
漢語	汉语
Se-pâu	细胞
Hiet-yi̍t	血液
Hi	肺
Lò-mâ-nì-â-ngî	羅馬尼亞語
Pó-kâ-li-â-ngî	保加利亚语
Magadan-chû	马加丹州
Chhṳ-yèn Khô-ho̍k	自然科学
Het-chhe̍t Mìn	黑澤明
Franklin D. Roosevelt	富兰克林·德拉诺·罗斯福
Thi-khiù Khô-ho̍k	地球科学
Sa̍k-thèu	岩石
Yùn	云
Kí-hò-ho̍k	几何学
Tet-lu-kú-ngî	泰卢固语
Thai-hì-chhèn	大气层
Kak-lû-kit-â-ngî	格鲁吉亚语
Kîn-chi-ho̍k	经济学
Pîn-kóng	邦加檳港
漢字	汉字
Sî-lî-ngì Sṳ-mû	西里尔字母
Lâ-tên sṳ-mû	拉丁字母
Vùn-ho̍k	文學
分類:Fap-koet	Category:法国
分類:Yîm-ngo̍k	Category:音乐
分類:Vùn-ho̍k	Category:文学
Fù-lì	狐
La̍p-pá	小號
Â-li̍t-sân-thai sâm-sṳ	亚历山大大帝
Kiûn-sṳ-thán-tên Yit-sṳ	君士坦丁大帝
Set-lû-sṳ thai-ti	居鲁士二世
Vùn-mìn	文明
Kau-yuk	教育
Kâ-thìn	家庭
Nàm-ngìn	男性
Fûn-yîn	婚姻
Kiûn-sṳ	軍事
Kâ-pî	咖啡
Ngiù-nen	乳
Sûn Chûng-sân	孫中山
Â-yuk-vòng	阿育王
香港	香港
Thai-yîn Ti-koet	大英帝国
Sú-ngì	首爾
Kâm-nái-thit Koet-chi Kî-chhòng	約翰·甘迺迪國際機場
上海	上海市
Lùn-tûn Hî-sṳ̂-lu Kî-chhòng	倫敦希斯路機場
Lùn-tûn Kak-vet Kî-chhòng	格域機場
Set-vì-li-â	塞维利亚
Chhîn-chhèu	清朝
Â-ngì-pâ-nì-â-ngî	阿尔巴尼亚语
Pâ-sṳ̂-khiet-ngî	巴斯克語
Â-lâ-kung-ngî	阿拉贡语
Yîn-koet Hòng-khûng	英國航空
Â-mî-nì-â-ngî	亚美尼亚语
Vû-khiet-làn-ngî	乌克兰语
Pâ-lùn-sî-â	巴倫西亞
Shuì-tién-ngî	瑞典語
Tan-ma̍k-ngî	丹麦语
Nò-vî-ngî	挪威语
Kô-thi̍t-fu̍t-lòi-tet Vî-liâm Lòi-pu-nì-tsṳ	戈特弗里德·莱布尼茨
Tshia̍p-khiet-ngî	捷克语
Sṳ̂-lo̍k-phat-khiet-ngî	斯洛伐克语
Sṳ̂-lo̍k-vì-nì-â-ngî	斯洛文尼亚语
Hiûng-ngà-li-ngî	匈牙利语
Oi-sâ-nì-â-ngî	爱沙尼亚语
Là-thot-vì-â-ngî	拉脱维亚语
Li̍p-thâu-vón-ngî	立陶宛语
Pha̍k-ngò-lò-sṳ̂-ngî	白俄罗斯语
Kui-mí-thi̍t-lî Mùn-tet-lie̍t-fû	德米特里·伊万诺维奇·门捷列夫
Ngièn-chṳ́	原子
Lâ-set-fuk	欧内斯特·卢瑟福
Hî-lia̍p-ngî	希腊语
Oi-ngì-làn-ngî	愛爾蘭語
Pô-sṳ̂-ngî	波斯语
Chûng-kau	宗教
Chêu-sién-ngî	朝鮮語
Chhóng-sṳ-ki	創世記
Kóng-tûng-fa	广州话
Chhut-âi-khi̍p-ki	出埃及記
Ye̍t-nàm-ngî	越南语
Pó-lò	保罗 (使徒)
Kô-mièn-ngî	高棉语
Thai-ngî	泰语
Mâ-lòi-ngî	马来语
Yin-nì-ngî	印尼语
Mùng-kú-ngî	蒙古语
Hâ-sat-khiet-ngî	哈萨克语
Vû-tsṳ̂-phe̍t-khiet-ngî	乌孜别克语
Thú-khù-màn-ngî	土库曼语
Yù-thai-kau	犹太教
Hî-pak-lói-ngî	希伯来语
Â-set-pai-kiông-ngî	阿塞拜疆语
Mâ-khì-tun-ngî	马其顿语
Set-ngì-vì-â-ngî	塞尔维亚语
Set-ngì-vì-â Khiet-lò-thi-â-ngî	塞尔维亚-克罗地亚语
Pô-sṳ-nì-â-ngî	波斯尼亚语
Kâ-lî-sî-â-ngî	加利西亞語
Vî-ngì-sṳ̂-ngî	威尔士语
Sû-kak-làn Koi-ngì-ngî	苏格兰盖尔语
Siak-khiet-kau	锡克教
John Maynard Keynes	约翰·梅纳德·凯恩斯
Lufthansa Hòng-khûng	汉莎航空
Ló-chṳ́	老子
Kôn-chhóng	肝臟
Shìn	腎
Thu-é	兔
Sṳ̀n-kîn Ne-thúng	神经系统
Sîm-lî-ho̍k	心理学
Sṳt-kâ-mèu-nì	释迦牟尼
Mâ-tên Lu-tet	馬丁·路德
Yî-kâ	儒家
Thiên-chú-kau	天主教會
Tho-kau	道教
Chit-siói	脊髓
Sa̍t	舌
Yî-tshóng	胰脏
Hèu-thèu	喉頭
Fuk-khiet-làn khiùn-tó	福克兰群岛
Vàng-kak-mo̍k	橫膈膜
Lân-mî	阑尾
Elizabeth Ngi-sṳ	伊丽莎白二世
Thòng-chhèu	唐朝
John F. Kennedy	约翰·肯尼迪
Mìn-chhèu	明朝
Dwight D. Eisenhower	德怀特·艾森豪威尔
Ronald Reagan	罗纳德·里根
Sat-là-kô-sat	萨拉戈萨
Kîm Tsang-ngit	金正日
Ngièn-su Chû-khì-péu	元素周期表
Chû-su̍k	猪属
Mariano Rajoy	马里亚诺·拉霍伊
Se-khiûn	细菌
Phù-thò	葡萄
Phûng-thòng	蜂蜜
Thông	食糖
Vòng-theu	大豆
Kûng-chhàng-ho̍k	工程学
Vùn-fa	文化
Fan-vun	梵语
Sùn-fàn Hì-thúng	循环系统
Sôn	酸
Yî-ho̍k	医学
Néu-Yok Sṳ-kie Mo-yi Chûng-sîm	世界贸易中心
Hâ Màn-hâ-tun	曼哈顿下城
Yàm	食盐
分類:Pâ-sî	Category:巴西
Màn-hâ-tun	曼哈頓
Ngièn-su	化學元素
Kâ-suk-thu	加速度
Li̍t	力
Kú	鼓
Tsṳt-liông	质量
Thien-yáng	电影
Kîm-su̍k	金属
Nùng-ngia̍p	农业
Sâng-yîm	声音
Sṳ̀-kiên	时间
Mien-chit	面积
Kûng-kîn	千克
Kûng-tshak	米 (单位)
Miéu	秒
Pâu-siuk	玉米
Kûng-sṳ̂n	公升
Fà-ngì-kiê	华尔街
Tûng-nàm-â	东南亚
Tshùng-khin	重庆市
Thiên-tsîn	天津市
Vú-hon-sṳ	武汉市
Kú Hî-lia̍p	古希腊
Thomas Jefferson	托马斯·杰斐逊
Vùi-sṳ̂-khà	韦斯卡
Tychy	蒂黑
El Masnou	埃尔马斯诺
Pu-lie̍t-thap-nì-ngî	布列塔尼语
Brittany	布列塔尼
Lóng	聾
Chhi̍t-phiang	疾病
Khien-không	健康
Sok-lî-â	索里亚
Màn-tó-ngî	曼島語
Chhiâng-môi-su	青霉素
Nantes	南特
Pot-thâm-fó	結核
Mà-chiông	麻将
模板:Location map Taiwan	Template:Location map Taiwan
Detroit	底特律
Van-lî Tshòng-sàng	长城
Gard-sén	加尔省
Gers-sén	热尔省
Sông Garonne-sén	上加龙省
Sṳ̀n-sṳn Lò-mâ Ti-koet	神圣罗马帝国
Ille-et-Vilaine-sén	伊勒-维莱讷省
Isère-sén	伊泽尔省
Chûng-kau Kói-kiet	宗教改革
Sông Loire-sén	上盧瓦爾省
Lot-sén	洛特省
Lozère-sén	洛泽尔省
Maine-et-Loire-sén	曼恩-卢瓦尔省
Nì-pu-kap-nì-sat ngi-sṳ	尼布甲尼撒二世
Mayenne-sén	马耶讷省
Morbihan-sén	莫尔比昂省
Nièvre-sén	涅夫勒省
Nord-sén	诺尔省
Calais Hói-hia̍p-sén	加来海峡省
Puy-de-Dôme-sén	多姆山省
Sông Pyrénées-sén	上比利牛斯省
Pyrénées-Orientales-sén	东比利牛斯省
Hâ Rhin-sén	下莱茵省
Sông Rhin-sén	上莱茵省
Saône-et-Loire-sén	索恩-卢瓦尔省
Sarthe-sén	萨尔特省
Sông Savoie-sén	上萨瓦省
Tarn-sén	塔恩省
Tarn-et-Garonne-sén	塔恩-加龙省
Var-sén	瓦尔省
Vaucluse-sén	沃克吕兹省
Vendée-sén	旺代省
Yonne-sén	约讷省
Yî-pí-li-â Pan-tó	伊比利亚半岛
Lai-kî	荔枝
Yâ-è	椰
Sa̍k-liù	石榴
Chong-fa	壮语
Sông-sok-pu-ngî	上索布语
Na̍p-ngá-thi̍t-ngî	納瓦特爾語
Mí-nàm-kâ-pó-ngî	米南佳保語
Mirandés-ngî	米兰德斯语
Harvard Thai-ho̍k	哈佛大学
Néu-yok Chṳn-khèn Kâu-yi-só	纽约证券交易所
Lie̍t-yî-tha̍t-sén	列伊达省
Â-lâ-pak-ngî	阿拉伯语
Kiú-chiu	九州 (日本)
Si-koet	四國
O-khiet-ngî	奥克语
Nàm-fî Hò-làn-ngî	南非語
Lí Mìn-pok	李明博
Lû Vú-hién	盧武鉉
Kâ Mà-chiok	家麻雀
Kô-thiet	港鐵
澳門	澳門
Suhl	苏尔 (德国)
Mühlhausen	米尔豪森
Sâ-thièn-khî	沙田區
Fù Kím-Thàu	胡锦涛
Si̍p Khiûn-phìn	习近平
Chhòng-kiáng-lu̍k	长颈鹿
Phì-âi-mùng-thi̍t-ngî	皮埃蒙特語
Thap-là-kô-na̍p	塔拉戈纳
Provence-Alpes-Côte d'Azur	普罗旺斯-阿尔卑斯-蓝色海岸
Chûng-Wàn-Tshàm／Hiông-Kóng-Tshàm(MTR)	中環站
Chhṳ̂m-chun-sṳ	深圳市
Kóng-tûng	广东省
Kóng-sî Chong-chhu̍k Chhṳ-chhṳ-khî	广西壮族自治区
Mô-kài	魔戒
Borredà	博雷达
Castellar de n'Hug	努奇堡
Hiông-kóng Thai-ho̍k	香港大學
Badajoz	巴達霍斯
Lu̍k-yì-tó-yen	鹿儿岛县
Kiok	脚
Sit-thit	蜥蜴
Altenburg	阿尔滕堡
Kiên	肩
Midi-Pyrénées	南部-比利牛斯
模板:Link FA	Template:Link FA
Wikipedia:Chhâm-siòng	Wikipedia:互助客栈
Fu-mùng-thi̍t	佛蒙特州
Hiû-sṳ̂-tûn	休斯敦
Kóng-chiu-sṳ	广州市
Chiông Kie-sa̍k	蔣中正
Vûn Kâ-pó	温家宝
Nàm-kîn-sṳ	南京市
Phiang-yèn	醫院
Kông-sû	江苏省
Chet-kông-sén	浙江省
Thèn Séu-phìn	邓小平
Pet-phu Calais Hói-hia̍p	北部-加来海峡
Pays de la Loire	卢瓦尔河地区
Languedoc-Roussillon	朗格多克-鲁西永
Thiap-sat-lò-nì-kâ	塞萨洛尼基
西藏自治區	西藏自治区
Hàng-thung Thien-fa	移动电话
Thò-niâu	鸵鸟
Manchester	曼彻斯特
Pu-lû-khiet-lìm	布鲁克林区
Fòng-heu-khî	皇后區
Liùng-yìn-sṳ	龍仁市
Lòng	狼
Mâ-lòi Pan-tó	马来半岛
Sîn-yok Sṳn-kîn	新約聖經
Fan-lóng-thap-cham-sṳ	藩朗-塔占市
9	9
Zung-gok Thaai-liuk	中国大陆
Het-liùng-kông	黑龙江省
Mâ Yîn-kiú	馬英九
Piên-fò-sṳ	边和市
Hiông-kóng-tó	香港島
Ngà-tsông-sṳ	芽莊市
Podolsk	波多利斯克
Pô-tô Lì-kok Thu̍k-li̍p-tóng	波多黎各獨立黨
Lì-è	驴
Si-chhôn-sén	四川省
Khiu-yok Sṳn-kîn	旧约圣经
Sṳn-tan-chiet	圣诞节
Lò-màn Ngî-chhu̍k	罗曼语族
Sâm-kok-hìn	三角形
Steve Jobs	史蒂夫·乔布斯
Yin-Êu Ngî-ne	印欧语系
Breinigerberg	贝瑞宁格堡
Lo-fú	虎
Fù-ôn Khà-lo̍k-sṳ̂ Yit-sṳ	胡安·卡洛斯一世
Súi-ngièn-sṳ	水原市
Sâm-sên Si̍p-thòn	三星集团
Thai-thièn Kóng-vet-sṳ	大田广域市
Kîn-ki-tho	京畿道
Sṳ̂-khâm-tit-nâ-vì-â	斯堪的纳维亚
Fu̍k-fa̍t-chiet	復活節
Thien-nó Khô-ho̍k	计算机科学
Koet-chi Yîm-phiêu	國際音標
Hò-pet	河北省
Phú-lìm-sṳ̂-tun Thai-ho̍k	普林斯顿大学
Fôn-hìn-muk	鹳形目
Chhṳ̀n Súi-pién	陳水扁
台灣	臺灣
Chṳ-fi-hîn Sú-kî	智能手机
Sa̍k-yù	石油
Hài-è	鞋
Ngiùn-hòng	銀行
Ngièn-lun Chhṳ-yù	言論自由
Oi-ngì-làn	爱尔兰岛
Cheshire	柴郡
Cumbria	坎布里亞郡
Lancashire	兰开夏郡
Northumberland	諾森伯蘭郡
Tyne and Wear	泰恩-威爾郡
County Durham	達勒姆郡
Pet Yorkshire	北约克郡
Lincolnshire	林肯郡
Nottinghamshire	諾丁漢郡
Derbyshire	德比郡
Merseyside	默西賽德郡
Leicestershire	莱斯特郡
Rutland	拉特蘭
Lû-sùn	鲁迅
Northamptonshire	北安普敦郡
Devon	德文郡
Oxfordshire	牛津郡
Wiltshire	威爾特郡
Hampshire	漢普郡
Buckinghamshire	白金汉郡
Surrey	薩里郡
West Sussex	西薩塞克斯郡
East Sussex	東薩塞克斯郡
Kent	肯特郡
Thai Lùn-tûn	大倫敦
7	7
8	8
Lu̍k-é	鹿科
Pên	冰
Chú ke Khì-tó-vùn	主禱文
Ngìn-lui-ho̍k	人类学
Fùng-hói	红海
Oi-tên-páu	爱丁堡
Pha̍k-set	白色
Marseille	马赛
Thai-chhûng-thèu	洋蔥
6	6
Kôn-fông ngî-ngièn	官方语言
Kháu-kú-ho̍k	考古学
George H. W. Bush	乔治·赫伯特·沃克·布什
Pâ-ngì-kòn pan-tó	巴尔干半岛
Dmitry Medvedev	德米特里·阿纳托利耶维奇·梅德韦杰夫
Entrena	恩特雷纳
Sîn-kau	新教
Selena	莎麗娜
Mî-koet Thai-khûng Chúng-shu	美国国家航空航天局
Thai Put-lie̍t-tiên-tó	大不列顛島
Pâ-le̍t-sṳ̂-thán	巴勒斯坦
10	10
Lila Downs	利拉·唐斯
Lia̍p-pau	猎豹
Cleveland (Yîn-koet)	克利夫蘭 (英國)
Liverpool	利物浦
Bremen	不来梅
Sîn Nò-vî-ngî	新挪威語
Meu-thèu-tiâu	貓頭鷹
Sṳ̀	小时
Fap-lò-ngî	法罗语
Kîm-eu-sṳ	金瓯市
Meu-khô	猫科
Koet-chi Thai-khûng Chhàm	国际空间站
Tà-la-sṳ	大叻市
Tat-tat-ngî	鞑靼语
Tshûng-liông	重量
Tsûng-su	海枣
Fan-tshiet-sṳ	藩切市
Sî Fut-lî-sî-ngî	弗里西语
Séu Vòng-chṳ́	小王子 (小说)
Phiàng-fông kûng-tshak	平方米
Fó-yam-chhùng	萤科
Li̍p-fông kûng-tshak	立方米
Fàn-chiet-thûng-vu̍t-mùn	环节动物门
Chhú-khô	鼠科
Ede (Hò-làn)	埃德
Sông-ngia̍p	商业
Fú-kîn	虎鯨
Sâ-thi̍t-fut-lî-sî-ngî	沙特弗里西語
Liû-khiù-koet	琉球国
Pet-fut-lî-sî-â-ngî	北弗里西亚语
Â-mê-ha̍p-lâ-ngî	阿姆哈拉语
蝠婆	蝙蝠
Tarnobrzeg	塔尔诺布热格
Vòng Ti	黄帝
Tiau-ǹg-thòi Lie̍t-yí	釣魚臺列嶼
Khiung-fò-tóng (Mî-koet)	共和黨 (美國)
Â-sṳ̂-thù-lî-â-sṳ̂-ngî	阿斯图里亚斯语
中國	中國
O-thi-li Pâ-vî-li-â-ngî	奥地利-巴伐利亚语
Mìn-chú-tóng (Mî-koet)	民主党 (美国)
Tsuk-pet-sṳ	竹北市
Sàng-tû-sṳ	成都市
Âi-sṳ̂-thi̍t-lùi-mâ-thu-lâ-ngî	埃斯特雷馬杜拉語
Sàng-fà-khî	成华区
Séu-su mìn-chhu̍k	少数群体
Pô-lòi-kú	波來古市
Â-ha̍p-sṳ̂-vòng	亞哈斯
Chûng-chû-sṳ	忠州市
Yî-liàu Ví-sâng	医疗卫生
Yòng-suk-yen	阳朔县
Khiet-là-khô-fû	克拉科夫
臺灣省	臺灣省
Pet-kîn Sú-tû Koet-chi Kî-chhòng	北京首都国际机场
Sîn-kâ-po Hòng-khûng Kûng-sṳ̂	新加坡航空
Thien-nó Thôn-chhèn Só-mèu	X射线计算机断层成像
Vî-nî-sṳ̂-ngî	威尼斯語
Vû-lòi-khî	烏來區
Koet-li̍p Thòi-vân Thai-ho̍k	國立臺灣大學
Vì-phú-sêm-ngî	维普森语
Fu̍t-lò-ngî	佛罗语
Pân-mâ	斑馬
Valery Leontiev	瓦列里里昂惕夫
Khô-sî-kâ-ngî	科西嘉语
Buryat-ngî	布里亞特語
Sùn-tho-chûng	循道宗
Mông-kiê-sṳ	芒街市
Suk-vú-ngî	宿霧語
Chavacano-ngî	查瓦卡諾語
Chûng-pí-khô-ngì-ngî	中比科爾語
Tha̍t-lò-phî-thû Ngî-hì	达罗毗荼语系
Ló-kiê-sṳ	老街市
客家語	客家语
Pet-nèn-sṳ	北寧市 (越南)
Liòng-sân-sṳ	谅山市
Hiuk-tsin-sṳ	朔庄市
Liùng-chhôn-sṳ	龍川市
Mî-tshiu-sṳ	美萩市
Fut-liù-li-ngî	弗留利语
Pâng-mî-tsuk	邦美蜀市
Kàm-ngî	贛語
Pok-vu̍t-kón	博物馆
Yin-thu Yî-lóng Ngî-chhu̍k	印度-伊朗语族
Thai-yùng-meu	大熊猫
Kalmyk-ngî	卡爾梅克衛拉特語
Mân-ngî	满语
Kû-li̍p ngî-ngièn	孤立语言
Khà-sû-pí-ngî	卡舒比语
Karachay-Balkar-ngî	卡拉恰伊－巴尔卡尔语
Lùn-pâ-tí-ngî	倫巴底語
Sú	手
Thu fú	杜甫
O-lî-â-ngî	奥里亚语
Ngìn-khiéu	人口
Nò-man-thi-ngî	諾曼語
Nèn-phìn-sṳ	寧平市
Pet-sat-mí-ngî	北方萨米语
O-set-thôi-ngî	奧塞梯語
Sî-sî-lî-ngî	西西里语
Sat-tên-nî-â-ngî	薩丁尼亞語
Nì-ngá-ngì-ngî	尼瓦尔语
Valparaíso	瓦尔帕莱索
Kóng-ngi-sṳ	廣義市
Hò-tshin-sṳ	河靜市
Yên-yèn	演員
Thap-kâ-lo̍k-ngî	他加祿語
Thùng	青铜
Vlaams-ngî	弗拉芒语
Fà-liùng-ngî	瓦隆语
Sú-ngî	手語
Yî-ngî	彝语北部方言
Międzyrzec Podlaski	缅济热茨
Phiêu-chún Chhông-ngî	標準藏語
Ngá-shuì-ngá-shuì-ngî	瓦瑞瓦瑞語
Yì-ku-tshu̍k	裕固族
N̂g-ngî	吴语
Woodrow Wilson	伍德罗·威尔逊
Fu̍t-sân-sṳ	佛山市
Ngiù-chîn Thai-ho̍k	牛津大学
Sṳ̍p-thiàu Kie-min	十誡
Yok-hon-nì-sṳ̂-páu	约翰内斯堡
Kî-tuk Kau-fi	教会
Pau-é	豹
Sîn-kiông	新疆维吾尔自治区
Muk-kôa	番木瓜
Pu-lî-sṳ̂-pân	布里斯班
Â-mî-ngî	阿美語
Vî-liâm Lùn-khìm	威廉·伦琴
Chû-chhèu	周朝
Ido-ngî	伊多語
Brad Pitt	畢·彼特
Pa̍k-kiûng	白宮
Tha̍t-mâ-thai-ngî	达尔马提亚语
Tat-tat-chhu̍k	鞑靼人
Kô-liáng-sṳ	高領市
Thai-fán-sṳ	大阪市
Kiam-khiâu Thai-ho̍k	剑桥大学
Kûng-khín	公顷
Sé-lî	洗禮
Pông-hâ	哮喘
Chuk	竹
Fù Tsṳ-mìn	胡志明
Thièn-piên-fú	奠邊府
Khûn-sṳ-làn-chû	昆士蘭州
Ha-liùng-sṳ	下龍市
Kûi-yìn-sṳ	歸仁市
Mìn-nì-â-pô-li-sṳ̂	明尼阿波利斯
Li̍t-ka-sṳ	迪石市
Li-kú-lî-â-ngî	利古里亚语
Phô-lò-chû	婆罗洲
Khà-phién-phién-kâm-ngî	邦板牙語
Vù-fâ-kó	無花果
Sun-fa-sṳ	順化市
Tshòng-thu	长度
Sṳ̂-chhù-chṳ̂-lu	丝绸之路
Hói-yòng-sṳ	海陽市 (越南)
Mô-li-ngî	毛利语
Mên-tûng-ngî	閩東語
Mên-pet-ngî	闽北语
Tô-se-pâu sâng-vu̍t	多細胞生物
Hîn-ôn-sṳ	興安市
Mên-nàm-ngî	闽南语
Tshiên-ngièn	千纪
Ho̍k-miàng	二名法
Vì-tô-li-â-chû	維多利亞州
Chong-chhu̍k	壮族
Sông-hói-fa	上海话
Pet-kông	北江市
Aung San Suu Kyi翁山蘇姬	翁山蘇姬
Tshèu-chû-fa	潮州话
Yok-hon-fuk-yîm	約翰福音
William Vòng-chṳ́	劍橋公爵威廉王子
Kâm-tsà	甘蔗
Chhṳ̀n Kóng-sâng	成龍
12	12
Vok-là-phú-khiet-ngî	沃拉普克语
Toshiro Mifune	三船敏郎
Kám-lám-su	橄欖 (木樨科)
Só-lò-mùn-vòng	所羅門
O-khiet-làn	奧克蘭都會區
Chhṳ̍t-sien	直线
11	11
13	13
Sûn-chṳ́	孙武
Sṳn-lìn	聖靈
Lû-pu-lìm	卢布林
Thì-thèu	花生
100	100
Tshit-thèu	膝
Tô-piên-hìn	多边形
Nàm Chûng-koet Hói	南海
Campora San Giovanni	肯波拉圣吉奥瓦尼
Pien-set-liùng	變色龍
Bloemfontein	布隆方丹
Ngiam-set-thí	染色体
O-khiet-làn Vùn-fap Ho̍k-káu	奧克蘭文法學校
Ngióng-kông	仰光
Ma̍k-tông-lò Kûng-sṳ̂	麦当劳
1000000	1000000
Meu-miàng-sṳ	茂名市
Liú-chiu-sṳ	柳州市
Pet-pan-khiù	北半球
Ló-chhú	小鼠属
Thí-tsit	体积
Het-tsṳ̂	赫兹
Pak-pân-khiet	伯班克 (加利福尼亚州)
Sien-lia̍p-thí	線粒體
Yî-sên	医生
Ki-sa̍k-chhṳn	巨石阵
Chúng-thí Kîn-chi-ho̍k	宏观经济学
Ágreda	阿格雷达
Lu-kâ-fuk-yîm	路加福音
Sîn Kí-nui-â	新幾內亞
Sṳ́-thù-hàng-chhon	使徒行传
Mô-hái	螃蟹
PH	PH值
Khì-tó	祷告
Ôn-fui-sén	安徽省
Chûng-chhîn Pet-tho	忠清北道
Chûng-chhîn Nàm-tho	忠清南道
Kông-ngièn-tho (Hôn-koet)	江原道 (韓國)
Nui Mùng-kú	内蒙古自治区
Kîm Ngit-sṳ̀n	金日成
Pí-tet-kô-sṳ̍p	比得哥什
Nottingham	诺丁汉
Thai-ví-vòng	大衛
Li-vi-ki	利未記
Sṳ̂-thán-fuk Thai-ho̍k	史丹佛大學
Fuk-kian	福建省
Kûng-khiet	克
Mùng-kú-tshu̍k	蒙古族
Khí-sṳ-liu̍k	启示录
Kong-lîn-sṳ	江陵市
Kiê-liùng-sṳ	雞龍市
Kô-yòng-sṳ	高陽市
Kûng-chû-sṳ	公州市
Kó-chhôn-sṳ	果川市
Kông-mìn-sṳ	光明市
Kóng-chû-sṳ (Hôn-koet)	廣州市 (京畿道)
Kiú-lî-sṳ	九里市
Kiûn-phú-sṳ	軍浦市
Kîm-phú-sṳ	金浦市
Nàm-yòng-chû-sṳ	南楊州市
Lun-sân-sṳ	論山市
Thông-chîn-sṳ (Hôn-koet)	唐津市 (韓國)
Tûng-theu-chhôn-sṳ	東豆川市
Tûng-hói-sṳ (Hôn-koet)	東海市 (韓國)
Pó-nèn-sṳ	保寧市
Fu-chhôn-sṳ	富川市
Sâm-chit-sṳ	三陟市
Shuì-sân-sṳ	瑞山市
Sàng-nàm-sṳ	城南市
Suk-chhó-sṳ	束草市
Sṳ́-hîn-sṳ	始興市
Ngà-sân-sṳ	牙山市
Ôn-sân-sṳ	安山市
Ôn-sàng-sṳ (Hôn-koet)	安城市 (韓國)
Ôn-yông-sṳ	安養市
Yòng-chû-sṳ	楊州市
Vû-sân-sṳ	烏山市
Ngièn-chû-sṳ	原州市
Ngi-vòng-sṳ	義王市
Ngi-chṳn-fú-sṳ	議政府市
Li-chhôn-sṳ (Hôn-koet)	利川市 (京畿道)
Thî-chhôn-sṳ	堤川市
Thiên-ôn-sṳ	天安市
Chhîn-chû-sṳ	清州市
Chhûn-chhôn-sṳ	春川市
Thai-pha̍k-sṳ	太白市
Po-chû-sṳ	坡州市
Phìn-tshe̍t-sṳ	平澤市
Phàu-chhôn-sṳ	抱川市
Hò-nàm-sṳ	河南市
Fà-sàng-sṳ	華城市
Buckingham Kiûng	白金汉宫
Hói-nàm	海南省
Yén-tûng	遠東
Ngiên-kiu	研究
Kâm-suk	甘肃省
Pha̍k Se-pâu	白血球
York	約克
Tsiú	肘
Sṳ̂n-min-ki	申命記
Sû-chû-sṳ	苏州市
Vûn-chû-sṳ	温州市
Windsor Sàng-páu	溫莎城堡
Hòn-chhu̍k	汉族
Nèn-pô-sṳ	宁波市
Tet-koet-ngìn	德意志人
Ko-men	过敏
Fù-khì	蚂蟥
Kîm-yùng	金融
1000	1000
Mìn-su-ki	民數記
Liu̍k Khiet-vùn	陆克文
Ngo̍k-ǹg	鱷科
Yùn-nàm	云南省
Vû-â	乌鸦
Plymouth	普利茅斯
Sân-tûng	山东省
Pí	臂
Derby-sṳ	德比 (英格蘭)
Thàn-khîn Fa-ha̍p-vu̍t	烃
Hò-nàm	河南省
Montehermoso	蒙特埃尔莫索
Liâu-nèn	辽宁省
El Cid	熙德
Jim Morrison	吉姆·莫里森
Sin-ngi-hiông	信義鄉 (臺灣)
Kóng-khiéu	港口
Thòi-vân Thò-yèn Koet-chi Kî-chhòng	臺灣桃園國際機場
Kit-lìm	吉林省
Fù-nàm	湖南省
Chhiâng-hói	青海省
Vì-ngâ-ngì-tshu̍k	维吾尔族
Rhône-sén	羅納省
Koet-kâ Kûng-yèn	國家公園
Pâ-lì Charles-de-Gaulle Koet-chi Kî-chhòng	巴黎夏尔·戴高乐机场
Chṳ̂-sán	資產
O-le̍t-liòng	奥勒良
Fù-pet	湖北省
Sân-sî	山西省
Hòng-khûng Kûng-sṳ̂	航空公司
Hò-khiéu-vân	河口
Chûng-set	褐色
Kui-chû	贵州省
Chûng-khi Sṳ̀n-kîn Ne-thúng	中樞神經系統
Yî-fut-só	以弗所
Ôn-tha̍t-màn Hói	安达曼海
Yok-sû-â-ki	約書亞記
Sî-pet Yîn-kak-làn	西北英格蘭
Shám-sî-sén	陕西省
Tûng-pet Yîn-kak-làn	东北英格兰
Tûng Midlands	東密德蘭
Tûng Yîn-kak-làn	東英格蘭
Tûng-nàm Yîn-kak-làn	東南英格蘭
Sî-nàm Yîn-kak-làn	西南英格蘭
模板:Commonscat	Template:Commons category
Sî Midlands	西密德兰
Yorkshire lâu Humber	约克郡-亨伯
Kòn Se-pâu	幹細胞
Lò-mâ-sû	羅馬書
Mâ-liuk-kap Hói-hia̍p	马六甲海峡
Yù-thai Vòng-koet	猶大王國
Mî-koet Pha̍k-ngìn	美國白人
Fî-yí Mî-koet Het-ngìn	非裔美国人
Mà-sat-chû-set Lî-kûng Ho̍k-yen	麻省理工学院
Pô-sṳ-tun Thai-ho̍k	波士頓大學
Yâ-lû Thai-ho̍k	耶鲁大学
Lû-khái-ngî	魯凱語
Nàm-pet-chêu	南北朝
Liû-Sùng	刘宋
Fûn-lî	婚礼
Pan Chúng-thúng-chṳ	半总统制
Kâ-phìn-khiùn	加平郡
Kô-sàng-khiùn (Hôn-koet)	高城郡 (韓國)
Fâi-sân-khiùn	槐山郡
Kím-sân-khiùn	錦山郡
Tan-yòng-khiùn (Hôn-koet)	丹阳郡 (韩国)
Po-ên-khiùn	報恩郡
Fù-yì-khiùn	扶餘郡
Sû-chhôn-khiùn	舒川郡
Yòng-khiéu-khiùn	楊口郡
Siong-yòng-khiùn	襄陽郡 (韓國)
Yòng-phìn-khiùn	楊平郡
Lî-chû-sṳ	驪州市
Liên-chhôn-khiùn	漣川郡
Yún-thùng-khiùn	永同郡
Nèn-ye̍t-khiùn	寧越郡 (韓國)
Lî-sân-khiùn	禮山郡
Vok-chhôn-khiùn	沃川郡
Yîm-sàng-khiùn	陰城郡
Lîn-thài-khiùn	麟蹄郡
Tsin-san-khiùn	旌善郡
Chên-phiàng-khiùn	曾坪郡
Chṳ́n-chhôn-khiùn	镇川郡
Thiet-ngièn-khiùn	鐵原郡 (南)
Chhiâng-yòng-khiùn	青陽郡
Thai-ôn-khiùn	泰安郡
Fùng-sàng-khiùn	洪城郡
Fùng-chhôn-khiùn	洪川郡
Fà-chhôn-khiùn	華川郡
Vàng-sàng-khiùn	橫城郡
Ên-phìn-sṳ	恩平區
Fî-li̍p-pí-sû	腓立比書
Thiên-koet Pat-fuk	天國八福
Mî-koet Lièn-pâng Chún-phi Ne-thúng	联邦储备系统
Kúai-é	无尾目
Hâ Sî-lî-sî-â-sén	下西里西亚省
Khù-â-vì - Pô-mî-là-nì-â-sén	庫亞維-波美拉尼亞省
Lû-pu-lìm-sén	卢布林省
Lû-pu-sṳ̂-khà-sén	盧布斯卡省
Lò-tsṳ-sén	罗兹省
Séu Pô-làn-sén	小波兰省
Mâ-tsó-fû-sá-sén	馬佐夫舍省
O-pô-lòi-sén	奧波萊省
Khak-ngì-pâ-yèn-sân-sén	喀尔巴阡山省
Pô-tet-là-chhia-sén	波德拉謝省
Pô-mî-là-nì-â-sén	濱海省 (波蘭)
Sî-lî-sî-â-sén	西里西亚省
Sṳn-sṳ̍p-sṳ-sén	聖十字省
Sî Pô-mî-là-nì-â-sén	西波美拉尼亚省
Pâ-lùn-sî-â-sén	巴倫西亞省
Sat-là-kô-sat-sén	薩拉戈薩省
Vùi-sṳ̂-khà-sén	韋斯卡省
Baak-gaa-seng	百家姓
Sok-lî-â-sén	索里亚省
Hien-thoi Khì-chhâ	現代汽車
Sûng-hâi-khî	雙溪區
Kîm Tsang-ên	金正恩
Pu-nùng-ngî	布農語
Phû-sien-ngî	莆仙語
Kông-sî	江西省
Wernher von Braun	沃纳·冯·布劳恩
Nèn-ha	宁夏回族自治区
Lí Hién-liùng	李显龙
Kîm-fà-sṳ	金华市
Thòi-chû-sṳ	台州市
Phòng-châ-phú-ngî	旁遮普語
Phú-sṳ̍p-thok-ngî	普什图语
Yâ-chû	野豬
Chû-hói-sṳ	珠海市
Sân-thèu-sṳ	汕头市
Shâu-kûan-sṳ	韶关市
Kông-mùn-sṳ	江门市
Chhám-kông-sṳ	湛江市
Shàu-khin-sṳ	肇庆市
Fi-chiu-sṳ	惠州市
Mòi-chiu-sṳ	梅州市
San-mî-sṳ	汕尾市
Hò-ngièn-sṳ	河源市
Yòng-kông-sṳ	阳江市
Chhîn-yén-sṳ	清远市
Tûng-kôn-sṳ	东莞市
Chûng-sân-sṳ	中山市
Chhèu-chiu-sṳ	潮州市
Thiên-tén-yen	天等县
Liùng-chiu-yen	龙州县
Nèn-mìn-yen	宁明县
Thai-sîn-yen	大新县
Sâ-chhà-chiòng	沙茶酱
Thòi-vân sén-tho	臺灣省道
Mâ-liuk-kap-sṳ	马六甲市
Khiâu-chhṳ-sṳ	乔治市
IPhone 5	IPhone 5
Nàm-Chhî	南齐
Mèu-li̍t-yen	苗栗縣
Sṳn-chhôn-lî	聖餐禮
Fuk-chiu-sṳ	福州市
Nàm-phìn-sṳ	南平市
Phû-thièn-sṳ	莆田市
Sâm-mìn-sṳ	三明市
Tshièn-chiu-sṳ	泉州市
Hà-mûn-sṳ	厦门市
Chông-chiu-sṳ	漳州市
Liùng-ngâm-sṳ	龙岩市
Nèn-tet-sṳ	宁德市
Sî-pak-li-â Fú	东北虎
Thiên-ngô-yen	天峨县
Nàm-tan-yen	南丹县
Fung-sân-yen	凤山县
Tûng-làn-yen	东兰县
Buren	比倫 (荷蘭)
Pat-tet-sṳ	八德區
Sîn-chuk-yen	新竹縣
Thông Ngiâ-mong	汤若望
Yáng-chhiong Chín-thôn-ho̍k	影像诊断学
Rumia	魯米亞
Kluczbork	克盧奇堡
La̍p-tsuk	蜡烛
Hiet-chiong	血浆
Southampton	南安普敦
Lu-tet-ki	路得記
Hâ-sat-khiet-chhu̍k	哈薩克族
Yòng-mî	蜻蜓
Chit-fûn-ho̍k	积分
Kô-lìm-tô-chhièn-sû	哥林多前書
Sî-pân-ngà Ti-koet	西班牙帝國
Pha̍k-yùn-khî (Kóng-chiu-sṳ)	白云区 (广州市)
Sṳ-sṳ̂-ki	士師記
Po-lîn-chhòi	菠菜
Pâ-set-lò-nâ-sén	巴塞罗那省
Nàm-thèu-yen	南投縣
Liuk-piên-hìn	六边形
Thòi-pet 101	台北101
Lùn-tûn Thap-khiâu	倫敦塔橋
Luì-kûng	雷
Siù-li Yún-kòn-sien-chhùng	秀麗隱桿線蟲
O-pô-lòi	奥波莱
Sopot	索波特
Kám-lám-yù	橄欖油
Chim-sin-fi	浸信会
Vú-yî-sân-sṳ	武夷山市
Set-vì-li-â-sén	塞維利亞省
Thap-là-kô-na̍p-sén	塔拉戈纳省
Provence-sén	普罗旺斯
Kî-hài Kûng-chhàng	机械工程
Apeldoorn	阿珀尔多伦
Lìm-pó-ngî	林堡语
Khái-ngì-chhái	凯尔采
Bytom	比托姆
Ôn-sit-ngit	安息日
Khìm-sṳ̂-thok-khok-ngá	琴斯托霍瓦
Zabrze	扎布热
Ôn-sit-ngit-fi	基督復臨安息日會
Jean Michel Jarre	让-米歇尔·雅尔
Thai Pô-làn Thi-khî Kô-yî-fû	大波蘭地區戈茹夫
Là-tô-mê	拉多姆
Lo̍k-chham-ki-yen	洛杉矶县
Słupsk	斯武普斯克
Sosnowiec	索斯诺维茨
Gliwice	格利维采
Yo̍k-sṳ̂	藥劑師
Hi-kôn Yì-chhṳ̍t	器官移植
Bielsko-Biała	别尔斯科-比亚瓦
Rybnik	雷布尼克
Tân-fu̍t Se-pâu	单核细胞
Mâ-khó-fuk-yîm	馬可福音
Ruda Śląska	鲁达希隆斯卡
Yok-thán-vòng	約坦
Thò-yèn-yen	桃園市
Nò-mí	糯稻
Kîn-tû-fú	京都府
Kau-su	教授
Thai-fán-fú	大阪府
Fuk-kông-yen	福冈县
Oi-yèn-yen	爱媛县
Kô-lìm-tô-heu-sû	哥林多後書
Khien-mî	健美
Chhùng-hièn	蚯蚓
Port Elizabeth	伊莉莎白港
Kimberley (Nàm-fî)	金伯利 (北开普省)
Yok-sâ-fap-vòng	約沙法
Thòi-vân Hói-hia̍p	台灣海峽
Sî Khôi-phú-sén	西開普省
Yamaguchi-yen	山口县
Khiâu-chhṳ Sâm-sṳ	喬治三世
Chûng-koet Thi-fông	中国地方
Mî-koet Thu̍k-li̍p Siên-ngièn	美國獨立宣言
Sâm-tshûng-yen	三重县
Yù-mu̍k mìn-chhu̍k	遊牧民族
Hiông-pak-su	雪松
Hî-pak-lòi-sû	希伯來書
Kâ-lâ-thai-sû	加拉太書
Màn-é	鰻
Sông-chhèu	商朝
Thai-thúi	大腿
Pîn-khù-yen	兵库县
Kiûng-khì-yen	宮崎縣
Yùng-pún-yen	熊本縣
Fò-phìn-sṳ	和平市
Stamford Raffles	斯坦福·莱佛士
Sha̍m-é	蝉
Tûng Khôi-phú-sén	東開普省
Fap-koet Hòng-khûng	法國航空
Lie̍t-vòng-ki-song	列王紀上
Kô-lò-sî-sû	歌羅西書
Ngâ-kok-sû	雅各書
Yok-hon-yit-sû	約翰一書
Fî-li-mùn-sû	腓利門書
Thiap-sat-lò-nì-kâ-heu-sû	帖撒羅尼迦後書
Thiap-sat-lò-nì-kâ-chhièn-sû	帖撒罗尼迦前书
Pí-tet-chhièn-sû	彼得前書
Thì-mô-thai-chhièn-sû	提摩太前書
Lí Kông-yeu	李光耀
Chṳ̂-kâ-kô Thai-ho̍k	芝加哥大学
Tsṳ̂-fo-yen	滋贺县
Mu-nì-het Kî-chhòng	慕尼黑机场
Yok-hon-ngi-sû	約翰二書
Thì-mô-thai-heu-sû	提摩太後書
Thì-tô-sû	提多書
Yî-sṳ̂-lâ-ki	以斯拉記
Nì-hî-mí-ki	尼希米記
Pietersburg	波羅克瓦尼
Séu Pha̍k-Lù	白鹭
Chhòn-ngiam-phiang	傳染病
Kôn-yàm	肝炎
Chhûn-chiet	春節
Shinzō Abe	安倍晋三
Mpumalanga-sén	普馬蘭加省
Pet Khôi-phú-sén	北開普省
Tó-kîn-yen	岛根县
Kông-sân-yen	岡山縣
Gauteng-sén	豪登省
Thung-fûng	痛风
Chông-fa-yen	彰化縣
Thai-fûn-yen	大分县
Tiâu-tshí-yen	鳥取縣
Nùng-la̍k	農曆
Kô-tî-yen	高知县
Pha̍k-hèu	白喉
Exeter	埃克塞特
Saint Lawrence-hò	圣劳伦斯河
Limpopo-sén	林波波省
Kô-tén Kau-yuk	高等教育
Sân-tá-kîn	山打根
Â-pí	亞庇
Hak-kâ-tóng	客家黨
Ngi̍t-pún thúng-tshṳ sṳ̀-thoi (Thòi-vân)	台灣日治時期
Phok Kiún-fi	朴槿惠
Tûng-sṳ-khî	東勢區
Lévis	利维 (魁北克)
Thòi-fûng	颱風
Thòi-nàm-sṳ	臺南市
Laval (Québec)	拉瓦勒 (魁北克)
Mâ-lòi Pô-lî-nì-sî-â Ngî-chhu̍k	马来－波利尼西亚语族
Fên-yòng-sṳ	衡阳市
Pet-lûn-khî	北仑区
Mân-chiu-tshu̍k	满族
Zambrów	贊布魯夫
Doetinchem	杜廷赫姆
Zamość	扎莫希奇
Malbork	马尔堡 (波兰)
Mì-chit-fûn-ho̍k	微积分学
Mì-fûn	微分
Ngo̍k-yòng-sṳ	岳阳市
BP	BP
Sú-thiàu	馬鈴薯條
Yùn-lìm-yen	雲林縣
Fù-khiéu-hiông	湖口鄉
Kiok-tsṳ́	腳趾
Vî-liâm Â-li̍t-sân-thai (Hò-làn)	威廉-亞歷山大 (荷蘭)
Krasnystaw	克拉斯內斯塔夫
Sî-fù-khî (Hông-chû-sṳ)	西湖区 (杭州市)
Vì-tô-li-â Kóng	維多利亞港
Sî-kung-khî	西貢區
Mâ-nâ-sî-vòng	瑪拿西 (猶大)
Kî-kîm-fi	基金会
A-hîn Kôn-yàm	甲型肝炎
Yù-tsiâm-vong-khî	油尖旺區
Tshṳ̍t-tshòng	直肠
Chhṳ-yù Pâng-sén	自由邦省
Tsó-fo-yen	佐贺县
Tet-tó-yen	德岛县
Sî-pân-ngà-ngìn	西班牙人
Fu̍t-chhṳ̂ Khiung-chṳn Sṳ̀n-siong	核磁共振成像
Hiông-tshon-yen	香川县
Reading, Berkshire	雷丁
Kâ-chû Lî-kûng Ho̍k-yen	加州理工學院
Vì-ngì-tshṳ-páu Thai-ho̍k	维尔茨堡大学
Fên-yòng-yen	衡阳县
Êu-kí-lî-tet Kí-hò	欧几里得几何
Si̍t-kuk	硅谷
Barneveld	巴讷费尔德
Khiu Tha̍t-sîn	達新·欽那瓦
Thòi-sân-sṳ	台山市
Lièn-phìn-yen	连平县
Kîm-kôa	南瓜
Thai Sùn-thâ Khiùn-tó	大巽他群岛
Elburg	埃尔堡
Sî-pet-sén	西北省 (南非)
Sien-thon	线段
Kâ-ngi-yen	嘉義縣
Vûn-tai	温带
Â-kûng	祖父母
Thai-khi̍t-khièn	太极拳
Kiok-khwá	腳踝
Hò-làn Tâi-thi Sat-khiet-sùn-ngî	西低地德语
Pân-kiêu-é	欧斑鸠
Tshòng-khì-yen	长崎县
Hà-chhèu	夏朝
Chû-vì Sṳ̀n-kîn Ne-thúng	周围神经系统
Lùn-tûn Thai-ho̍k	倫敦大學
Kip-sú	级数
Nelspruit	内尔斯普雷特
Sâ-là-ye̍t-chû	砂拉越
Â-chû Thai-phìn-yòng Kîn-tsi Ha̍p-tsok Fi-ngi	亚洲太平洋经济合作组织
Kôan-chiet-yàm	关节炎
Ngò-piên Yì-chhu̍k Chhṳ-chhṳ-yen	峨边彝族自治县
Chûng-la̍k-sṳ	中壢區
Montauban	蒙托邦
Chhòng-sâ-sṳ	长沙市
Thai Put-lie̍t-tiên lâu Oi-ngì-làn Lièn-ha̍p Vòng-koet	大不列颠及爱尔兰联合王国
Kiok-kiên	踵
Kûng-fûn	厘米
Lièn-ha̍p Hòng-khûng	聯合航空
Yen-thèu	咽
Hò-mí	毫米
Tsûng-tsang-khî (Thòi-pet-sṳ)	中正區 (臺北市)
Mì-mí	微米
Pâ-mâ Yâu-chhu̍k Chhṳ-chhṳ-yen	巴马瑶族自治县
Khi̍t-han (Sú-ho̍k)	极限 (数学)
Theu-fú	豆腐
Phù-sat	菩萨
Chóng-ló Kau-fi	長老宗
Nai-mí	纳米
Berlanga de Duero	贝尔兰加德杜埃罗
Pâ-chûng-sṳ	巴中市
Fu̍t-kông-yen	佛冈县
Sâ-pâ-chû	沙巴
Nàm-nèn-sṳ	南宁市
Ngâ-li-ôn-ngìn	雅利安人
Yù-sṳn-mî-thi Koet-kâ Kûng-yèn	優勝美地國家公園
Chhiâng-set	青色
Ho̍k-yen	學院 (大學)
Kô-hiùng-sṳ	高雄市
Pet-mî Chhṳ-yù Mo-yi Hia̍p-ngi	北美自由贸易协议
Sû-kak-làn-ngìn	蘇格蘭人
Rustenburg	勒斯滕堡
Yen-tsong-fui	音樂會
Yù-fu̍t-chû	柔佛州
Ngò-lò-sṳ̂ Lièn-pâng Chhṳ̍t-hot-sṳ	俄罗斯联邦直辖市
Fì-tshu̍k	回族
Sha̍k-sṳ	硕士
Preston, Lancashire	普雷斯顿
Sî-tí-kâ-vòng	西底家
Sâm-koet	三国
Chhûn-chhiû Sṳ̀-khì	春秋时期
Chan-koet Sṳ̀-khì	戰國
Mâ-liuk-kap-chû	马六甲
Pietermaritzburg	彼得马里茨堡
Sú-vón	腕
Kit-làn-tan-chû	吉兰丹
Tshông-tshu̍k	藏族
Pîn-sàng-chû	槟城
Blackburn	布莱克本
Chûng-sin Pha̍k-hiet-khiû	中性粒细胞
Pâng-kâ-tó	邦加島
Phìn-chhông-khiùn	平昌郡
Thai-koet Koet-chi Hòng-khûng Kûng-sṳ̂	泰國國際航空
Thai Ngi̍t-pún Ti-koet	大日本帝国
Hiûng-nù	匈奴
Phit-li̍t-chû	霹靂州
Lùn-tûn Ti-koet Ho̍k-yen	伦敦帝国学院
Tsen-sàng-sṳ	增城区
Kui-lìm-sṳ	桂林市
Siet-làn-ngô-chû	雪蘭莪
Tui-kok-sien	對角線
Fi-li-phi Liuk-sṳ	費利佩六世
Kûng-tún	公噸
Phàng-hên-chû	彭亨
中國象棋	象棋
Pit-sṳn-hak	必胜客
Yim-suk Siáu-tsṳ́	刺猬索尼克
Ngo̍k-vûn-khiet-tshu̍k	鄂温克族
Nàm-kîn Thai-thù-sat	南京大屠殺
Yún Chṳ-Hau	尹致昊
Phì-mí	皮米
Chûng-koet 2010-ngièn Sông-hói Sṳ-kie Pok-lám-fi	中國2010年上海世界博覽會
Ngiù-ngiuk	牛肉
Carlisle, Cumbria	卡萊爾
Sandomierz	桑多梅日
Ngit-tèu-kông	太阳光
Fûn-kî-hon-khiûn	分枝杆菌属
Chàu-yòng-sṳ	邵阳市
Phìn-tûng-yen	屏東縣
Chông-fa-sṳ	彰化市
Hién-mì-kiang	顯微鏡
Chông-phìn-sṳ	漳平市
Chông-kâ-kie-sṳ	张家界市
Tsàu-ôn-yen	诏安县
Chau-phìn-yen	昭平县
Chṳ Sṳ̀n-kûng	鄭成功
Tsṳn-fò-yen	政和县
Chin-siong-khî	蒸湘区
Chṳ́n-hói-khî (Nèn-pô-sṳ)	镇海区 (宁波市)
Tsà-yùng-yen	柘荣县
Chûng-fò-khî	中和區
Chûng-kông-yen	中江县
Chung-sân-yen	钟山县
Tsû-nèn-yen	周宁县
Chon-hiuk	颛顼
Chu-chû-sṳ	株洲市
Phàng-fù-yen	澎湖縣
Nàm-sâ-khî	南沙区
Kûng-tshun	分米
McGill Thai-ho̍k	麦吉尔大学
Sâm-fòng Ńg-ti	三皇五帝
Sanok	萨诺克
Tsṳ́-kîm-yen	紫金县
Chhṳ-liù-chiáng-khî	自流井区
Mâ-tshâ	馬戰車
Milton Keynes	米尔顿凯恩斯
Â-mî-tshu̍k	阿美族
Ên-tién	恩典
Hiong-sàng-khî	芗城区
Hî-lìn-tên-khî	希靈登區
Chṳ̂-hîn-sṳ	资兴市
Chṳ̂-yòng-sṳ	资阳市
Chṳ̂-ngièn-yen	资源县
Sṳ̀n-chhùng	成蟲
Chang Thien-chṳ́ Fat-sa Kie-son-kî Thôn-chhèn Só-mèu	正电子发射计算机断层扫描
Przemyśl	普热梅希尔
Chhiòn-khiû Sàng-sṳ	全球城市
Pî-mí	飛米
Burnley	伯恩利
Tûng Lùn-tûn, Tûng Khôi-phú-sén	東倫敦 (南非)
Sat-mû-ngí-ki-ha	撒母耳記下
Lie̍t-vòng-ki-ha	列王紀下
Biała Podlaska	比亞瓦-波德拉斯卡
Mèu-tshu̍k	苗族
Pet-hói-sṳ	北海市
Mafikeng	梅富根
Mí-sâ-yên Khiùn-tó	米沙鄢群島
Yông-muì-sṳ	楊梅區
Lò-pô-ôn-vòng	羅波安
Slough	斯劳
Thì-mô-thai	提摩太
Chho̍k-sṳ̂-lia̍p	着絲粒
Tûng-hò, Néu-yok-sṳ	東河 (紐約市)
Chhêu-fông-hìn	超方形
Sêm-mî-làn-chû	森美兰
Brzeg	布熱格
Fidel Valdez Ramos	菲德尔·瓦尔德斯·拉莫斯
Łomża	沃姆扎
Siong-thâm-sṳ	湘潭市
Thûng-tshu̍k	侗族
Pak-fo Kûng-sṳ̂	百貨公司
Thòi-vân Ngièn-tshu-mìn	臺灣原住民族
騷靈現象	騷靈現象
Tha̍t-vat-ngì-tshu̍k	达斡尔族
Na̍p-sî-tshu̍k	纳西族
Kô-hiùng-yen	高雄縣
Khiu-lîn	丘陵
Outaouais	烏塔韋區
Kuî-é	龜
Pak-sâ-sat	伯沙撒
Tshièn-pí	前臂
Yî-set-lie̍t Vòng-koet	以色列王國 (後期)
Tshòn-fì Yâ-lu-sat-lâng Yun-thung	传回耶路撒冷运动
Sîn-sân-sṳ	新山
Khiu-kîm-sân Vân	舊金山灣
Li Mâ-teu	利玛窦
Tshài Yîn-vùn	蔡英文
Chełm	海乌姆
Pha̍k-ngìn	白人
Â-ha̍p-vòng	亞哈
Suwałki	苏瓦乌基
Ngì-làn-yen	宜蘭縣
Maidenhead	梅登黑德
Chû Khiet-lùn	周杰倫
Kiú-liùng	九龍
Nâ-pô-nì-tha̍t	那波尼德
Kiap-kông-yen	夹江县
Hâ-phú-yen	霞浦县
Ngie-mí-li-ôn Lò-mâ-nok-ngî	艾米利亞-羅馬涅語
Sîn-pet-sṳ	新北市
Hî-sî-kâ-vòng	希西家
Thòi-chûng-sṳ	臺中市
IPhone 4S	IPhone 4s
Jędrzejów	延傑尤夫
Fâ-lièn-yen	花蓮縣
Kîm-mùn-yen	金門縣
Lièn-kông-yen	連江縣 (中華民國)
Thòi-tûng-yen	臺東縣
Sîn-chuk-sṳ	新竹市
Kâ-ngi-sṳ	嘉義市
Kî-lùng-sṳ	基隆市
Pet-thèu-khî (Thòi-pet-sṳ)	北投區
Thai-ôn-khî (Thòi-pet-sṳ)	大安區 (臺北市)
Sṳ-lìm-khî (Thòi-pet-sṳ)	士林區
Busko-Zdrój	布斯科茲德魯伊
Àu-thai-li-â Ngièn	澳大利亚元
Thùng-lû-yen	桐庐县
Tûng-yín-hiông	東引鄉
Fuk-tshîn-sṳ	福清市
Tûng-sṳ-hiông	東勢鄉
Mò Chhiang-li ke Thung-vu̍t	不淨動物
Nyèn-sân-khî	雁山区
Tûng-sa̍k-hiông	東石鄉 (台灣)
Kroonstad	克龍斯塔德
Chṳ́-khiâu-khiùn	紙橋郡
Ngo̍k-thòng-khî	岳塘区
Hon-ho̍k	汉学
Thai-thùng-khî (Thòi-pet-sṳ)	大同區 (臺北市)
Nàm-kóng-khî (Thòi-pet-sṳ)	南港區
Nui-fù-khî (Thòi-pet-sṳ)	內湖區
Tshiùng-sân-khî (Thòi-pet-sṳ)	松山區 (臺北市)
Van-fà-khî (Thòi-pet-sṳ)	萬華區
Vùn-sân-khî (Thòi-pet-sṳ)	文山區
Sin-ngi-khî (Thòi-pet-sṳ)	信義區 (臺北市)
Tsûng-sân-khî (Thòi-pet-sṳ)	中山區 (臺北市)
Yî-pó-sṳ	怡保
Ná-pô-pha-lâ-sâ-ngì	那波帕拉薩爾
Â-pí-ngâ-vòng	亞比央
Sûn N̂g	孫吳
Pha̍k-chhu̍k	白族
Pińczów	平丘夫
Aalten	阿尔滕
Ap-chû	鴨洲
Hajnówka	哈伊努夫卡
Phiâng-sân-sîn-khî	坪山新区
Chàu-tûng-yen	邵东县
Lai-phú-yen	荔浦县
Lubartów	盧巴爾圖夫
Hâu-kông-khî	濠江区
Yòng-sân-yen	阳山县
Kông-mìn-sîn-khî	光明新区
Montréal-tó	蒙特利尔岛
IPhone 3GS	IPhone 3GS
IPhone 4	IPhone 4
IPhone 3G	IPhone 3G
Alan Dawa Dolma	阿兰·达瓦卓玛
Tûng-Chìn	东晋
Tûng-Chû	东周
Mâ-lòi-sî-â Hòng-khûng	马来西亚航空
Lì-tshu̍k	黎族
Chûng-sî-khî (Hiông-kóng)	中西區 (香港)
Mí-nâ-hien-vòng	米拿現
Â-ha̍p-chhia-vòng (Yî-set-lie̍t)	亞哈謝 (以色列)
Â-ha̍p-chhia-vòng (Yù-thai)	亞哈謝 (猶大)
Yok-làn-vòng (Yù-thai)	約蘭 (猶大)
Â-sat-li-ngâ	亞撒利雅
Yâ-lò-pô-ôn yit-sṳ	耶羅波安一世
Am-li-vòng	暗利
Nâ-tap-vòng	拿答
Pâ-sâ-vòng	巴沙
Yâ-fu-vòng	耶戶
Yok-sî-â-vòng	約西亞
Yok-â-sṳ̂-vòng (Yù-thai)	約阿施 (猶大)
Sîm-li-vòng	心利 (國王)
Yâ-lò-pô-ôn ngi-sṳ	耶羅波安二世
Yî-vi-mí-lò-tha̍t	以未米羅達
Â-mâ-chhia-vòng	亞瑪謝
Yî-sṳ̂-pô-sat-vòng	伊施波設
N̂g Chok-tùng	吴作栋
Â-sat-vòng	亞撒
Â-mùn-vòng	亞們
Chong Koet-yùng（Chong Fat-chûng）	張國榮
Lí Tên-Fî	李登輝
Yî-lâ-vòng	以拉
Yok-ngâ-kin-vòng	約雅敬
Hò-se-â-vòng	何細亞
Yok-ngâ-kîn-vòng	约雅斤
Biłgoraj	比烏戈拉伊
Chhî Chai-Phit	徐載弼
Puławy	普瓦維
Chuk Hon	蜀汉
Chhâu Ngùi	曹魏
Abitibi-Témiscamingue	阿比蒂比-蒂米斯坎明格
Staszów	斯塔舒夫
Mò-tóng-sit	無黨籍
Iwakuni-sṳ	岩國市
Soi-ha-tshu̍k	賽夏族
Kâu-thûng kûng-khí	运输方式
Phok Hièn-yún	朴宪永
Sat-kâ-li-ngâ-vòng	撒迦利雅
Yok-ha̍p-sṳ̂-vòng	約哈斯 (以色列)
Fùng Siù-chhiòn	洪秀全
Yok-â-sṳ̂-vòng (Yî-set-lie̍t)	約阿施 (以色列)
Yok-làn-vòng (Yî-set-lie̍t)	約蘭 (以色列)
Pí-kâ-vòng	比加
Sâ-liùng-vòng	沙龍 (以色列)
Pí-kâ-hot-vòng	比加轄
Khiu Sṳ̀n-thûng	丘成桐
Fùng Puk-kím Kiê	红腹锦鸡
Grajewo	格拉耶沃
Sat-lâ-tshu̍k	撒拉族
Yok-ha̍p-sṳ-vòng	約哈斯 (猶大)
Sîn-tiam-khî	新店區
Łapy	瓦佩
Sin-ngióng	新娘
Pâ-set-fi	崇真会
Chhiâng-pa̍k-kông-khî	青白江区
Mî-yî-mî-fi	美以美會
瑤族	瑶族
Thú-sàng-khî	土城區
Sîn-chông-khî	新莊區
Hagi-sṳ	萩市
Wong Hi-zi	王羲之
Meu-nàm-khî	茂南区
Chûng-chhiû-chiet	中秋节
Nài-lî-kak-li-sâ-ngì	涅里格利沙爾
Fùng-theu	紅豆
Łuków	武庫夫
Łęczna	文奇納
Świdnik	斯維德尼克
Pô-sṳ̂ Ti-koet	阿契美尼德王朝
Nagato-sṳ	長門市
Sî-lìm-yen	西林县
Mâ-thai-fuk-yîm	馬太福音
Sṳ̍p-sṳ-ka	十字架 (基督教)
Â-chû Hòng-khûng X	全亚洲航空
Â-chû Hòng-khûng	亞洲航空
Yî-fut-só-sû	以弗所書
Sòng-tet-sṳ	常德市
Yit-yòng-sṳ	益阳市
Chhim-chû-sṳ	郴州市
Tshî Kông-khí	徐光启
Sàng-khî (San-mî-sṳ)	城区
Súi-nèn-sṳ	遂宁市
Nui-kông-sṳ	内江市
Tha̍t-chû-sṳ	达州市
Ngá-ôn-sṳ	雅安市
10000	10000
Fú-kûa	苦瓜
Fún-fùng-set	粉红色
Nâ-sat-le̍t	拿撒勒
Thòi-vân kâu-thûng	臺灣交通
Yî-tshu̍k	彝族
Mî-koet Kûng-lî-fi Chhâ-fi	美国公理会差会
Â-thâ-li-ngâ	亞她利雅
Augustów	奧古斯圖夫
Windsor, Berkshire	溫莎 (伯克郡)
Kô Khô-kî	高科技
Hí Chṳ̂n-shuk	許貞淑
Tai Tet-sâng	戴德生
Hòn Hòn	韩寒
Pet-kóng-tsṳ́n	北港鎮 (臺灣)
Tczew	特切夫
Hâ-nì-tshu̍k	哈尼族
Thòi-nàm-yen	臺南縣
Fù-chṳ-mìn-sṳ Kî-chhòng	新山一國際機場
Hien-thoi Sonata	现代索纳塔
Vû-tsṳ-phe̍t-khiet-chhu̍k	乌孜别克族
Thap-kit-khiet-tshu̍k	塔吉克族
Wal-Mart Kûng-sṳ̂	沃尔玛
緋彈个婭里婭	緋彈的亞莉亞
Yùn-tôn yun-son	雲端運算
Ńg-sùn-chiet Yun-thung	五旬節運動
Liu̍k-theu	绿豆
Chêu-siên-chhu̍k	朝鲜族
Khúa-ngì-khiet-tsṳ-tshu̍k	柯尔克孜族
Burgo de Osma-Ciudad de Osma	布尔戈德奥斯马-休达德奥斯马
Sông-hói Ha̍p-tsok Tsû-tsṳt	上海合作组织
Yì Kit-chùn	兪吉濬
Reus	雷烏斯
San Esteban de Gormaz	圣埃斯特万德戈尔马斯
Sâm-sên Fó-châi Hói-song Pó-hiám	三星火灾海上保险
Yî-ho̍k-yen	醫學院
Het-mien Phî-lù	黑脸琵鹭
Tshiòn-koet hon-sṳ kau-yuk thôi-tsin tsúng lièn-ha̍p-fi	全國漢字教育推進總聯合會
Sṳ̀n-chheu-fi	神召会
Phok Chhùng-yòng	朴重陽
Fâ-tû-khî	花都区
Sâ-â-nàm	莎阿南
Kit-lùng-po Koet-chi Kî-chhòng	吉隆坡国际机场
Ngiu̍k-Sân	玉山
Hōfu-sṳ	防府市
Thai-yí-sân	大嶼山
Starogard Gdański	格但斯克舊城
Het-tsat-tshu̍k	赫哲族
Sîn-chhèu	新朝
Mauricie	摩麗絲區
Strzelce Opolskie	斯切爾采奧波萊斯基
Yîn-kô-khî	鶯歌區
Kâu-thûng	道路運輸
Khiùn	郡
Vû-yìn	蠅
Tha̍t-mâ-thai	達爾馬提亞
Witwatersrand Thai-ho̍k	金山大學
Pat-phu-khî	八步区
Ôn-fa-yen	安化县
Hà (Sṳ̍p-liuk-koet)	夏 (十六国)
Hò-tûng-sṳ	河東郡 (越南)
Sîn-chîn-yen	新津县
Mâ-lî-sûn	马礼逊
Mùng-sân-yen	蒙山县
Thai-lî-khî	大里區
Fûng-ngièn-sṳ	豐原區
Thai-phìn-sṳ	太平區 (臺中市)
Thai-kap-tsṳ́n	大甲區
Tshîn-súi-tsṳ́n	清水區 (臺中市)
Sâ-lu̍k-tsṳ́n	沙鹿區
Ǹg-tshi-tsṳ́n	梧棲區
Thai-ôn-hiông (Thòi-chûng)	大安區 (臺中市)
Thai-tú-hiông	大肚區
Thai-ngâ-hiông	大雅區
Fò-phìn-khî	和平區 (臺中市)
Heu-lî-hiông	后里區
Liùng-tsiáng-hiông	龍井區
Sṳ̀n-kông-hiông	神岡區
Sa̍k-kóng-hiông	石岡區
Thâm-tsṳ́-hiông	潭子區
Ngoi-phû-hiông	外埔區
Vú-fûng-hiông	霧峰區
Vû-ngit-hiông	烏日區
Sîn-sa-hiông	新社區
Pat-lî-khî	八里區
Pán-khièu-khî	板橋區 (新北市)
Kung-liàu-khî	貢寮區
Kîm-sân-khî	金山區 (新北市)
Nà-khiéu-khî	林口區
Lù-chû-khî	蘆洲區
Phiâng-lìm-khî	坪林區
Phìn-hâi-khî	平溪區
Lui-fông-khî	瑞芳區
Sâm-chhùng-khî	三重區
Sâm-hia̍p-khî	三峽區
Sâm-chṳ-khî	三芝區
Chhṳ̂m-hâng-khî	深坑區
Sa̍k-tàng-khî	石碇區
Sa̍k-mùn-khî	石門區
Su-nà-khî	樹林區
Thai-sân-khî	泰山區 (新北市)
Thâm-súi	淡水區
Van-lî-khî	萬里區
Ńg-kú-khî	五股區
Sip-chṳ-khî	汐止區
Yún-fò-khî	永和區
Fû-lùn-pi-ngì-sṳ	呼伦贝尔市
Ngo̍k-vûn-khiet-tshu̍k Tshṳ-tshṳ-khî	鄂温克族自治旗
Thòi-yit-sien	台1線
Ǹg-chiu-sṳ	梧州市
Fòng-sàng-kóng-sṳ	防城港市
Khîm-chiu-sṳ	钦州市
Kui-kóng-sṳ	贵港市
Ngiu̍k-lìm-sṳ	玉林市
Pak-set-sṳ	百色市
Fo-chiu-sṳ	贺州市
Hò-chhṳ̀-sṳ	河池市
Lòi-pîn-sṳ	来宾市
Fuk-thièn-khî	福田区
Chhùng-chó-sṳ	崇左市
Thòi-kiú-sien	台9線
Kôn-liâu	官僚
Lùng-fi-yen	隆回县
Thú-kâ-tshu̍k	土家族
Lai-vân-khî	荔湾区
Hîn-nèn-khî	兴宁区
Siau-sân-khî	萧山区
Fûng-khôi-yen	封开县
Dewetsdorp	德韋茨多普
Sîn-kie	新界
Khôi-phìn-sṳ	开平市
Tsit-sa̍k-sân Pó-ôn-tshu̍k Tûng-hiông-tshu̍k Sat-lâ-tshu̍k Tshṳ-tshṳ-yen	积石山保安族东乡族撒拉族自治县
Mo-yi	贸易
Kô-mìn-khî	高明区
Saam-zi-gang	三字经
Thí-lîn-sṳ	醴陵市
Kędzierzyn-Koźle	肯傑任科茲萊
Kóng-hon-sṳ	广汉市
Meu-yen	茂县
Ôn-hiông-yen	安乡县
Ôn-hâi-yen	安溪县
Yo̍k-ho̍k	药学
Chhiâng-yòng-khî	青羊区
Fi-yòng-khî	惠阳区
Kóng-tó-yen	廣島縣
Thu̍k-liùng-tshu̍k	独龙族
Tseu-tshu̍k	鄒族
IPhone (Thi-yit thoi)	IPhone (第一代)
Ye̍t-nàm-ngî sṳ-mû	越南文字母
Ólvega	奥尔韦加
Sîn Pâ-pí-lùn Vòng-koet	新巴比倫王國
Fuk-tín-sṳ	福鼎市
Fung-sân-sṳ	鳳山區
Khîm-nàm-khî	钦南区
Thú-ngí-khì-ngî sṳ-mû	土耳其语字母
Kien-yòng-sṳ	建阳区
Shūnan-sṳ	周南市
Skarżysko-Kamienna	斯卡日斯科-卡緬納
Longás	隆加斯
Kô-tá-ha̍p-lû-sṳ	哥打巴鲁
Sú-chiuk-khiéu-phiang	手足口病
Kông-phú	光學頻譜
Chhṳ̂m-súi-phu-khî	深水埗區
Mielec	梅萊茨
Yùn-siau-yen	云霄县
客家	客家民系
Vù-kau-piáng	無酵餅
Téu-liuk-sṳ	斗六市
Wejherowo	韋伊海羅沃
Pu-yî-chhu̍k	布依族
Mí-yi-yen	米易县
Nâ-po-yen	那坡县
Ngì-làn-sṳ	宜蘭市
Ńg-fù Sṳ̍p-liuk-koet	五胡十六国
Néu-yok Tû-fi-khî	紐約都會區
歷峯雧團	历峰集团
Ng̀-tshon-sṳ	吴川市
Lanaudière	勒奴地耶
Thap-lùn-ti-nò-ngî	塔伦蒂诺语
Vòng Sîm-lìn	王心凌
Vòng Yún-khin	王永慶
Thùng-lò-hiông	銅鑼鄉 (台灣)
Chhṳ̀n Kâ-fà	陳嘉樺
Lo̍k-chhîn-sṳ	乐清市
Eu-hói-khî	瓯海区
Mâ-kûng-sṳ	馬公市
Sîn-yàng-sṳ	新營區
Tshu-theu-fú	臭豆腐
Thai-pó-sṳ	太保市
Sû-o-tsṳ́n	蘇澳鎮 (臺灣)
Chong Lìn-sâng	張靈生
Làn-yí	蘭嶼
Mèu-li̍t-sṳ	苗栗市
2009-ngièn sṳ-kie yun-thung-fi	2009年世界運動會
Thòi-vân hàng-tsṳn khî-va̍k	臺灣行政區劃
Nàm-o-hiông	南澳鄉
Tshṳ̀n Ví-ngia̍p	陳偉業
Thai-ngâ-tshu̍k	泰雅族
Thòi-chûng-yen	臺中縣
Thòi-ngi-sien	台2線
Liu̍k-tó-hiông	綠島鄉
Lu̍k-kóng-tsṳ́n	鹿港鎮
Kîm-mùn Koet-kâ Kûng-yèn	金門國家公園
Thòi-pet Lìn-liòng-thòng	臺北靈糧堂
Pu-nùng-tshu̍k	布農族
Vòng Ngiuk-mìn	黃毓民
Nàm-kôn-hiông	南竿鄉
Liùng-vân-khî	龙湾区
Lu̍k-sàng-khî	鹿城区
Phìn-yòng-yen	平阳县
Yún-kâ-yen	永嘉县
Thung-thèu-yen	洞头县
Tûng-sân-hiông (Thòi-nàm)	東山區 (臺南市)
Ǹg-yèn	鱼丸
Chhṳ̀-hâi-sṳ	慈溪市
Lò-tûng-tsṳ́n	羅東鎮 (臺灣)
Tûng-sân-hiông	冬山鄉
Thèu-sàng-tsṳ́n	頭城鎮
Pet-mùn-hiông	北門區
Sîn-sṳ-hiông	新市區 (臺南市)
Thai-hâi-tsṳ́n	大溪區
Tshit-mî-hiông	七美鄉 (臺灣)
Pî-nàm-tshu̍k	卑南族
Kit-ôn-hiông	吉安鄉
Yún-không-sṳ	永康區
Kông-sân-tsṳ́n	岡山區
Phú-chṳ́-sṳ	朴子市
Sâm-sên-hiông	三星鄉 (台灣)
Tha̍t-ngu-tshu̍k	達悟族
Thòi-vân Ngiùn-hòng	臺灣銀行
Kîm-sàng-tsṳ́n	金城鎮 (金門縣)
Phû-lî-tsṳ́n	埔里鎮
Vû-hiu-hiông	烏坵鄉
Thai-thùng-hiông	大同鄉 (台灣)
Mâ-hâi	馬偕
Ngit-chhut-khòng-sàng	日出康城
Tsiông-kiûn-hiông	將軍區
Koet-li̍p Thòi-vân Pok-vu̍t-kón	國立臺灣博物館
Thai-su-hiông	大樹區
Pô-chûng-hiông	褒忠鄉
Tsiâu-hâi-hiông	礁溪鄉
Mong-ôn-hiông	望安鄉
Mà-theu-tsṳ́n	麻豆區
Mî-nùng-tsṳ́n	美濃區
Theui-waan Thin-get Lin-mang	台灣團結聯盟
Pat-pat suí-châi	莫拉克風災
Thai-lû-kok Koet-kâ Kûng-yèn	太魯閣國家公園
Â-lî-sân Koet-kâ Sêm-lìm Yù-lo̍k-khî	阿里山國家風景區
Tûng-kóng-tsṳ́n	東港鎮 (臺灣)
Tshòng-tshṳ-hiông	長治鄉
Sṳ̂-é-hiông	獅子鄉 (台灣)
Tsham-lìm-hiông	杉林區
Van-yùng-hiông	萬榮鄉
Tsuk-thièn-hiông	竹田鄉
Mâ-kâ-hiông	瑪家鄉
Mì-thò-hiông	彌陀區
Yèn-tshâu-hiông	燕巢區
Piông-liàu-hiông	枋寮鄉
Tsṳ́-kôn-hiông	梓官區
Piông-sân-hiông	枋山鄉
Méu-tân-hiông	牡丹鄉
Yèn-sân-hiông	員山鄉
Lu-tsuk-hiông	路竹區
Khén-tên Koet-kâ Kûng-yèn	墾丁國家公園
Su-fûng-hiông	壽豐鄉
Fu-lî-hiông	富里鄉
Siet-pa Koet-kâ Kûng-yèn	雪霸國家公園
Siu-lìm-hiông	秀林鄉
Kông-fu̍k-hiông	光復鄉
Nàm-chû-hiông	南州鄉
Cho̍k-hâi-hiông	卓溪鄉
Mân-chû-hiông	滿州鄉
Kham-táng-hiông	崁頂鄉
Yâm-phû-hiông	鹽埔鄉
Pet-kôn-hiông	北竿鄉
Lie̍t-yí-hiông	烈嶼鄉
Ńg-kiet-hiông	五結鄉
Van-lòng-hiông	萬巒鄉
Kô-su-hiông	高樹鄉
Kâ-tûng-hiông	佳冬鄉
Lòi-ngi-hiông	來義鄉
Fûng-pîn-hiông	豐濱鄉
Nâ-mâ-ha-hiông	那瑪夏區
Lìm-lo̍k-hiông	麟洛鄉
Liùng-khì-hiông	龍崎區
Thai-vú-hiông (Phìn-tûng)	泰武鄉
Vu-thòi-hiông	霧台鄉
Meu-lìm-hiông	茂林區
Kiú-yì-hiông	九如鄉
Ho̍k-kap-tsṳ́n	學甲區
Yún-ôn-hiông	永安區
Tiâu-tshiùng-hiông	鳥松區
Tsó-tsṳ́n-hiông	左鎮區
Thièn-liàu-hiông	田寮區
Khiâu-thèu-hiông	橋頭區
Thai-sa-hiông	大社區
Yàm-súi-tsṳ́n	鹽水區
Liù-khiù-hiông	琉球鄉
Lìm-yèn-hiông	林園區
Lìm-piên-hiông	林邊鄉
Tshûn-ngit-hiông	春日鄉
Lî-kóng-hiông	里港鄉
Thò-ngièn-hiông	桃源區
Nui-mùn-hiông	內門區
Â-lièn-hiông	阿蓮區
Vòng Sṳ́m-tî	王審知
Nàm-fa-hiông	南化區
Si̍p-si̍p-tsṳ́n	集集鎮
Tsuk-sân-tsṳ́n	竹山鎮 (台灣)
Tshó-thùn-tsṳ́n	草屯鎮
Yìn-oi-hiông	仁愛鄉
Yìn-tet-hiông	仁德區
Ôn-thin-hiông	安定區 (臺南市)
Sṳ̀n-kûng-tsṳ́n	成功鎮
Súi-lî-hiông	水里鄉
Yìn-vú-hiông	仁武區
Koet-siang-hiông	國姓鄉
San-fa-tsṳ́n	善化區
Tshit-kú-hiông	七股區
Ngiu̍k-tsiáng-hiông	玉井區
Ǹg-tshṳ̀-hiông	魚池鄉 (臺灣)
Sân-song-hiông	山上區
Ha-yàng-hiông	下營區
Nàm-sî-hiông	楠西區
Kûi-yìn-hiông	歸仁區
Liuk-kap-hiông	六甲區
Miàng-kiên-hiông	名間鄉
Liú-yàng-hiông	柳營區
Tshèu-chû-tsṳ́n	潮州鎮
Fú-mî-tsṳ́n	虎尾鎮
Thú-khù-tsṳ́n	土庫鎮
Van-tân-hiông	萬丹鄉
Hâi-chû-hiông	溪州鄉
Kûan-sân-tsṳ́n	關山鎮 (台灣)
Heu-piak-hiông	後壁區
Sî-kóng-hiông	西港區
Ngiu̍k-lî-tsṳ́n	玉里鎮
Thai-nui-hiông	大內區
Kôn-thièn-hiông	官田區
Ngô-mì-hiông	峨眉鄉
Pha̍k-hò-tsṳ́n	白河區
Yòng-mìn-sân Koet-kâ Kûng-yèn	陽明山國家公園
Sî-yí-hiông	西嶼鄉
Sú-tû(Hiông-kóng)	首都 (香港)
Hak-kâ chhoi	客家菜
Làn-yí-hiông	蘭嶼鄉
Â-lî-sân-hiông	阿里山鄉
Fù-sî-hiông	湖西鄉
Fù-nui-hiông	湖內區
Lìm-nui-hiông	林內鄉
Téu-nàm-tsṳ́n	斗南鎮
Ma̍k-liàu-hiông	麥寮鄉
Kâ-lî-tsṳ́n	佳里區
Ngièn-tshòng-hiông	元長鄉
Sîn-phî-hiông	新埤鄉
Thòi-sî-hiông	臺西鄉
Lûn-poi-hiông	崙背鄉
Tshṳ̀-thùng-hiông	莿桐鄉
Thai-tshûn-hiông	大村鄉 (臺灣)
Hèn-tshûn-tsṳ́n	恆春鎮
Kú-hâng-hiông	古坑鄉
Sî-lô-tsṳ́n	西螺鎮
Thai-phî-hiông	大埤鄉
Tûng-ông Sân-ma̍k	中央山脈
Si-fù-hiông	四湖鄉
Wong Gaa-khi	黃家駒
Phìn-fông Kûng-lî	平方千米
Phùn-tshoi	盆菜
Pha̍k-sâ-hiông	白沙鄉 (台灣)
Tshòng-pîn-hiông	長濱鄉
Tûng-hò-hiông	東河鄉 (臺灣)
Pî-nàm-hiông	卑南鄉
Sîn-phû-tsṳ́n	新埔鎮
Kîm-nèn-hiông	金寧鄉
Liòng Kuet-hiùng	梁國雄
Thòi-vân Kî-tuk-kau	台灣基督教
Lu̍k-kuk-hiông	鹿谷鄉
Lu̍k-yâ-hiông	鹿野鄉
Liuk-kuî-hiông	六龜區
Ngi-lûn-hiông	二崙鄉
Súi-lìm-hiông	水林鄉
Kôn-yîm-hiông	觀音區
Thòi-pet tû-fi khî	臺北都會區
Khì-sân-tsṳ́n	旗山區
Tsong-vì-hiông	壯圍鄉
Lui-sui-hiông	瑞穗鄉
Fò-mî-tsṳ́n	和美鎮
Hak-kâ Thien-sṳ-thòi	客家電視台
Yèn-phìn-hiông	延平鄉
Sîn-sàng-hiông	新城鄉 (台灣)
Thai-mà-lî-hiông	太麻里鄉
Tshâ-sàng-hiông	車城鄉 (臺灣)
Kîm-fûng-hiông	金峰鄉 (台灣)
Thai-vú-hiông	大武鄉 (台灣)
Kîm-fù-tsṳ́n	金湖鎮
Thûng-sêu-tsṳ́n	通霄鎮
Sâm-thi-mùn-hiông	三地門鄉
Hói-tôn-hiông	海端鄉
Kîm-sâ-tsṳ́n	金沙鎮 (金門縣)
Sîn-fûng-hiông	新豐鄉 (台灣)
Tsiâm-sa̍k-hiông	尖石鄉
Yen-lî-tsṳ́n	苑裡鎮
Fâ-lièn-sṳ	花蓮市
Kuî-sân-hiông	龜山區
Yèn-lìm-tsṳ́n	員林鎮
Phìn-tsṳ́n-sṳ	平鎮區
Liùng-thâm-hiông	龍潭區 (桃園市)
Shuì-ôn-sṳ	瑞安市
Lù-tsuk-hiông	蘆竹區
Fung-fa-sṳ	奉化市
Phìn-tûng-sṳ	屏東市
Thòi-tûng-sṳ	臺東市
Thai-liàu-hiông	大寮區
F4	F4 (男子團體)
Chùng-chṳ́	粽
Pet-phû-hiông	北埔鄉
Heu-liùng-tsṳ́n	後龍鎮 (台灣)
Vàng-sân-hiông	橫山鄉 (臺灣)
Kûng-kón-hiông	公館鄉 (臺灣)
Nàm-chông-hiông	南庄鄉 (台灣)
Ńg-fûng-hiông	五峰鄉 (台灣)
Sîn-yèn-hiông	新園鄉 (台灣)
Kûan-sî-tsṳ́n	關西鎮 (台灣)
Sî-fù-hiông	西湖鄉 (台灣)
Tsuk-nàm-tsṳ́n	竹南鎮
Sṳ̂-thàn-hiông	獅潭鄉
Khiûng-lìm-hiông	芎林鄉
Chûng-liàu-hiông	中寮鄉
Fung-lìm-tsṳ́n	鳳林鎮 (臺灣)
Thèu-vuk-hiông	頭屋鄉
Lui-phû-hiông	內埔鄉
Thèu-fun-tsṳ́n	頭份鎮
Thai-ôn-hiông	泰安鄉
Pó-sân-hiông	寶山鄉 (台灣)
Cho-khièu-hiông	造橋鄉
Tha̍t-yìn-hiông	達仁鄉
Cho̍k-làn-tsṳ́n	卓蘭鎮
Siet-sân Sân-ma̍k	雪山山脈
Tsuk-tûng-tsṳ́n	竹東鎮
Thai-fù-hiông	大湖鄉 (台灣)
Hâi-khiéu-hiông	溪口鄉 (台灣)
Sâm-vân-hiông	三灣鄉 (台灣)
Liuk-kiok-hiông	六腳鄉
Mìn-hiùng-hiông	民雄鄉
Sâm-ngi-hiông	三義鄉 (台灣)
Thai-phû-hiông	大埔鄉
Phû-sîm-hiông	埔心鄉
Yún-tshìn-hiông	永靖鄉
Hak-kâ Yòng-theu-fú	客家酿豆腐
Ya̍p Â-lòi	叶亚来
Then Yí-hièn	鄧雨賢
Thòi-fûng Mo̍k-Là-Khiet (2009-ngièn)	颱風莫拉克 (2009年)
Tshûn-kóng-hiông	伸港鄉
Thòi-pet Tshia̍p-yun	臺北捷運
Kí-kóng-hiông	莒光鄉
Chhòn-yùng Hòng-khûng	長榮航空
Nàm-thèu-sṳ	南投市
Phài-vân-tshu̍k	排灣族
Thòi-vân nàm-tó ngî-ngièn	台灣南島語言
Lìm-pâ Se-pâu	淋巴细胞
Fông-yen-hiông	芳苑鄉
Thièn-mî-hiông	田尾鄉
Phài-vân-ngî	排湾语
Thai-ngâ-ngî	泰雅語
Sa-thèu-hiông	社頭鄉
Hâi-fù-tsṳ́n	溪湖鎮
Pu-thoi-tsṳ́n	布袋鎮
Lu̍k-tshó-hiông	鹿草鄉
Sîn-vuk-hiông	新屋區
Kap-siên-hiông	甲仙區
Thò-yèn-sṳ	桃園區
Lû-khái-tshu̍k	魯凱族
Tseu-ngî	鄒語
Pî-nàm-ngî	卑南語
Soi-ha-ngî	賽夏語
Khiéu-fù-hiông	口湖鄉
Thòi-vân Thú-thi Ngiùn-hòng	臺灣土地銀行
Hak-kâ thú-lèu	福建土楼
Khòng-sàng-chhàm (Hiông-kóng)	康城站 (香港)
Sien-sî-hiông	線西鄉
Sîn-kóng-hiông	新港鄉
Chûng-phû-hiông	中埔鄉
Fâ-thàn-hiông	花壇鄉
Tsuk-thòng-hiông	竹塘鄉 (台灣)
Chûng-fà Thai-ho̍k	中華大學
Phû-yàm-hiông	埔鹽鄉
Tsuk-khì-hiông	竹崎鄉
Thai-sàng-hiông	大城鄉
Ngi-súi-hiông	二水鄉
Ngi-tsuk-hiông	義竹鄉
Súi-song-hiông	水上鄉
Fu̍k-hîn-hiông	復興區 (桃園市)
Thai-lìm-tsṳ́n	大林鎮 (台灣)
Thai-yèn-hiông	大園區
Phî-thèu-hiông	埤頭鄉
Mòi-sân-hiông	梅山鄉 (台灣)
Fuk-hîn-hiông (Chông-fa)	福興鄉 (臺灣)
Pet-téu-tsṳ́n	北斗鎮 (台灣)
Fân-lu-hiông	番路鄉
Fûn-yèn-hiông	芬園鄉
Ngi-lìm-tsṳ́n	二林鎮
Thièn-chûng-tsṳ́n	田中鎮
Siu-súi-hiông	秀水鄉 (台灣)
100000	100000
Kô-sîn-shì	嚳
Jarosław	雅罗斯瓦夫
Tûng-khî (Hiông-kóng)	東區 (香港)
Â-chû Thien-sṳ Yû-han Kûng-sṳ̂ (Hiông-kóng)	亞洲電視
Gaspésie–Îles-de-la-Madeleine	嘉比茜-馬德蘭島
Pok-lò-yen	博罗县
Ostrowiec Świętokrzyski	聖十字地區奧斯特羅維茨
Sa̍k-fûng-khî	石峰区
Tshiâ-tshu̍k	畲族
Sîn-kâ-po Koet-li̍p Thai-ho̍k	新加坡国立大学
Sên-sán	生产
Chojnice	霍伊尼采
Thi-kip-sṳ	地级市
Mine-sṳ	美禰市
Mì-fûn-ho̍k	微分学
Tûng-hiông-tshu̍k	东乡族
Lâ-fú-tshu̍k	拉祜族
Włodawa	弗沃達瓦
Starachowice	斯塔拉霍維采
Stalowa Wola	斯塔洛瓦沃拉
Chat-ho̍k Pok-sṳ	哲學博士
Lì-tó-khî	離島區
Thông-phûng	蜜蜂
Tshûng-shîn-yen	沖繩縣
Tshòng-lo̍k-sṳ	长乐市
Yí-fù-khî	雨湖区
Sâm-súi-khî	三水区
Nàm-thin-sṳ	南定市
Montpellier Thai-ho̍k	蒙彼利埃大學
Końskie	孔斯凱
Luceni	卢塞尼
Fà-khièu	海外華人
Kien-nèn-yen	建宁县
Lô-kông-khî	萝岗区
Madrid Chhṳ-chhṳ Thai-ho̍k	马德里自治大学
Tshṳ-tshṳ-chû	自治州
Medway	梅德韋
Pó-ôn-khî	宝安区
Pet-liù-sṳ	北流市
Nysa, Pô-làn	尼斯 (波兰)
Belver de Cinca	贝尔韦尔德辛卡
Pó-ôn-chhu̍k	保安族
Culemborg	屈伦博赫
Kôan-tan-sṳ	关丹
Sokółka	索庫烏卡
Thâu-thông-shì	尧
Hikari-sṳ	光市
Krosno	克羅斯諾
Kûng-lî	千米
Almarza	阿尔马萨
Aldealices	阿尔德亚利塞斯
Aldealafuente	阿尔德亚拉丰特
Alentisque	阿伦蒂斯克
Adradas	阿德拉达斯
Alconaba	阿尔科纳瓦
Abejar	阿韋哈爾
Aldealpozo	阿尔德亚尔波索
Alcubilla de las Peñas	阿尔库维利亚德拉斯佩尼亚斯
Aldealseñor	阿尔德亚尔塞尼奥尔
Alcubilla de Avellaneda	阿尔库维利亚德亚韦利亚内达
Covaleda	科瓦莱达
Almazul	阿尔马苏尔
Arcos de Jalón	阿尔科斯德哈隆
Aldehuela de Periáñez	阿尔德韦拉德佩里亚涅斯
Almenar de Soria	阿尔梅纳尔德索里亚
Vinuesa	比努埃萨
Sû-chiu-fa	苏州话
Duruelo de la Sierra	杜鲁埃洛德拉谢拉
San Leonardo de Yagüe	圣莱奥纳尔多德阿格
Sṳ̂-é-sân (Hiông-kóng)	獅子山 (香港)
Vú-Chû	武周
Chhṳ̀-yùn-sân	慈雲山
白話	白話
Vòng-thai-siên Tshàm	黃大仙站
Shâu-sân-sṳ	韶山市
Tshiên-vân Chhàm(TSW)	荃灣站
Chhṳ̂m-súi-phu Tshàm	深水埗站
梅縣話	梅县话
Yù-thòng Tshàm(YAT)	油塘站
Tai-tshu̍k	傣族
Mùn-pâ-tshu̍k	门巴族
Kudamatsu-sṳ	下松市
Kiong-tshu̍k	羌族
Afrikaner-ngìn	阿非利卡人
Sâ-thèu-kok	沙頭角
Yîn-koet-ngìn	英国人
Ngá-tshu̍k	佤族
Kûng-yîn	粨
Fû-yûng-sṳ	芙蓉市
Jasło	亚斯沃
Â-chhông-chhu̍k	阿昌族
Bielsk Podlaski	波德拉謝地區別爾斯克
Thú-tshu̍k	土族
Kîn-mí	京米
Sîn-lòng	新郎
Súi-tshu̍k	水族
Nyet-láu-tshu̍k	仡佬族
Kín-phó-tshu̍k	景颇族
Lo̍k-pâ-tshu̍k	珞巴族
Li̍t-siuk-tshu̍k	傈僳族
Vì-kî Pak-khô Ngî-ngièn Lie̍t-péu	Wikipedia:维基百科语言列表
Siên-pî-chhu̍k	鲜卑
Sanyo-Onoda-sṳ	山陽小野田市
Billingham	比林漢姆
Pin-kông-khî	滨江区
Pet-khî (Hiông-kóng)	北區 (香港)
Mô-nàm-tshu̍k	毛南族
Nu-tshu̍k	怒族
Mu̍k-láu-tshu̍k	仫佬族
Sî-sûng-pán-na̍p Thài-tshu̍k Tshṳ-tshṳ-chû	西双版纳傣族自治州
Ngièn-lóng-khî	元朗區
Kôn-thòng-khî	觀塘區
Khwûi-tshiâng-khî	葵青區
Phù-mí-tshu̍k	普米族
Thai-pu-khî	大埔區
Tet-ngo-tshu̍k	德昂族
Vòng-thai-siên-khî	黃大仙區
Tshiên-vân-khî	荃灣區
Pu-lóng-chhu̍k	布朗族
Pok-pha̍k-yen	博白县
Chhîn-sîn-yen	清新区
Pâ-thìn-khiùn	巴亭郡
Bracknell Sêm-lìm	布拉克內爾森林
Mìn-chú Chin-phu-tóng	民主進步黨
Tomaszów Lubelski	盧布林地區托馬舒夫
Liú-kông-yen	柳江县
Thiên-hò-khî	天河区
Po-thèu-khî	坡头区
Hàng-thung Chok-ngia̍p Ne-thúng	行動作業系統
Hrubieszów	赫魯別舒夫
Liùng-mùn-yen	龙门县
Hói-tshong-khî	海沧区
Pet Québec Thi-khî	北魁北克地区
Montérégie	蒙泰雷吉
Nàm-hiùng-sṳ	南雄市
Hói-nàm-fa	海南话
Tshiùng-thâu Mèu-tshu̍k Tshṳ-tshṳ-yen	松桃苗族自治县
Chhièn-Liòng	前凉
Liú-sàng-yen	柳城县
Sun-tet-khî	顺德区
Dębica	登比察
Fân-nyî-khî	番禺区
Québec-ngìn Tóng	魁北克人黨
Grahamstown	格拉罕鎮
Cape Town Thai-ho̍k	开普敦大学
Phìn-lo̍k-yen	平乐县
Kui-phìn-sṳ	桂平市
Sasolburg	薩索爾堡
Kûng-nèn-hîn Sú-kî	功能型手機
Tûng-sân-yen	东山县
Hò-thòng-khî	荷塘区
Si̍p-mî-khî	集美区
Ǹg-fûng-khî	鱼峰区
Kraśnik	克拉希尼克
Dęblin	登布林
Radzyń Podlaski	波德拉謝地區拉曾
Pet-thâm-yúng	北潭涌
Kú-thung Tshàm(Tûng-Thiet-Sien)古洞站（東鐵綫）	古洞站
Kú-thung	古洞
Hiông-kóng Piên-kin Kim-khî	香港邊境禁區
Thûn-mùn-khî	屯門區
Kiú-liùng-sàng-khî	九龍城區
Nàm-khî (Hiông-kóng)	南區 (香港)
Vân-chái-khî	灣仔區
Prudnik	普魯德尼克
Villanueva de Sigena	锡赫纳新镇
Tûng-Thiet-Sien	東鐵綫
Tseung Kwan O Line	將軍澳綫
Stockton-on-Tees	蒂斯河畔斯托克頓
Kóng-nèn-yen	广宁县
Bultfontein	伯爾特方丹
Sî-Liòng	西涼
Phiàng-Chhià	坪輋
Lo̍k-mâ-chû	落馬洲
Kiú-liùng--thòng Tshàm	九龍塘站 (香港)
Fûng-hâi-khî	枫溪区
Lò-fù-khî	罗湖区
Yàm-thièn-khî	盐田区
Khiâm-nàm Pu-yî-tshu̍k Mèu-tshu̍k Tshṳ-tshṳ-chû	黔南布依族苗族自治州
Lìm-ha Fì-tshu̍k Tshṳ-tshṳ-chû	临夏回族自治州
Liùng-kông-khî	龙岗区
Graaff-Reinet	格拉夫-里內特
Fu-yòng-sṳ	富阳区
Yì-yâu-sṳ	余姚市
Â-pa Chhong-chhu̍k Kiông-chhu̍k Chhṳ-chhṳ-chû	阿坝藏族羌族自治州
Vong-kok Tshàm(MOK)	旺角站
Welkom	韋爾科姆
Vú-mîn-yen	武鸣区
Hoedspruit	胡德斯普雷特
Lìm-ôn-sṳ	临安市
Hói-tsû-khî	海珠区
Ye̍t-siù-khî	越秀区
Vryheid	弗萊海德
Swellendam	斯韋倫丹
Kwun-lò-sṳ	汨罗市
Vòng-pu-khî	黄埔区
Nàm-hói-khî	南海区
Sin-nî-sṳ	信宜市
Lùng-ôn-yen	隆安县
Tû-kông-yén-sṳ	都江堰市
Mâ-sân-yen	马山县
Sîn-fi-khî	新会区
Tshiùng-fa-sṳ	从化区
Lièn-sân Chong-chhu̍k Yâu-chhu̍k Chhṳ-chhṳ-yen	连山壮族瑶族自治县
Lo̍k-tshông-sṳ	乐昌市
Lièn-chiu-sṳ	连州市
Kô-yêu-sṳ	高要市
Fû-yûng-khî	芙蓉区
Hîn-nèn-sṳ	兴宁市
Ho̍k-sân-sṳ	鹤山市
Yòng-chhûn-sṳ	阳春市
Mo̍k-li̍t Tha̍t-ngá Tha̍t-vat-ngì-tshu̍k Tshṳ-tshṳ-khì	莫力达瓦达斡尔族自治旗
Thùng-ôn-khî	同安区
Liu̍k-fûng-sṳ	陆丰市
Thòi-kông-khî	台江区
Liùng-hói-sṳ	龙海市
Sa̍k-sṳ̂-sṳ	石狮市
Siông-ôn-khî	翔安区
Mên-hêu-yen	闽侯县
Lìm-siong-sṳ	临湘市
Liù-yòng-sṳ	浏阳市
Lói-yòng-sṳ	耒阳市
Tsàu-vú-sṳ	邵武市
Hói-shù-khî	海曙区
Sa-fi Mìn-tsú Lièn-sien	社會民主連線
Kien-tet-sṳ	建德市
Phî-yen	郫县
Sîn-tû-khî	新都区
Phìn-siông-sṳ	凭祥市
Nî-chiu-sṳ	宜州市
Tshîn-hói-khî	澄海区
Yîn-tet-sṳ	英德市
Sṳ̍p-fong-sṳ	什邡市
Vi	胃
Tsìn-kông-sṳ	晋江 (河流)
Tshông-sân-khî	仓山区
Chhông-ǹg-yen	苍梧县
Liùng-hâ	海螯蝦
Pak-van-mí	百万米
Kî-nok-tshu̍k	基诺族
Chhém-hâi-sṳ	岑溪市
Ngo̍k-lùn-tshùn-tshu̍k	鄂伦春族
Chhà-lîn-yen	茶陵县
Shèn-sàng-khî	禅城区
Chhòng-sâ-yen	长沙县
Tshòng-thai-yen	长泰县
Tshòng-tin-yen	长汀县
Chhòng-chû-khî	长洲区
Tshèu-ôn-yen	潮安区
Chaudière-Appalaches	肖迪耶-阿帕拉什
Sî-Chû	西周
Liông (Nàm-chhèu)	梁 (南朝)
Sṳ̀n-Hòn	成汉
Sàng-phu Mèu-chhu̍k Chhṳ-chhṳ-yen	城步苗族自治县
Sàng-siong-khî	城厢区
Tshak-kham-khî	赤坎区
Sî-Hon	西汉
Chhùng-chû-sṳ	崇州市
Hói-nàm-tó	海南岛
Christiana (Nàm-fî)	克里斯蒂安娜 (西北省)
Sùn-ôn-yen	淳安县
Lí-sàng-khî	鲤城区
Thaai-phin-cang-ziu	祈安醮
Pet-ngan Thi-khî (Québec)	北岸 (魁北克省)
Mí-nàm-kâ-pó-ngìn	米南佳保人
Tshṳ̀-song-hiông	池上鄉
Néu-yok-kóng	紐約港
Sî-Chìn	西晋
Tha̍k-é	笛子
Tûng-Hon	东汉
Kiet-chhu̍k	羯
Su-nèn-yen	寿宁县
Sâ-vân-khî	沙湾区
Thûng-chhôn-khî	通川区
Sṳ-chûng-khî (Lo̍k-Sân-sṳ)	市中区 (乐山市)
Mâ-piên Yì-chhu̍k Chhṳ-chhṳ-yen	马边彝族自治县
Thai-song-ló-kiûn	道德天尊
Thai-phû-yen	大埔县
Thai-fa Yâu-chhu̍k Chhṳ-chhṳ-yen	大化瑶族自治县
Tân-yit kón-lî-khî	單一管理區
Kú-thièn-yen	古田县
Tet-pó-yen	德保县
Tet-fa-yen	德化县
Sîn-fa-tsṳ́n	新化區
Kûan-meu-hiông	關廟區
Hiông-kóng Thit-sṳ-nì Lo̍k-yèn Thu-ká-khî	香港迪士尼樂園度假區
Ńg-kuk	五谷
Tet-khin-yen	德庆县
Tí-chhu̍k	氐
Fi-sàng-khî	惠城区
Chiáng-ngân-yen	井研县
Fài-si̍p-yen	怀集县
Khien-vì-yen	犍为县
Ńg-thûng-khiàu-khî	五通桥区
Kông-hói-khî	江海区
Khì-yen	渠县
Sun-khin-khî	顺庆区
Kô-phiàng-khî	高坪区
Mu̍k-chhôn-yen	沐川县
Liú-pet-khî	柳北区
Liú-nàm-khî	柳南区
Kông-nàm-khî (Nàm-nèn-sṳ)	江南區
Thien-pha̍k-yen	电白区
Sông-lìm-yen	上林县
Thâm-thòng-khî	覃塘区
Mòi-yen	梅县区
Chṳ̂-yòng-khî	资阳区
Sâm-kông Thûng-chhu̍k Chhṳ-chhṳ-yen	三江侗族自治县
Na̍p-hâi-khî	纳溪区
Mièn-chuk-sṳ	绵竹市
Lièn-sàng-yen	连城县
Kô-chiu-sṳ	高州市
Khiûng-lôi-sṳ	邛崃市
Si-fi-sṳ	四会市
Ngièu-phìn-yen	饶平县
Lùi-chiu-sṳ	雷州市
Sun-tshông-yen	顺昌县
Lò-ngièn-yen	罗源县
Phîn-nàm-yen	屏南县
Phìn-thâm-yen	平潭县
Nàm-ôn-sṳ	南安市
Àu-choi Fôn	凹嘴鸛
Thia̍p-chhái-khî	叠彩区
Ya̍k-sân-khî	蝶山区
Tín-sàng-khî	鼎城区
Tín-fù-khî	鼎湖区
Chhîn-sàng-khî	清城区
Tûng-khî (Pan-kî-fâ-sṳ)	东区 (攀枝花市)
Tûng-hîn-sṳ	东兴市
Tûng-ngièn-yen	东源县
Kî-chhòng	機場
Téu-mùn-khî	斗门区
Liu̍k-chhôn-yen	陆川县
Tû-ôn Yâu-chhu̍k Chhṳ-chhṳ-yen	都安瑶族自治县
Tôn-chiu-khî	端州区
Tsen-zi-wun	千字文
Ha̍p-phû-yen	合浦县
Lî Ngâ-kok	理雅各
Yen	县级行政区
Lò-kông-yen	罗江县
Yún-thin-yen	永定
Thèn-yen	藤县
Thi-fông Kau-fi	召會
Ngiù-Chhâ-Súi	牛車水
Nàm-Yèn	南燕 (十六國)
Nàm-Liòng	南凉
Fûng-sun-yen	丰顺县
Siong-sân-yen	象山县
Ngiûn-chû-khî	鄞州区
Kông-pet-khî (Nèn-pô-sṳ)	江北区 (宁波市)
Nèn-hói-yen (Chet-kông-sén)	宁海县 (浙江省)
Kông-kòn-khî	江干区
Ngò-mì-sân-sṳ	峨眉山市
Siù-yí-khî	秀屿区
Yún-tshûn-yen	永春县
Chàu-yòng-yen	邵阳县
Sa̍k-kú-khî	石鼓区
Tsiau-sàng-khî	蕉城区
Sien-yù-yen	仙游县
Fên-sân-yen	衡山县
Yèn-phìn-khî	延平区
Sîn-lò-khî	新罗区
Phú-sàng-yen	浦城县
Sâm-ngièn-khî	三元区
Ngièn-fung-khî	雁峰区
Hâm-kông-khî	涵江区
Fûng-tshe̍t-khî	丰泽区
Lai-sàng-khî	荔城区
Sông-hông-yen	上杭县
Tshiùng-hâi-yen	松溪县
Fên-nàm-yen	衡南县
Vú-phìn-yen	武平县
Fên-tûng-yen	衡东县
Nàm-tshìn-yen	南靖县
Khî-tûng-yen	祁东县
Lù-siung-khî	芦淞区
Kâ-vò-yen	嘉禾县
Sû-sien-khî	苏仙区
Thâu-ngièn-yen	桃源县
Liùng-fù-khî	龙湖区
Sông-chhṳ̍t-yen	桑植县
Het-sân-khî	赫山区
Kông-sàng-khî	江城区
Phûng-kông-khî	蓬江区
Yòng-sî-yen	阳西县
Hon-su-yen	汉寿县
Sa̍k-mùn-yen	石门县
Lìm-lí-yen	临澧县
Lìm-vú-yen	临武县
Kui-yòng-yen	桂阳县
Yòng-tûng-yen	阳东区
Hiông-chû-khî	香洲区
Liùng-mâ-thâm-khî	龙马潭区
Ngiùn-hói-khî	银海区
Vú-siên-yen	武宣县
Kóng-nàm-khî (Kui-kóng-sṳ)	港南區 (廣西)
Yùng-yen (Chhṳ-kung-sṳ)	荣县
Meu-kóng-khî	茂港区
Kîm-phìn-khî	金平区
Yùng-yen	容县
Lû-yen	泸县
Siong-sân-khî	象山区
Chin-yòng-khî	旌阳区
Ket-sî-yen	揭西县
Siù-fûng-khî	秀峰区
Thièn-yòng-yen	田阳县
Chhìn-sî-yen	靖西县
Yún-fuk-yen	永福县
Thièn-tûng-yen	田东县
Kiûng-sàng Yâu-chhu̍k Chhṳ-chhṳ-yen	恭城瑶族自治县
Kung-chiáng-khî	贡井区
Mòi-kông-khî	梅江区
Hîn-pîn-khî	兴宾区
Siong-khiâu-khî	湘桥区
Hîn-ngia̍p-yen	兴业县
Kú-nìn-yen	古蔺县
Lìn-yùn-yen	凌云县
Lò-sàng Mu-láu-chhu̍k Chhṳ-chhṳ-yen	罗城仫佬族自治县
Yàm-piên-yen	盐边县
Lìm-kui-yen	临桂区
Ket-tûng-yen	揭东区
Sî-khî (Pan-kî-fâ-sṳ)	西区 (攀枝花市)
Kon-yòng-yen	灌阳县
Kîm-sàng-kông-khî	金城江区
Kóng-héu-khî	港口区
Phû-pet-yen	浦北县
Ngiu̍k-chiu-khî	玉州区
Yùng-ôn-yen	融安县
Lìn-chhôn-yen	灵川县
Chhiòn-chiu-yen	全州县
Van-siu-khî	万秀区
Khîm-pet-khî	钦北区
Sîn-fûng-yen	新丰县
Fò-phìn-yen	和平县
Sé-kiok-lî	洗腳禮
Kîm-vân-khî	金湾区
Ngìn-kûng Hi-kôn	人工器官
Liùng-sṳn-kok-chhu̍k Chhṳ-chhṳ-yen	龙胜各族自治县
Sîn-sàng-yen	忻城县
Thiet-sân-kóng-khî	铁山港区
Siong-chiu-yen	象州县
Kîm-siu Yâu-chhu̍k Chhṳ-chhṳ-yen	金秀瑶族自治县
Lùng-lìn Kok-chhu̍k Chhṳ-chhṳ-yen	隆林各族自治县
Chhiâng-siù-khî	青秀区
Chhit-sên-khî	七星区
Thièn-lìm-yen	田林县
Liòng-khin-khî	良庆区
Phìn-nàm-yen	平南县
Hói-sàng-khî	海城区
Phìn-kó-yen	平果县
Yung-nèn-khî	邕宁区
Fòng-sàng-khî	防城区
Sông-sṳ̂-yen	上思县
Lìn-sân-yen	灵山县
Lu̍k-tshài-yen	鹿寨县
Hîn-ôn-yen	兴安县
Phû-kông-yen	蒲江县
Kîm-thòng-yen	金堂县
Vûn-kông-khî	温江区
Phìn-yén-yen	平远县
Hói-fûng-yen	海丰县
Lièn-nàm Yâu-chhu̍k Chhṳ-chhṳ-yen	连南瑶族自治县
Liùng-tshôn-yen	龙川县
Liu̍k-hò-yen	陆河县
Vú-hêu-khî	武侯区
Liùng-chhièn-yi̍t-khî	龙泉驿区
Chiau-liang-yen	蕉岭县
Kông-chiu-khî	江州区
Yu-kông-khî	右江区
Ha̍p-sân-sṳ	合山市
Kîm-ngiù-khî	金牛区
Kím-kông-khî	锦江区
Phàng-chû-sṳ	彭州市
Kông-tûng-khî (Nèn-pô-sṳ)	江东区 (宁波市)
Hâ-sàng-khî	下城区
Kiúng-shú-khî	拱墅区
Yì-hông-khî	余杭区
Sông-sàng-khî	上城区
Lo̍k-ngia̍p-yen	乐业县
Sân-sî Sṳ-sa	山西市社
Chûng-koet Ngò-lò-sṳ̂-tshu̍k	中国俄罗斯族
Windsor lâu Maidenhead	溫莎-梅登黑德
Â-ha̍p-sùi-lû-vòng	亞哈隨魯
Mà-tsông-khî	麻章区
Ńg-fà-yen	五华县
Súi-hâi-yen	遂溪县
Sui-nèn-yen	绥宁县
Tshî-vùn-yen	徐闻县
Fuk-ôn-sṳ	福安市
Nàm-àu-yen	南澳县
Tsung Kâ-Hiûn	鍾嘉欣
Chîn-sṳ-sṳ	津市市
Liâm-kông-sṳ	廉江市
Mên-tshîn-yen	闽清县
Hâ-sân-khî	霞山区
Vung-ngièn-yen	翁源县
Fa-chiu-sṳ	化州市
Kien-eu-sṳ	建瓯市
Mâ-mî-khî	马尾区
Yún-thai-yen	永泰县
Nèn-hiông-yen	宁乡县
Liùng-vùn-khî	龙文区
Sṳ-mìn-khî	思明区
Yí-fâ-khî	雨花区
Ngiên-kông-sṳ	沅江市
Fi-tûng-yen	惠东县
Siong-thâm-yen	湘潭县
Phìn-fò-yen	平和县
Thai-nèn-yen	泰宁县
Kông-tshe̍t-yen	光泽县
Yún-ôn-sṳ	永安市
Thí-ngoi Mo̍k-yòng-ha̍p	體外膜氧合
Lìm Tan	林丹
分類:Tet-koet	Category:德国
分類:Yi-thai-li	Category:意大利
分類:Kâ-nâ-thai	Category:加拿大
分類:Sî-pân-ngà	Category:西班牙
分類:Chûng-koet	Category:中国
分類:Ngi̍t-pún	Category:日本
分類:Àu-thai-li-â	Category:澳大利亚
分類:Yin-thu	Category:印度
分類:Yî-set-lie̍t	Category:以色列
分類:Nàm-fî	Category:南非
Koet-li̍p Thòi-vân Thai-ho̍k Yî-ho̍k-yèn Fu-sat Yî-yèn	國立臺灣大學醫學院附設醫院
Thiên-sái (Hiông-kóng)	天璽 (香港)
Redcar and Cleveland	雷德卡-克利夫兰
分類:Yin-thu-nì-sî-â	Category:印尼
分類:Pâ-kî-sṳ̂-thán	Category:巴基斯坦
分類:Pô-làn	Category:波蘭
分類:Sîn-kâ-po	Category:新加坡
分類:Hòn-koet	Category:大韓民國
分類:Thai-koet	Category:泰國
分類:Ye̍t-nàm	Category:越南
分類:Phú-nen-lui	Category:哺乳類
分類:Tiâu	Category:鸟类
分類:Chhṳ̍t-vu̍t	Category:植物
分類:Vu̍t-lí-ho̍k	Category:物理学
分類:Chhṳ-yèn Khô-ho̍k	Category:自然科学
分類:Sâng-vu̍t-ho̍k	Category:生物学
分類:Fa-ho̍k	Category:化学
分類:Li̍t-sṳ́	Category:历史
分類:Thi-lî	Category:地理
分類:Sa-fi	Category:社会
分類:Chûng-kau	Category:宗教
分類:Thí-yuk	Category:体育
分類:Khô-ho̍k	Category:科学
分類:Lièn-ha̍p-koet	Category:联合国
分類:Êu-chû Lièn-mèn	Category:欧盟
分類:Kien-chuk-vu̍t	Category:建築物
分類:Thûng-sin	Category:通信
分類:Thi-khiù	Category:地球
Chhièn-Chhîn	前秦
Chhièn-Yèn	前燕
Sî Berkshire	西伯克郡
Hiông-kóng Thiet-lu Yû-han Kûng-sṳ̂	港鐵公司
Thai-mo-sân	大帽山
Heu-Yèn	後燕
Pet-Liòng	北凉
Chhièn-Chhàu	汉赵
Zuera	苏埃拉
Langa del Castillo	兰加德尔卡斯蒂略
Contamina	孔塔米纳
Louis Trichardt	路易特里哈特
Abiego	阿维耶戈
Abanto	阿万托
Sî-Chhîn	西秦
Song-Súi Tshàm(Hiông-Kóng Tûng-Thiet-Sien)	上水站 (香港)
Fó-than-chham	火炭站
Tson-sa̍k-sân Tshàm	鑽石山站
Yî-lien-chióng	儒莲奖
Heu-Chhîn	后秦
Kú Lò-mâ	古罗马
La Fueva	拉富埃瓦
Tsui-heu ke Sṳ́m-phan	最后的审判
Song-yâu-tshûn	上窰村
Greenwich Thai-ho̍k	格林威治大學
Middelburg, Mpumalanga-sén	米德爾堡 (普馬蘭加省)
Sat-mû-ngí-ki-song	撒母耳記上
分類:Chet-ho̍k	Category:哲学
分類:Fu̍t-kau	Category:佛教
分類:Kî-tuk-kau	Category:基督教
分類:Yù-thai-kau	Category:犹太教
Ventersdorp	芬特斯多普
Pet-Yèn	北燕
Sià-ok Sṳn-kîn	邪恶圣经
Kôn-thòng Chhàm(KWT)	觀塘站
Ên-tiâu	鵰
Kiú-liùng Chhàm (Hiông-kóng)	九龍站 (香港)
Yî-kín-vân	愉景灣
Ngùi Pó-lò	魏保羅
Heu-Liòng	后凉
Heu-Chhàu	后赵
Hò-sṳ̂n	毫升
Trompsburg	特龍普斯堡
Zung-kok tsen-thung zit-nit	中華傳統節日
Chong Pâ-nâ-pâ	张巴拿巴
香港客家話	香港客家語
Ngi̍t-pún Khûn-chhùng Ki	日本昆蟲記
Chiông-Kiûn-Àu	將軍澳
Chûng-koet Ngî-ngièn	汉语方言
Bothaville	博塔維爾
Theunissen	托伊尼森
琴浦同學	琴浦小姐
Fung-fông-sân (Hiông-kóng)	鳳凰山 (香港)
分類:Hàng-sên	Category:行星
分類:Vùn-fa	Category:文化
分類:Ngìn-vùn Khô-ho̍k	Category:人文科學
分類:Tî-sṳt	Category:知識
Nàm-tshông Thiet-lu Tshàm（Hiông-kóng）	南昌站 (香港)
Hiông-kóng Sṳp-thi Kûng-yèn	香港濕地公園
Sàng-sṳ Fûng-sû Kau-fi	城市豐收教會
Ngiù-yèn	牛肉丸
Sîn-kie-tûng	新界東
Kiú-liùng-sî	九龍西
Kiú-liùng-tûng	九龍東
Chṳ́-set	紫色
Hòn Sân-mìn	韩山明
Phiàng-fa-sṳ	平話字
Ngiu̍k-sân Koet-kâ Kûng-yèn	玉山國家公園
Thai-phìn-thiên-koet	太平天国
Yû-nyî-shì	有虞氏
Ap-è	鸭
Fuk-kian-fa	福建方言
Kâm Vì-lîm	甘為霖
分類:Yên-yèn	Category:演员
汪明欣	汪明欣
模板:Tl	Template:Tl
模板:Userbox	Template:Userbox
Thòi-sâm-sien	台3線
Thòi-vân tû-fi khî	臺灣都會區
蛤塘	蛤塘
Vùn-kím-thu	文錦渡
Thòi-chûng tû-fi khî	臺中彰化都會區
Thòi-11-sien	台11線
Pha̍k-fa-sṳ	客語白話字
Hiu Hen-ngì	邱幸儀
Pak-thòng-chṳ́n	柏塘镇
Nèn-pô-fa	寧波話
Kâ-ngi chhṳ tû-fi khî	嘉義都會區
Sòn-Vân-káu-yâ kûng-yèn	船灣郊野公園
Liû Seu-Hî	劉劭希
Hen-Fâ-tshûn	杏花邨
Kûng-pín	公秉
Chhôn-Liùng (Hiông-kóng)	川龍
Li-kó-teu	荔枝窩
Thò-yèn tû-fi khî	桃園中壢都會區
Thòi-si-sien	台4線
Thòi-64-sien	台64線
Hò-song-hiông	河上鄉
Thòi-18-sien	台18線
Sîn Tshóng-tsho Kau-fi	新造教會
Â-kô	兄
Tseui-tin-faat-ngin Chung-faa-min-gok gen-gok it-paak-nen gi-gim-fui	中華民國建國一百年慶祝活動籌備委員會
Yâ-sû Kâ-thìn	耶稣家庭
Kóng-thiet CRC-Stock EMU（Bombardier MOVIA C6554-07E） tshâ-hin Lie̍t-tshâ	港鐵北車長客電動列車 (直流電)
Thòi-16-sien	台16線
Mâ Ngâ-kok	馬雅各
Só-lò-phùn	鎖羅盆
Lûi-chhâ	擂茶
Thòi-ńg-sien	台5線
Sîn-tsuk chhṳ tû-fi khî	新竹都會區
Maria Cordero	瑪俐亞
Lu̍k-Kiáng	鹿頸
Thòi-21-sien	台21線
Thòi-chû-fa	台州话
Sîn-kie-sî	新界西
模板:Wikipedialang	Template:Wikipedialang
分類:Koet-kâ	Category:国家
Wikipedia:Kón-lî-yèn	Wikipedia:管理员
分類:Chûng-fà Mìn-chhu̍k	Category:中华民族
分類:Ngìn-vu̍t	Category:人物
分類:Mìn-chhu̍k	Category:族群
Wikipedia:Hàng-tsṳn-yèn	Wikipedia:行政员
Wikipedia:IP chhà-fûng li-ngoi-chá	Wikipedia:IP封禁例外
Wikipedia:Kî-hi-ngìn	Wikipedia:机器人
分類:Sṳ̀-kiên	Category:时间
分類:Chhṳ-yèn	Category:自然
分類:Kûng-chhàng	Category:工程學
分類:Yî-ho̍k	Category:医学
分類:Chṳn-chṳ	Category:政治
分類:Kau-yuk	Category:教育
分類:Kông-ho̍k	Category:光學
Âi-khi̍p	埃及
分類:Chat-ho̍k-kâ	Category:哲学家
模板:Bot	Template:Bot
Kâ-nâ-thai	加拿大
分類:Hiûng-ngà-li	Category:匈牙利
分類:Hî-lia̍p	Category:希腊
分類:Lâ-thot-vì-â	Category:拉脫維亞
分類:Yù-hi	Category:游戏
Thiên-koet	天國
Zong Thaai-pheng	張大鵬
Phi Chhṳ-vùn	裨治文
分類:Êu-chû koet-kâ	Category:欧洲国家
分類:Êu-chû	Category:欧洲
模板:Documentation	Template:Documentation
Wikipedia:Yung-fu	Wikipedia:用户权限级别
Pok-sṳ	博士
Wikipedia:Sa-khî	Wikipedia:社群首页
分類:Wikipedians by language	Category:用户语言
Sṳ̀n Chhai-kî	成在基
Khi-néu Kî-chhòng	樞紐機場
Khî-ngia̍p	企业
Ngiuk-yèn	肉丸
Vò-yông-sân	禾秧山
模板:Softredirect	Template:軟重定向
模板:Delete	Template:Delete
分類:Kî-su̍t	Category:技术
分類:Ngî-ngièn	Category:语言
Wikipedia:Chhóng-kien Sîn Thiàu-muk	Help:创建新条目
分類:還無索引嘅頁面	Category:不可索引页面
分類:含有損壞文件鏈接嘅頁面	Category:缺少文件的页面
模板:Navbox	Template:Navbox
Thoi-chhú	袋鼠
Chùng-ha̍p Kô-kip Chûng-ho̍k	綜合型高級中學
Pak-ha̍p-fâ	百合属
Ma̍k Kâ-thì	麦嘉缔
Yîn-koet Chóng-ló-fi Chhâi-fi	英国长老会差会
模板:!-	Template:!-
模板:Tnavbar	Template:Navbar
模板:Unicode	Template:Unicode
模板:Smallcaps	Template:Smallcaps
模板:Small	Template:Small
模板:Nowrap	Template:Nowrap
分類:Fî-chû	Category:非洲
分類:Chhṳ-yù Pâng-sén	Category:自由邦 (南非)
分類:Gauteng-sén	Category:豪登省
分類:KwaZulu-Natal-sén	Category:夸祖魯-納塔爾省
分類:Mpumalanga-sén	Category:普马兰加省
分類:Pet Khôi-phú-sén	Category:北开普省
分類:Sṳn-kîn	Category:圣经
分類:Limpopo-sén	Category:林波波省
分類:Sî Khôi-phú-sén	Category:西開普省
分類:Sî-pet-sén	Category:西北省 (南非)
分類:Si	Category:書籍
模板:Pâ-phe̍t	Template:Babel
模板:Reflist	Template:Reflist
模板:Stub	Template:Stub
模板:User ca-1	Template:User ca-1
模板:User de	Template:User de
模板:User de-1	Template:User de-1
模板:User en-3	Template:User en-3
模板:User en-1	Template:User en-1
模板:User en-2	Template:User en-2
模板:User en-4	Template:User en-4
模板:User en-0	Template:User en-0
模板:User en	Template:User en
模板:User de-2	Template:User de-2
分類:Yî-chhiu	Category:宇宙
模板:User fr-2	Template:User fr-2
模板:User ja-1	Template:User ja-1
模板:User fr	Template:User fr
模板:Location map/Info	Template:Location map/Info
分類:Khûn-chhùng	Category:昆蟲綱
分類:Â-chû	Category:亚洲
分類:Chṳ-li	Category:智利
分類:Nàm-mî-chû	Category:南美洲
模板:Esoteric	Template:Esoteric
分類:Mâ-lòi-sî-â	Category:马来西亚
分類:Sṳ̍t-phín	Category:食品
模板:Mod	Template:Mod
模板:SIL	Template:SIL
模板:User es-2	Template:User es-2
模板:Fôn-ngiàng	Template:Welcome
分類:Thiàu-mi-liau	Category:調味料
分類:Chû-chṳt	Category:组织
分類:Ngî-ngièn-ho̍k	Category:语言学
模板:ITA	Template:ITA
模板:非洲行政區劃	Template:Africa
模板:SVK	Template:SVK
模板:Infobox Country	Template:國家基礎資訊
模板:Documentation/docname	Template:Documentation/docname
模板:TUR	Template:TUR
分類:User en-4	Category:En-4 使用者
分類:User en	Category:En 使用者
分類:User zh	Category:Zh 使用者
分類:User zh-N	Category:Zh 母语使用者
分類:User en-2	Category:En-2 使用者
模板:User zh	Template:User zh
模板:Documentation/start box	Template:Documentation/start box
模板:Cite web	Template:Cite web
Haak-gaa-saan-goh	客家山歌
模板:Ombox	Template:Ombox
分類:Hòng-khûng	Category:航空
模板:Country data	Template:Country data
分類:Yím-sṳ̍t	Category:飲食
模板:Fong-wui	Template:方位
模板:BS3	Template:BS3
分類:Tsúng-thúng	Category:总统
模板:IPA	Template:IPA
分類:Chṳn-chṳ Ngìn-lui	Category:政治人物
分類:Mî-chû	Category:美洲
模板:其他	Template:Otheruses
模板:User language-N	Template:User language-N
模板:Imbox	Template:Imbox
Wikipedia:GNU自由文檔協議證書	Wikipedia:GNU自由文档许可证文本
模板:Topicon	Template:Topicon
模板:Fmbox	Template:Fmbox
模板:大洋洲行政區劃	Template:Oceania
分類:Vùn-ho̍k-kâ	Category:作家
分類:Kiûn-sṳ	Category:军事
分類:Thai-ho̍k	Category:大学
模板:Country data Malaysia	Template:Country data Malaysia
模板:Lang-he	Template:Lang-he
模板:Both	Template:Both
分類:Sṳ-kie Pok-lám-fi	Category:世界博覽會
分類:Chûng-fà Ngìn-mìn Khiung-fò-koet Chú-sit	Category:中华人民共和国主席
模板:Documentation subpage	Template:Documentation subpage
分類:Fu̍k-tsông	Category:佛教出家眾
模板:FIN	Template:FIN
模板:Purge	Template:Purge
模板:Lang-de	Template:Lang-de
模板:DNK	Template:DNK
模板:Provinces of China	Template:中华人民共和国省级行政区
模板:Userpage	Template:Userpage
模板:DEU	Template:DEU
模板:SWE	Template:SWE
模板:User language-4	Template:User language-4
分類:Ye̍t-nàm kî-chhòng	Category:越南機場
Kiet-tshòng	结肠
分類:Kûng-sṳ̂	Category:公司
模板:User fr-3	Template:User fr-3
模板:Allcaps	Template:Allcaps
模板:JPN	Template:JPN
分類:Thien-nó	Category:電腦
模板:MKD	Template:MKD
模板:LTU	Template:LTU
分類:Sṳ-chhòng	Category:市場
Mô-li-ngìn	毛利人
模板:Disambig	Template:Disambig
模板:Tick	Template:Tick
分類:Khien-không Khô-ho̍k	Category:健康科學
模板:Smallcaps all	Template:Smallcaps all
分類:Hàng-thung Thien-fa	Category:行動電話
模板:User nan	Template:User nan
模板:User nan-1	Template:User nan-1
模板:GRC	Template:GRC
模板:Lang-grc	Template:Lang-grc
模板:CZE	Template:CZE
模板:Lifetime	Template:BD
模板:Lang-en	Template:Lang-en
分類:Chhòn-ngiam-phiang	Category:传染病
分類:Sîn-kau	Category:基督教新教
模板:GBR	Template:GBR
分類:Sâng-vu̍t	Category:生物
模板:SVN	Template:SVN
模板:FRA	Template:FRA
模板:Hiông-kóng Hàng-tsṳn Khî-va̍k	Template:香港十八區
模板:User pt-2	Template:User pt-2
模板:歐洲行政區劃	Template:Europe
分類:User yue	Category:Zh-yue 使用者
分類:User fr	Category:Fr 使用者
分類:User ja	Category:Ja 使用者
分類:User pt	Category:Pt 使用者
分類:User nl-3	Category:Nl-3 使用者
分類:User fr-2	Category:Fr-2 使用者
分類:User ja-2	Category:Ja-2 使用者
分類:User ko-N	Category:Ko 母語使用者
分類:User fr-N	Category:Fr 母語使用者
分類:Vùn-sṳ	Category:文字
分類:Tho-kau	Category:道教
分類:User ca	Category:Ca 使用者
分類:User ca-1	Category:Ca-1 使用者
分類:User de	Category:De 使用者
分類:User de-2	Category:De-2 使用者
分類:User de-N	Category:De 母語使用者
分類:User en-3	Category:En-3 使用者
分類:User en-N	Category:En 母语使用者
分類:User es	Category:Es 使用者
分類:User es-2	Category:Es-2 使用者
分類:User es-N	Category:Es 母语使用者
分類:Hiông-kóng Thi-lî	Category:香港地理
模板:Lang-lv	Template:Lang-lv
分類:Yî-set-lie̍t kiûn-vòng	Category:以色列君王
分類:Yù-thai kiûn-vòng	Category:猶大君王
Fî-ngô-sân (Hiông-kóng)	飛鵝山
分類:Kí-hò-ho̍k	Category:几何学
模板:Ye̍t-nàm	Template:越南一级行政区
分類:User ja-1	Category:Ja-1 使用者
分類:User ko	Category:Ko 使用者
Hà-mà	蟾蜍
模板:Lang-vi	Template:Lang-vi
分類:Thiên-hi	Category:天氣
河婆街道	河婆街道
分類:Lièn-ha̍p-koet Pi-sû-chóng	Category:联合国秘书长
分類:Hói-yòng	Category:海洋
模板:LUX	Template:LUX
分類:Thai-yòng-ne	Category:太阳系
分類:Chhîn-su̍k Ne-thúng	Category:家世與傳承
分類:Kóng-tûng-sén	Category:广东
分類:Fuk-kian	Category:福建
分類:Kîn-chi	Category:经济
分類:Koet-chi Chû-chṳt	Category:国际组织
分類:Fat-mìn-kâ	Category:發明家
分類:Yím-liau	Category:饮料
Sṳ̂-é-sân káu-yâ kûng-yèn (Hiông-kóng)	獅子山郊野公園
分類:User nan-1	Category:Nan-1 使用者
分類:User nan-2	Category:Nan-2 使用者
分類:User nan-3	Category:Nan-3 使用者
分類:User nan-N	Category:Nan 母语使用者
分類:Sa-fi Khô-ho̍k	Category:社会科学
分類:Mî-koet Koet-kâ Kûng-yèn	Category:美國國家公園
分類:Kô-tén Kau-yuk	Category:高等教育
模板:!w	Template:!w
分類:Thi-hìn	Category:地形
模板:User ja-2	Template:User ja-2
分類:Thiên-chú-kau	Category:天主教
分類:User yue-N	Category:Zh-yue 母语使用者
分類:Yîm-ngo̍k-kâ	Category:音乐家
模板:!((	Template:!((
模板:))!	Template:))!
模板:Lang	Template:Lang
分類:Fa-kâ	Category:画家
分類:Yin-thu chûng-kau	Category:印度宗教
分類:Ho̍k-su̍t	Category:学术
分類:Sa-fi chṳ-thu	Category:社會制度
Hiông-kóng Lìn-liòng-thòng	香港靈糧堂
羅香林	罗香林
模板:.w	Template:.w
Yòng-kông Kô-sîn Kî-su̍t Sán-ngia̍p Khôi-fat-khî	阳江高新技术产业开发区
Yâ-kiông-fâ chung	野薑花粽
分類:Ngìn-lui	Category:人类
Tsàu-ôn Hak-ngî	詔安客語
Sî-fù Kón-lî-khî	西湖管理区
Sî-thung-thìn Kón-lî-khî	西洞庭管理区
Shàu-khin Kô-sîn Kî-su̍t Sán-ngia̍p Khôi-fat-khî	肇庆高新技术产业开发区
模板:CYP	Template:CYP
分類:Yin-thu Thi-lî	Category:印度地理
分類:Sông-ngia̍p	Category:商業
Thòi-vân ho̍k-ló-ngìn	福佬
Hói-lîn-tó Kîn-chi Khôi-fat Sṳ-ngiam-khî	海陵岛经济开发试验区
Kau-fi Lò-mâ-sṳ	教會羅馬字
分類:Kiú-liùng	Category:九龍
模板:EST	Template:EST
Phiàng-fông kûng-fûn	平方分米
模板:Nocaps	Template:Nocaps
Kông-khièu Kón-lî-khî	岗侨管理区
模板:AUT	Template:AUT
Ńg-phô-sân (Hiông-kóng)	女婆山
Thòi-pat-sien	台8線
Thòi-liuk-sien	台6線
Thòi-24-sien	台24線
Thòi-22-sien	台22線
Thòi-20-sien	台20線
Thòi-15-sien	台15線
Thòi-14-sien	台14線
Thòi-13-sien	台13線
Thòi-12-sien	台12線
Thòi-sṳ̍p-sien	台10線
分類:Meu-khô	Category:貓科
Nui-vân-tshûn	內灣村 (橫山鄉)
Hiông-tho	乡道
分類:Kâ-le̍t-pí-hói	Category:加勒比海
分類:Thòi-vân Thi-lî	Category:台灣地理
模板:User zh-3	Template:User zh-3
模板:User zh-4	Template:User zh-4
Kuet-tho	国道
分類:Nì-pok Thi-lî	Category:尼泊爾地理
分類:Thai-khûng-ngìn	Category:宇航员
分類:Chûng-fà Mìn-tshu̍k Tshṳ-tshṳ-chû	Category:中国自治州
分類:Khî-ngia̍p-kâ	Category:企业家
分類:Fî-li̍t-pîn	Category:菲律宾
分類:User nl	Category:Nl 使用者
分類:User zh-1	Category:Zh-1 使用者
分類:User zh-4	Category:Zh-4 使用者
分類:User zh-3	Category:Zh-3 使用者
分類:User zh-2	Category:Zh-2 使用者
分類:Yin-thu kiûn-chú	Category:印度君主
分類:Â-chû Thien-sṳ Yû-han Kûng-sṳ	Category:亞洲電視
分類:Ho̍k-vi	Category:學位
分類:Pô-sṳ̂ koet-vòng	Category:波斯国王
分類:Kîm-yùng	Category:金融
分類:Chûng-fà mìn-koet tsúng-thúng	Category:中華民國總統
分類:Thien-sṳ	Category:电视
分類:Chhòn-kau-sṳ	Category:传教士
分類:Hói-hia̍p	Category:海峡
粵語	粤语
分類:Yin-Êu Ngî-ne	Category:印欧语系
分類:Kî-chhòng	Category:機場
分類:Fa-ho̍k ngièn-su	Category:化学元素
分類:Khô-ho̍k-kâ	Category:科学家
分類:Pâ-kî-sṳ̂-thán Thi-lî	Category:巴基斯坦地理
分類:Kî-tuk-kau lî-ngì	Category:基督教禮儀
分類:Nì-pok	Category:尼泊爾
分類:Thòi-vân	Category:台灣
分類:Chûng-koet chhèu-thoi	Category:中国朝代
分類:Nàm-Â koet-kâ	Category:南亚国家
分類:Pet-mî-chû koet-kâ	Category:北美洲國家
分類:Sṳ-tshòi	Category:蔬菜
分類:Súi-kó	Category:水果
分類:Khiu-yok Sṳn-kîn	Category:旧约圣经
分類:Pok-vu̍t-kón	Category:博物馆
分類:Hì-hèu	Category:氣候
分類:Â-chû Thi-lî	Category:亚洲地理
分類:Ngìn-lui-ho̍k	Category:人类学
分類:Thai-khûng Chhàm	Category:太空站
分類:Fap-koet Thai-ho̍k	Category:法國大學
模板:ESP	Template:ESP
分類:Thung-vu̍t	Category:动物
分類:Chit-chhûi Thung-vu̍t	Category:脊椎動物亞門
分類:Ngî-yîm-ho̍k	Category:語音學
分類:Hòng-khûng Kûng-sṳ̂	Category:航空公司
分類:Ngìn-khièn	Category:人權
Chuk-kô-vân	竹篙灣
分類:Mìn-tshu̍k	Category:民族
分類:Ngo̍k-hi	Category:乐器
分類:Ngî-ne	Category:語系
分類:Hon-sṳ	Category:汉字
分類:Pó-sa̍k	Category:宝石
分類:Koet-kâ Kûng-yèn	Category:國家公園
分類:Hi-siong-ho̍k	Category:气象学
分類:Chûng-mî-chû	Category:中美洲
分類:Fî-kîm-su̍k	Category:非金属
分類:Hiông-kóng	Category:香港
分類:Kóng-sî-sén	Category:广西
分類:Thòi-vân tû-fi khî	Category:台灣都會區
分類:Yên-liau	Category:燃料
分類:Sông-hói	Category:上海
分類:Sin-sit kî-su̍t	Category:信息技术
分類:Ngiuk-lui	Category:肉類
分類:Yo̍k-ho̍k	Category:藥學
分類:Sú-tû	Category:首都
分類:Nàm-Â	Category:南亚
分類:Kham-thap-pu-lî-â	Category:坎塔布里亚
分類:Â-sṳ̂-thù-lî-â-sṳ̂-sén	Category:阿斯圖里亞斯
分類:Kîm-su̍k	Category:金属
分類:Thòi-pet-sṳ	Category:台北市
Li̍p-fông Kûng-lî	立方千米
分類:Lò-màn Ngî-chhu̍k	Category:罗曼语族
分類:Kâu-thûng	Category:交通
分類:Ngiên-kiu	Category:研究
分類:Thông-lui	Category:糖类
分類:Fòng-ti	Category:皇帝
分類:Nàm-tó ngî-hì	Category:南島語系
分類:Pet-mî-chû	Category:北美洲
分類:Kô-sú	Category:歌手
分類:Si-chhòng	Category:藏区
分類:Sú-ho̍k-kâ	Category:数学家
分類:Vu̍t-lî ho̍k-kâ	Category:物理学家
分類:Kîn-chi ho̍k-kâ	Category:经济学家
Pak-van séu ho̍k-thòng	百萬小學堂
分類:Mìn-tsú	Category:民主
分類:Kî-tuk-kau Li̍t-sṳ́	Category:基督教历史
分類:Àu-mûn	Category:澳門
分類:Hàng-sên-ne	Category:行星系
Thòi-17-sien	台17線
Kiú-liùng Khiùn-sân	九龍群山
Tûng-hói-tó Kîn-tsi Khôi-fat Sṳ-ngiam-khî	东海岛经济开发试验区
分類:Hiông-kóng pan-tó	Category:香港島嶼
分類:Thòi-vân ngî-ngièn	Category:台灣語言
分類:Thòi-vân Koet-kâ Kûng-yèn	Category:台灣國家公園
分類:Khiù-lui Yun-thung	Category:球類運動
分類:Ngiùn-hòng	Category:銀行
Fu̍k-vu	服务
分類:Chûng-fà Ngìn-mìn Khiung-fò-koet	Category:中华人民共和国
分類:Kâ-thai-lò-nì-â	Category:加泰罗尼亚
Kap-kut-vùn	甲骨文
分類:Khien-không	Category:健康
模板:Lang-pl	Template:Lang-pl
Trojany	特洛疆尼
分類:Pâ-pí-lùn-ngìn	Category:巴比倫人
Yîn-fà Sû-yen	英華書院
分類:Â-chû koet-kâ	Category:亚洲国家
分類:Mî-chû koet-kâ	Category:美洲国家
分類:Yùn-lìm-yen	Category:雲林縣
分類:Ngièn-lóng-khî	Category:元朗區
分類:Ngì-làn-yen	Category:宜蘭縣
分類:Yù-tsiâm-vong-khî	Category:油尖旺區
分類:Vòng-thai-siên-khî	Category:黃大仙區
模板:Chûng-fà Mìn-chhu̍k	Template:中华民族
模板:User nan-2	Template:User nan-2
模板:User cdo	Template:User cdo
模板:MLT	Template:MLT
模板:User zh-classical-2	Template:User zh-wenyan-2
分類:Vân-chái-khî	Category:灣仔區
分類:Hak-kâ	Category:客家
分類:Kûng-yèn	Category:公園
分類:Thòi-vân Ngiùn-hòng	Category:臺灣的銀行
分類:Chûng-sî-khî (Hiông-kóng)	Category:中西區 (香港)
分類:Kâ-ngi-yen	Category:嘉義縣
分類:Sùn-fàn Hì-thúng	Category:循環系統
分類:Tûng-khî (Hiông-kóng)	Category:東區 (香港)
分類:Thòi-vân ngièn-tshu-mìn ngî-ngièn	Category:台灣原住民語言
分類:Nàm-Â Thi-lî	Category:南亚地理
分類:Si-chhòng Thi-lî	Category:藏区地理
分類:Hak-kâ Vùn-fa	Category:客家文化
分類:Hak-kâ-ngî	Category:客家語
模板:Lts	Template:Lts
分類:Hiông-kóng-tó	Category:香港島
分類:Sîn-tsuk-yen	Category:新竹縣
分類:Fâ-lièn-yen	Category:花蓮縣
分類:Nui-mùng-kú Tshṳ-tshṳ-khî	Category:内蒙古
分類:Koet-tsi kîn-tsi tsû-tsṳt	Category:国际经济组织
分類:Lì-tó-khî	Category:離島區
分類:Kî-lùng-sṳ	Category:基隆市
分類:Kiú-liùng-sàng-khî	Category:九龍城區
分類:Khwûi-tshiâng-khî	Category:葵青區
分類:Kôn-thòng-khî	Category:觀塘區
分類:Lâ-tên Mî-chû	Category:拉丁美洲
分類:Chúng-chhu̍k	Category:种族
分類:Mèu-li̍t-yen	Category:苗栗縣
分類:Mîn-ngî	Category:閩語
分類:Hiông-kóng Sân-Fûng	Category:香港山峰
分類:Chûng-fà Mìn-koet	Category:中華民國
分類:Nàm-thèu-yen	Category:南投縣
分類:Sîn-kie	Category:新界
分類:Pet-khî (Hiông-kóng)	Category:北區 (香港)
分類:Sî-kung-khî	Category:西貢區
分類:Sâ-thièn-khî	Category:沙田區
分類:Siak-khiet-kau	Category:锡克教
分類:Sa-fi Mìn-tsú Tsú-ngi	Category:社會民主主義
分類:Phìn-tûng-yen	Category:屏東縣
模板:BEL	Template:BEL
分類:Nàm-khî (Hiông-kóng)	Category:南區 (香港)
分類:Kú-thoi chhu̍k-khiùn	Category:古代族群
分類:Pâ-set-lò-nâ-sén	Category:巴塞羅那省
分類:Chûng-kau-ho̍k	Category:宗教学
分類:Thai-pu-khî	Category:大埔區
分類:Thòi-tûng-yen	Category:台東縣
分類:Thòi-vàn Ngièn-chhu-mìn	Category:台灣原住民
分類:Thò-yèn-yen	Category:桃園市
分類:User hak	Category:Zh-hakka 使用者
分類:Thien-fa	Category:电话
模板:TPE	Template:TPE
分類:Ngân-set	Category:颜色
分類:Tshiên-vân-khî	Category:荃灣區
分類:Thûn-mùn-khî	Category:屯門區
分類:User cdo	Category:Cdo 使用者
分類:User zh-min-dong-N	Category:Cdo 母語使用者
分類:User hak-1	Category:Zh-hakka-1 使用者
分類:User hak-3	Category:Zh-hakka-3 使用者
分類:User hak-4	Category:Zh-hakka-4 使用者
分類:User hak-N	Category:Zh-hakka 母語使用者
分類:Chông-fa-yen	Category:彰化縣
分類:Tseu-mìn	Category:照明
分類:Phòng-châ-phú	Category:旁遮普
分類:Phàng-fù-yen	Category:澎湖縣
分類:Hak-kâ-ngìn	Category:客家人
模板:Chûng-fà Mìn-koet Hàng-chṳn Khî-va̍k	Template:中華民國自由地區行政區劃
分類:Lie̍t-yî-tha̍t-sén	Category:莱里达省
甲型流感病毒H7N9亞型	甲型流感病毒H7N9亞型
分類:User lzh	Category:Lzh 使用者
模板:HUN	Template:HUN
模板:Yin-thu-nì-sî-â	Template:Indonesia
分類:User hak-2	Category:Zh-hakka-2 使用者
Vòng-phûng	黄蜂
模板:Kóng-sî Hàng-chṳn Khî-va̍k	Template:广西行政区划
模板:Kóng-tûng Hàng-chṳn Khî-va̍k	Template:广东行政区划
分類:Thòi-chûng-yen	Category:台中縣
分類:Thòi-pet-yen	Category:台北縣
分類:Thòi-nàm-yen	Category:台南縣
Si-yen-fa	四县话
分類:User en-1	Category:En-1 使用者
分類:User de-1	Category:De-1 使用者
分類:Hak-kâ tshoi	Category:客家菜
分類:Kô-hiùng-yen	Category:高雄縣
分類:Liu̍k-kiên-hói	Category:陆间海
分類:Lièn-kông-yen	Category:連江縣
分類:Khô-kî	Category:科技
分類:Hò-khiéu	Category:河口
模板:Thòi-pet-sṳ	Template:台北市
Zung-faa thung-yit zuk-zan dong	中華統一促進黨
興寧話	兴宁话
Fà-khièu Kón-lî-khî (San-mî-sṳ)	华侨管理区 (汕尾市)
Liû-khiû Khiùn-tó	琉球群岛
Thòi-19-sien	台19線
Thòi-tshit-sien	台7線
Koet-li̍p Sîn-chuk Kô-kip Chûng-ho̍k	國立竹南高級中學
Koet-li̍p Mèu-li̍t Kô-kip Chûng-ho̍k	國立苗栗高級中學
Koet-li̍p Mèu-li̍t Kô-kip Sông-ngia̍p Chṳt-ngia̍p Ho̍k-káu	國立苗栗高級商業職業學校
模板:User ru-3	Template:User ru-3
Thòi-23-sien	台23線
模板:Kô-hiùng-yen	Template:高雄縣
模板:Phìn-tûng-yen	Template:屏東縣
模板:Ngì-làn-yen	Template:宜蘭縣
模板:User nl-3	Template:User nl-3
模板:ROC-all	Template:ROC-all
模板:ICE	Template:ICE
模板:Sîn-pet-sṳ	Template:新北市
模板:IRE	Template:IRE
模板:CRO	Template:CRO
模板:Ww	Template:Ww
模板:Yùn-lìm-yen	Template:雲林縣
模板:Si-chhôn Hàng-chṳn Khî-va̍k	Template:四川行政区划
模板:HOL	Template:HOL
模板:Nàm-thèu-yen	Template:南投縣
Kóng-pet-khî (Kui-kóng-sṳ)	港北区
模板:Fâ-lièn-yen	Template:花蓮縣
模板:BUL	Template:BUL
模板:POR	Template:POR
模板:MTR	Template:港鐵路綫及服務
模板:Kâ-ngi-yen	Template:嘉義縣
模板:Thòi-chûng-sṳ	Template:臺中市
模板:Sîn-tsuk-yen	Template:新竹縣
模板:Chông-fa-yen	Template:彰化縣
模板:Alphabet tr	Template:Alphabet tr
模板:LAT	Template:LAT
模板:Thò-yèn-yen	Template:桃園市行政區劃
模板:Mèu-li̍t-yen	Template:苗栗縣
模板:Thòi-nàm-yen	Template:台南市
模板:Thòi-tûng-yen	Template:台東縣
Fi-chiu Tshùng-khói Koet-kâ Kô-sîn Kî-su̍t Sán-ngia̍p Khôi-fat-khî	惠州仲恺高新技术产业开发区
Fi-chiu Thai-â-vân Kîn-tsi Kî-su̍t Khôi-fat-khî	惠州大亚湾经济技术开发区
Sin-Kóng Chûng-sîm (Hiông-kóng)	新港中心
水源音	水源音
𠊎話	𠊎話
2013-ngièn Lù-sân Thi-chṳ́n	2013年芦山地震
Yòng-ya̍p-é	蝴蝶
Chûng-koet Chhèu-thoi	中国朝代
模板:Documentation/end box	Template:Documentation/end box
Ngiên-kiu-só	研究所
模板:User hak-2	Template:User zh-hakka-2
Hak-ngî Sṳn-kîn: Hien-thoi Thòi-vân Hak-ngî Yi̍t-pún	客語聖經：現代台灣客語譯本
Hon-khek	汉剧 (客家)
模板:Style/IPA	Template:Style/IPA
模板:Style/yid	Template:Style/yid
Thòi-vân Hak-kâ-ngìn	臺灣客家人
Lì Li̍t-kî	黎力基
Mèu-li̍t-yen Sṳ̂-li̍p Kien-thòi Kô-kip Chûng-ho̍k	苗栗縣私立建臺高級中學
模板:Ping	Template:Reply to
IPhone 5S	IPhone 5s
IPhone 5C	IPhone 5c
Sûng-kú Lô-siên	雙股螺旋
客家話拼音方案	客家話拼音方案
Yun Hyon-seok	六友堂
Tôn-ńg-chiet	端午节
客語流行音樂	客語流行音樂
特殊:最近更改	Special:最近更改
模組:HtmlBuilder	模块:HtmlBuilder
模組:Navbar	模块:Navbar
模組:Navbox	模块:Navbox
模板:台灣語言	Template:臺灣語言
臺灣客家語拼音方案	臺灣客家語拼音方案
長樂話	五華話
分類:Lièn-só Chhôn-thâng	Category:連鎖店
Phû Lû-sṳ	蒲鲁士
惠陽話	惠阳话
Sâ-thièn Au-chhun	沙田坳邨
分類:Yit-chhùng	Category:益蟲
馬來西亞航空17號班機空難	马来西亚航空17号班机空难
新民話	新民話
船井生醫	船井生醫
Khóa Vùn-chet	柯文哲
分類:Sṳn-kîn Yi̍t-pún	Category:圣经译本
Hak-kâ-ngî	客家话正音正字
Hîn-fa Phìn-fa-sṳ	興化平話字
麼嘅話	麼个话
Kien-nèn Lò-mâ-sṳ	建寧羅馬字
