ʻApelika	非洲
Iāpana	日本
‘Amelika Hema	南美洲
Nolewai	挪威
ʻIlelani	爱尔兰共和国
Hunakalia	匈牙利
Sepania	西班牙
‘Amelika Hui Pū ‘ia	美国
Pelekiuma	比利时
Lukemapuka	卢森堡
Honua	地球
Keoki Wakinekona	乔治·华盛顿
Pinilana	芬兰
Kuekene	瑞典
Kenemaka	丹麦
Pōlani	波兰
Lituania	立陶宛
ʻĪkālia	意大利
Kuikilani	瑞士
ʻAukekulia	奥地利
Helene	希腊
Tureke	土耳其
Potugala	葡萄牙
‘Eulopa	欧洲
‘Ākia	亚洲
‘Amelika ‘Ākau	北美洲
‘Ane‘ālika	南极洲
Wikipikia	维基百科
Hōlani	荷兰
Wakinekona, D.C.	华盛顿哥伦比亚特区
Kapalakiko	旧金山
Pelelina	柏林
Barack Obama	贝拉克·奥巴马
Lākana	伦敦
Palika	巴黎
Mekiko	墨西哥
Moana ʻAkelanika	大西洋
Moana Pākīpika	太平洋
Kaleponi	加利福尼亚州
Pokekona	波士顿
Pō‘akahi	星期一
Ianuali	1月
Pepeluali	2月
Malaki	3月
Hōkū‘ula	火星
Kenia	肯尼亚
‘Aikiopia	埃塞俄比亚
‘Apelila	4月
Mei	5月
Iune	6月
Iulai	7月
‘Aukake	8月
Kepakemapa	9月
‘Okakopa	10月
Nowemapa	11月
Kēkēmapa	12月
Pō‘alua	星期二
Pō‘akolu	星期三
Pō‘ahá	星期四
Pō‘alima	星期五
Pō‘aono	星期六
Pōpule	星期日
Liona	狮
Palani	法国
‘Ōlelo Ekepelānako	世界语
Aupuni Mōʻī Hui Pū ʻia	英国
Pōpoki	猫
Kina	中华人民共和国
‘Ōlelo Palani	法语
Palakila	巴西
Rūsia	俄罗斯
Pai (makemakika)	圓周率
‘Alapama	亚拉巴马州
Kelemānia	德国
Belarusa	白俄罗斯
ʻĀina Hau	冰岛
ʻEsetonia	爱沙尼亚
Makulu	土星
1 (helu)	1
Lakawia	拉脫維亞
ʻUkelena	乌克兰
Tiekia	捷克
Solowakia	斯洛伐克
Solowenia	斯洛文尼亚
Molodowa	摩尔多瓦
Romānia	羅馬尼亞
Pulukalia	保加利亚
Loma	罗马
Repupalika o Masedonia	馬其頓共和國
ʻAlepania	阿尔巴尼亚
Koloatia	克罗地亚
Bosenia me Hesegowina	波斯尼亚和黑塞哥维那
‘Akepaikana	阿塞拜疆
ʻAnakola	安道尔
Kupelo	賽普勒斯
Keokia	格鲁吉亚
Kasakana	哈萨克斯坦
Malata	马耳他
Monako	摩纳哥
Montenegero	蒙特內哥羅
Wakikana	梵蒂冈
Sana Marino	圣马力诺
‘Inidonesia	印度尼西亚
Wolfgang Amadeus Mozart	沃尔夫冈·阿马德乌斯·莫扎特
Ludwig van Beethoven	路德维希·范·贝多芬
‘Alekelia	阿尔及利亚
Kelewikiona	电视
Chile	智利
Ukaliali‘i	水星
Hōkūloa	金星
Ka‘āwela	木星
Hele‘ekela	天王星
Nepekune	海王星
Kilo hōkū	天文學
Sinapoa	新加坡
Akeakamai	科学
Likenekaina	列支敦斯登
Makemakika	数学
Baharaina	巴林
‘Āmēnia	亞美尼亞
Seripia	塞尔维亚
‘Aukekulelia	澳大利亚
Kālaikūlohea	物理学
‘Alekina	阿根廷
Kālaimeaola	生物学
Kōlea ʻĀkau	朝鲜民主主义人民共和国
Kamabodia	柬埔寨
Nalala	恐龙
Hoʻomana Mohameka	伊斯兰教
Kālailau nahele	植物学
Sofia	索菲亞
Kūlanakauhale	城市
Lā	太阳
Kahua o nā hōkū	太阳系
Haikokene	氢
Hiliuma	氦
Likiuma	锂
Beryllium	铍
Makahiki	年
Oslo	奥斯陆
Likepona	里斯本
Rhône (kahawai)	罗纳河
Boron	硼
Kalepona	碳
Naikokene	氮
‘Okikene	氧
Hōkū hele	行星
Mokekao	莫斯科
Fluorine	氟
ʻŌlelo ʻĪkālia	意大利语
Nīane	氖
Sodiuma	钠
Makanekiuma	镁
‘Aluminuma	铝
‘Īnia	印度
Silikone	硅
Pokepola	磷
Sulufura	硫
Kolorine	氯
William Shakespeare	威廉·莎士比亚
‘Aragona	氩
Potasiuma	钾
Kalipuna	钙
Monokolia	蒙古国
Scandium	钪
Titanium	钛
Vanadium	钒
Maine	缅因州
Lio	马
Hoʻomana Buda	佛教
Nū Hamekia	新罕布什尔州
Leonardo da Vinci	列奥纳多·达·芬奇
Makakukeka	麻薩諸塞州
Konekikuka	康乃狄克州
Hawai‘i	夏威夷州
Moana ʻĀlika	北冰洋
Heiti	海地
‘Ilana	伊朗
‘Ilaka	伊拉克
‘Ālaka	阿拉斯加州
ʻIseraʻela	以色列
Panamā	巴拿马
Iemene	也门
Ioredāne	约旦
Pololika	佛罗里达州
Kaikikana	吉尔吉斯斯坦
‘Alikona	亞利桑那州
Kuete	科威特
Laosa	老挝
Lepanona	黎巴嫩
‘Olekona	俄勒冈州
Maladiwa	马尔代夫
Uka	犹他州
Malaisia	马来西亚
Puruma	缅甸
Nepala	尼泊尔
ʻOmana	阿曼
Pakitana	巴基斯坦
Katala	卡塔尔
Saudi ʻAlapia	沙特阿拉伯
Sililanaka	斯里蘭卡
Suria	叙利亚
Pokémon	口袋妖怪系列
Tailani	泰国
Wiekanama	越南
‘Apekanikana	阿富汗
Banagaladesa	孟加拉国
Butana	不丹
Brunei	文莱
ʻĀina Pilipino	菲律宾
Isaac Newton	艾萨克·牛顿
Albert Einstein	阿尔伯特·爱因斯坦
Tunisia	突尼西亞
Beijing	北京市
Burakina Faso	布吉納法索
ʻElikilea	厄立特里亚
Mauritiusa	毛里求斯
Iulius Caesar	尤利烏斯·凱撒
Hamepuka	汉堡
Huli honua	地质学
Mikikana	密歇根州
‘Ilinoe	伊利诺伊州
Tulinia	图林根
Kakoka ‘Ākau	北达科他州
Kakoka Hema	南达科他州
Monekana	蒙大拿州
Waiomina	怀俄明州
‘Ikahō	爱达荷州
Wakinekona	华盛顿州
Moana ʻIniana	印度洋
Kololako	科羅拉多州
ʻAlepa	阿尔卑斯山
Kikako, ʻIlinoe	芝加哥
‘Ōlelo Sepania	西班牙语
Montevideo	蒙得维的亚
Johann Sebastian Bach	约翰·塞巴斯蒂安·巴赫
Wilikinia	弗吉尼亚州
Wilikinia Komohana	西維吉尼亞州
Nuioka	纽约州
Loke ‘Ailana	羅德島州
Melelana	马里兰州
Kelawea	特拉华州
‘Ohaio	俄亥俄州
Penekelewinia	宾夕法尼亚州
Uetersen	于特森
Augustus	奥古斯都
Nū ‘Ieleke	新泽西州
‘Ōlelo Pinilana	芬兰语
‘Inikiana	印第安纳州
Keokia (‘Amelika Hui Pū ‘ia)	喬治亞州
Kekeka	德克萨斯州
Kalolaina Hema	南卡罗来纳州
Seine	塞纳河
Buenos Aires	布宜諾斯艾利斯
Mēkiko D.F.	墨西哥城
Mikikipi	密西西比州
Kenekī	田纳西州
Nū Mekiko	新墨西哥州
‘Akenai	雅典
Minekoka	明尼蘇達州
Wikonekina	威斯康辛州
‘Iowa	艾奥瓦州
Nepalaka	內布拉斯加州
Kanekaka	堪薩斯州
Mikouli	密蘇里州
Luikiana	路易斯安那州
Kenekuke	肯塔基州
‘Akanaka	阿肯色州
‘Okalahoma	奧克拉荷馬州
Makekepuka	马格德堡
Reykjavík	雷克雅維克
Paipala	聖經
Thulium	铥
Ka Ho‘omana Iesū ‘Oia‘i‘o	真耶稣教会
‘Ōlelo Pelekania	英语
Đồng Hới	同海市
Concepción, Chile	康塞普西翁 (智利)
Końskowola	孔斯科沃拉
2000	2000年
2003	2003年
2002	2002年
2001	2001年
2009	2009年
2008	2008年
2004	2004年
2005	2005年
2006	2006年
2007	2007年
Lipekika	莱比锡
1998	1998年
1999	1999年
Kurów	库鲁夫
Kemika	化學
Makelika	马德里
Lima	利馬
Santiago de Chile	圣地亚哥-德智利
Quito	基多
Ankara	安卡拉
Riyadh	利雅德
Kamakeko	大马士革
Amman	安曼
Muscat	马斯喀特
Wikipedia:Sandbox	Wikipedia:沙盒
Wehimala	魏玛
Osasco	奥萨斯库
Dong Hoi Airport	同海機場
Curitiba	庫里奇巴
Zichyújfalu	齐奇尤伊福卢
Sarah Bernhardt	莎拉·伯恩哈特
Mauna Kana Helena	圣海伦火山
Mokuhonua	洲
Kapikala	首都
Monzón	蒙宗
Almazán	艾爾瑪善鎮
Puke noi‘i kū‘ikena	百科全书
Ka papa kinohi	Wikipedia:首页
Vincent van Gogh	文森特·梵高
Frida Kahlo	芙烈達·卡蘿
Michelangelo	米开朗基罗
Pablo Picasso	巴勃羅·畢卡索
Raffael Santi	拉斐尔·圣齐奥
Rembrandt	伦勃朗
Frank Lloyd Wright	弗蘭克·勞埃德·賴特
Matsuo Bashō	松尾芭蕉
Castille a Leon	卡斯蒂利亚-莱昂
Meka	麥加
Gabriel García Márquez	加夫列尔·加西亚·马尔克斯
Johann Wolfgang von Goethe	约翰·沃尔夫冈·冯·歌德
Māhele:Candidates for speedy deletion	Category:快速删除候选
Kaumokuʻāina	国家
Homer	荷马
Hōʻole Akua	无神论
Kālaikaiaola	生态学
Kālaiʻāina	政治
Aupuni	政府
Qin Shi Huang	秦始皇
Tolstoi	列夫·托爾斯泰
Moku‘āina	國 (政治)
ʻŌlelo Lūkini	俄语
‘Ōlelo Pākē	汉语
Nelson Mandela	纳尔逊·曼德拉
Makani Pāhili	熱帶氣旋
Moʻokalaleo	文學
Māhele:Palani	Category:法国
Oboe	雙簧管
ʻOlumepika Kauwela ma 2008	2008年夏季奥林匹克运动会
Granada	格拉纳达
ʻĀtoma	原子
Lāpaki	兔
Mohameka	穆罕默德
Burgos	布尔戈斯
Ronald Reagan	罗纳德·里根
‘Ōlelo Zaza	扎扎其語
Māhele:Palakila	Category:巴西
Kumumea kemikala	化學元素
‘Ohe kani	笛
ʻAlea	面积
Hulahula	舞蹈
Papa o nā ʻāina	世界政區索引
Miranda de Ebro (Burgos)	埃布罗河畔米兰达
Kuli	聾
Ponferrada	蓬费拉达
Santander	桑坦德 (西班牙)
Helu piha	整数
Malgrat de Mar	滨海马尔格拉特
‘Ōlelo ‘Alapia	阿拉伯语
Tiranosauru	暴龍屬
Terikeratopa	三角龍屬
Setegasauru	劍龍屬
Barakiosauru	腕龍屬
Welokirapetoa	伶盜龍屬
Hae	旗幟
‘Ulu	麵包樹
Aupuni kiwikā	基层政权
Salamanca	萨拉曼卡
Zamora (España)	萨莫拉 (西班牙)
León (España)	莱昂 (西班牙)
Anakuhi:Link FA	Template:Link FA
Welemoneka	佛蒙特州
Houston, Kekeka	休斯敦
Pēniki	鳳凰城 (亞利桑那州)
Kakalameko	沙加緬度
Honolulu, Hawaiʻi	檀香山
Kauoha Hou	新約聖經
Rafael Correa	拉斐尔·科雷亚
Louvre	卢浮宫
‘Ao‘ao Kū‘oko‘a Pokoliko	波多黎各獨立黨
Kalikimaka	圣诞节
Mo‘ai	摩艾石像
Hoʻolele hualono	播客
Friedrich Schiller	弗里德里希·席勒
Jean Auguste Dominique Ingres	让·奥古斯特·多米尼克·安格尔
Pule	星期
Cervidae	鹿科
Pule Alaka‘i A Ka Haku	主禱文
Musée d'Orsay	奥赛博物馆
Mokupuni	島嶼
Moshchena	穆夏那
ʻōhiʻa lomi	番茄
Paltoga	帕托加
Panalā‘au o Quảng Binh	廣平省
Bryan Cranston	布莱恩·科兰斯顿
Felidae	猫科
Pichilemu	披市勒亩
Canidae	犬科
Karlstad	卡尔斯塔德
Bovidae	牛科
Phocidae	海豹
ʻAnekelopa	羚羊
‘Amelika	亚美利加
Cabañas Raras	卡瓦尼亚斯拉拉斯
Ardón (León)	阿尔东 (莱昂省)
Algadefe	阿尔加德费
Acebedo	阿塞韦多
Los Barrios de Luna	洛斯瓦里奥斯德卢纳
Fresno de la Vega	夫雷斯诺德拉韦加
La Antigua (Sepania)	兰蒂瓜
Almanza	阿尔曼萨 (莱昂省)
El Burgo Ranero	埃尔武尔戈拉内罗
Boca de Huérgano	博卡德韦尔加诺
Bustillo del Páramo	布斯蒂略德尔帕拉莫
Boñar	博尼亚尔
Alija del Infantado	阿利哈德林凡塔多
Brazuelo	布拉苏埃洛
Berlanga del Bierzo	贝尔兰加德尔维耶尔索
Cabreros del Río	卡夫雷罗斯德尔里奥
Bercianos del Real Camino	贝尔西亚诺斯德尔雷亚尔卡米诺
Burón (León)	布龙
Bercianos del Páramo	贝尔西亚诺斯德尔帕拉莫
Otariidae	海獅科
Pinnipedia	鰭足類
Zhengzhou	郑州市
Mīkini helu	计算器
Halakepoka	哈特福
‘Ōlelo Hawai‘i	夏威夷语
Pea kina	大熊猫
Pae moku	群島
Valparaíso	瓦尔帕莱索
‘Ōlelo Sāmoa	薩摩亞語
Marlon Brando	马龙·白兰度
‘Ōlelo Kahiki	大溪地語
Wailele ‘o Niakala	尼亚加拉瀑布
Mošovce	莫绍夫采
ʻAperodite	阿佛洛狄忒
Nā mokuʻāina o ʻAmelika Hui	美国州份
Pauka niho	潔齒劑
Mineapoli	明尼阿波利斯
Apia	阿皮亚
Brigitte Bardot	碧姬·芭杜
Arancón	阿兰孔
'ōlelo toki pona	道本语
Paul Gauguin	保羅·高更
Teide	泰德峰
Kālaiʻelala	昆虫学
Ágreda	阿格雷达
ʻAnekilosauru	甲龍屬
Waleluka	海象
Johannes Vermeer	扬·弗美尔
Teletubbies	天線寶寶
Kahiki	大溪地
Israel Kamakawiwoʻole	伊瑟瑞·卡瑪卡威烏歐爾
Johnny Cash	約翰尼·卡什
Nanahana	银杏
Hesioda	赫西俄德
Cubillos del Sil	库维略斯德尔西尔
Igüeña	伊格尼亚
Noceda del Bierzo	诺塞达
Castropodame	卡斯特罗波达梅
Páramo del Sil	帕拉莫德尔西尔
Molinaseca	莫利纳塞卡
Congosto	孔戈斯托
Toreno	托雷诺
Folgoso de la Ribera	福尔戈索德拉里韦拉
Sancedo	桑塞多
Josepa Samika	約瑟·斯密
Pihemanu	中途島
Paris Hilton	芭黎絲·希爾頓
Palapola	抛物线
Helu kumu	素数
Söréd	舍雷德
Palencia	帕伦西亚省
El Royo	埃尔罗约
Reyero	雷埃罗
La Ercina	莱尔西纳
La Robla	拉罗夫拉
Santa Colomba de Curueño	圣科隆瓦德库鲁埃尼奥
Santa María del Monte de Cea	圣马里亚德尔蒙特德塞亚
San Cristóbal de la Polantera	圣克里斯托瓦尔德拉波兰特拉
ʻUkulele	烏克麗麗
Santa María del Páramo	圣马里亚德尔帕拉莫
Santa Elena de Jamuz	圣埃莱纳德哈穆斯
San Justo de la Vega	圣胡斯托德拉韦加
Hawai‘i (mokupuni)	夏威夷島
Georg Philipp Telemann	格奥尔格·菲利普·泰勒曼
ʻUlano	乌拉诺斯
Coronel Fabriciano	法布里西亚诺上校城
Quintana y Congosto	金塔奈孔戈斯托
Matallana de Torío	马塔利亚纳德托里奥
Pamela Anderson	帕米拉·安德森
Gema	寶石
Puahōlani	郁金香
Nikolai Rimsky-Korsakov	尼古拉·安德烈耶维奇·里姆斯基-科萨科夫
Donald Sutherland	唐纳德·萨瑟兰
Peter O'Toole	彼得·奧圖
Lili‘uokalani	利留卡拉尼女王
Joey King	喬伊·金
X-Men	X战警
Nika	倪克斯
Mauna Kea	冒纳凯阿火山
O‘ahu	歐胡島
Lucillo	卢西略
Cimanes de la Vega	西马内斯德拉韦加
Cebrones del Río	塞夫罗内斯德尔里奥
Quintana del Marco	金塔纳德尔马尔科
San Millán de los Caballeros	圣米良德洛斯卡瓦列罗斯
Cubillas de Rueda	库维利亚斯德鲁埃达
Cea (León)	塞亚
Garrafe de Torío	加拉费德托里奥
Santa María de Ordás	圣马里亚德奥尔达斯
Cuadros	夸德罗斯
Llamas de la Ribera	利亚马斯德拉里韦拉
Riello	列略
Palacios de la Valduerna	帕拉西奥斯德拉瓦尔杜埃尔纳
Castrocalbón	卡斯特罗卡尔翁
Carrocera	卡罗塞拉
Murias de Paredes	穆里亚斯德帕雷德斯
Rioseco de Tapia	里奥塞科德塔皮亚
Santa Cristina de Valmadrigal	圣克里斯蒂纳德瓦尔马德里加尔
Grajal de Campos	格拉哈尔德坎波斯
Santa María de la Isla	圣马里亚德莱斯拉
Campo de Villavidel	坎波德维利亚维德尔
Crémenes	克雷梅内斯
Cimanes del Tejar	西马内斯德尔特哈尔
Castilfalé	卡斯蒂尔法莱
Quintana del Castillo	金塔纳德尔卡斯蒂略
Campazas	坎帕萨斯
Pajares de los Oteros	帕哈雷斯德洛索特罗斯
San Pedro Bercianos	圣佩德罗韦尔西亚诺斯
Santa Marina del Rey	圣马里纳德尔雷
Cebanico	塞瓦尼科
Gordaliza del Pino	戈尔达利萨德尔皮诺
Castrillo de la Valduerna	卡斯特里略德拉瓦尔杜埃尔纳
Pozuelo del Páramo	波苏埃洛德尔帕拉莫
Prado de la Guzpeña	普拉多德拉古斯佩尼亚
Matanza (León)	马坦萨
Santa Colomba de Somoza	圣科隆瓦德索莫萨
Cubillas de los Oteros	库维利亚斯德洛索特罗斯
Mansilla Mayor	曼西利亚迈奥尔
Gordoncillo	戈尔东西略
San Esteban de Nogales	圣埃斯特万德诺加莱斯
Regueras de Arriba	上雷格拉斯
Luyego	卢伊埃戈
San Emiliano	圣埃米利亚诺
Maraña	马拉尼亚
Castrotierra de Valmadrigal	卡斯特罗铁拉德瓦尔马德里加尔
Magaz de Cepeda	马加斯德塞佩达
Matadeón de los Oteros	马塔德翁德洛索特罗斯
Castrillo de Cabrera	卡斯特里略德卡夫雷拉
Gusendos de los Oteros	古森多斯德洛索特罗斯
Chozas de Abajo	下乔萨斯
Roperuelos del Páramo	罗佩鲁埃洛斯德尔帕拉莫
Sonata No. 8 no Piano (Beethoven)	第8钢琴奏鸣曲 (贝多芬)
Aotearoa	奥特亚罗瓦
John Singer Sargent	约翰·辛格·萨金特
Sesame Street	芝麻街
Aupuni Mōʻī o Hawaiʻi	夏威夷王國
Mauna Loa	冒纳罗亚火山
Pat Hingle	帕特·亨格尔
Frans Hals	弗兰斯·哈尔斯
Pō La‘i Ē	平安夜 (歌曲)
Nuʻuhiwa	馬克薩斯群島
Edentata	异关节总目
Caltojar	卡尔托哈尔
Berlanga de Duero	贝尔兰加德杜埃罗
Christopher Lee	克里斯多福·李
Knoxville, Kenekī	諾克斯維爾
Lāna‘i	拉奈島
Carl Larsson	卡爾·拉森
Kīlauea	基拉韋厄火山
Maui	茂宜島
Māmā	速度 (音樂)
Christopher Plummer	克里斯托弗·普卢默
Mokupuni o Hawai‘i	夏威夷群島
Ivan Shishkin	伊凡·伊凡諾維奇·希施金
Moloka‘i	摩洛凱島
Nancy Reagan	南希·里根
Almuñécar	阿尔穆涅卡尔
Hakakā ‘ole	不杀生
Kaua‘i	考艾岛
Tigranes II	提格兰二世
Georges de La Tour	乔治·德·拉·图尔
Adour	阿杜尔河
Ivan Kramskoi	伊凡·克拉姆斯柯依
Motril	莫特里尔
Roger Ebert	罗杰·埃伯特
Adolfo Suárez	阿道弗·苏亚雷斯
Thomas Eakins	湯姆·艾金斯
Kamehameha I	卡美哈梅哈一世
Hilo	希洛 (夏威夷州)
Anggun	安谷
Kaho‘olawe	卡胡拉威島
Kalo	芋
Makua Kamiano	達米盎神父
Ni‘ihau	尼豪島
Guadix	瓜迪斯
Pete Seeger	皮特·西格
Heleuī	万圣夜
Waikīkī	威基基
Castrojeriz	卡斯特罗赫里斯
Camponaraya	坎波纳赖阿
Ituero de Azaba	伊图埃罗德亚萨瓦
Villardiegua de la Ribera	比利亚尔迭瓜德拉里韦拉
Bañuelos de Bureba (Burgos)	巴纽埃洛斯德武雷瓦
Imelda Marcos	伊梅尔达·马科斯
Órgiva	奥尔希瓦
Michael Gough	麥可·高福
Sargentes de la Lora (Burgos)	萨尔亨特斯德拉洛拉
Vadillo	巴迪略
Peterosauru	翼手龍屬
Makeima	澳大利亚坚果
Richard Griffiths	李查·葛瑞夫斯
Andrew Wyeth	安德魯·魏斯
Loja	洛哈
Hua mele hapawalu	八分音符
Hua mele ‘oko‘a	全音符
Hua mele hapahā	四分音符
Pedro de Betancur	佩德罗·贝坦库尔
Calzada de Valdunciel	卡尔萨达德瓦尔敦希耶尔
Villarcayo de Merindad de Castilla la Vieja (Burgos)	比利亚尔凯奥德梅林达德卡斯蒂利亚拉维耶哈
Tubilla del Lago (Burgos)	图维利亚德利亚戈
Pino del Oro	皮诺德洛罗
Jeddah	吉达
Almaluez	阿尔马卢埃斯
Salas de los Infantes (Burgos)	萨拉斯德洛辛凡特斯
Hua mele hapa kanakolukūmālua	三十二分音符
Kamehameha II	卡美哈梅哈二世
Arraya de Oca (Burgos)	阿赖阿德奥卡
Valencia de Don Juan	巴伦西亚德东胡安
Manzanal del Barco	曼萨纳尔德尔瓦尔科
Bugedo (Burgos)	布赫多
Hua mele hapalua	二分音符
Anne Hathaway	安妮·海瑟薇 (消歧義)
Partido de la Sierra en Tobalina (Burgos)	帕尔蒂多德拉谢赖恩托瓦利纳
Valdefresno	巴尔德夫雷斯诺
Salobreña	萨洛夫雷尼亚
Aldea del Obispo	阿尔德亚德洛维斯波
Arabayona de Mógica	阿拉瓦伊奥纳德莫希卡
El Maderal	埃尔马德拉尔
Roa (Burgos)	罗阿 (布尔戈斯省)
Calvarrasa de Arriba	上卡尔瓦拉萨
Kamehameha III	卡美哈梅哈三世
Buke a Moramona	摩爾門經
Carazo	卡拉索省
Astorga	阿斯托尔加
Pōmare IV	波马雷四世
Alexander ʻIolani Liholiho	卡美哈梅哈四世
Tan Son Nhat International Airport	新山一國際機場
Aliud	阿柳德
Baraona	巴劳纳
Medinaceli	梅迪纳塞利
Láchar	拉查尔
Burgo de Osma-Ciudad de Osma	布尔戈德奥斯马-休达德奥斯马
Suellacabras	苏埃利亚卡夫拉斯
Yanguas	伊安瓜斯
San Esteban de Gormaz	圣埃斯特万德戈尔马斯
Baza	巴萨 (格拉纳达省)
San Vicente del Raspeig	圣比森特德尔拉斯佩格
Aranda de Duero (Burgos)	杜罗河畔阿兰达
Nā kiaʻāina o Hawaiʻi	夏威夷州州长
Ka'aahi Thomas	火車頭日記
Likaono	莱卡翁
Alhama de Granada	阿尔阿马德格拉纳达
Mauna kai	海底山
Gallegos del Río	加列戈斯德尔里奥
Espinosa de los Monteros (Burgos)	埃斯皮诺萨德洛斯蒙特罗斯
Rabanera del Pinar (Burgos)	拉瓦内拉德尔皮纳尔
Cañamaque	卡尼亚马克
Cazurra	卡苏拉
Requejo (Zamora)	雷克霍
Navaleno	纳瓦莱诺
Tremedal de Tormes	特雷梅达尔德托尔梅斯
Las Omañas	拉索马尼亚斯
Santa Eufemia del Barco	圣埃乌费米亚德尔瓦尔科
Huahine	胡阿希內島
Alfoz de Bricia (Burgos)	阿尔福斯德夫里西亚
Villalbilla de Burgos (Burgos)	比利亚尔维利亚德武尔戈斯
Negrilla de Palencia	内格里利亚德帕伦西亚
Honolulu International Airport	檀香山國際機場
Kailua	凯卢阿 (夏威夷州)
Belorado (Burgos)	贝洛拉多
Peleas de Abajo	下佩莱阿斯
Fresneda de la Sierra Tirón (Burgos)	夫雷斯内达德拉谢拉蒂龙
Morales de Toro	莫拉莱斯德托罗
Carcedo de Burgos	卡尔塞多德武尔戈斯
Cijuela	西胡埃拉
Armilla	阿尔米利亚
Chauchina	乔奇纳
Dúrcal	杜尔卡尔
Cantabrana	坎塔夫拉纳
Fuente Vaqueros	丰特瓦克罗斯
Huéscar	韦斯卡尔
Trévago	特雷瓦戈
Maracena	马拉塞纳
La Bouza	拉沃萨
El Campo de Peñaranda	埃尔坎波德佩尼亚兰达
Palacios de Riopisuerga (Burgos)	帕拉西奥斯德里奥皮苏埃尔加
Līhuʻe	利胡埃
Pedrosa del Príncipe (Burgos)	佩德罗萨德尔普林西佩
Merindad de Valdeporres (Burgos)	梅林达德瓦尔德波雷斯
Aldealengua	阿尔德亚伦瓜
Tubilla del Agua (Burgos)	图维利亚德拉瓜
La Encina (Salamanca)	莱恩西纳
Valdepiélago	巴尔德彼拉戈
Villademor de la Vega	比利亚德莫尔德拉韦加
Camarzana de Tera	卡马尔萨纳德特拉
Dévanos	德瓦诺斯
Zotes del Páramo	索特斯德尔帕拉莫
Priaranza del Bierzo	普里亚兰萨德尔维耶尔索
Villagonzalo Pedernales (Burgos)	比利亚贡萨洛佩德尔纳莱斯
Frades de la Sierra	弗拉德斯德拉谢拉
Avellanosa de Muñó (Burgos)	阿韦利亚诺萨德穆尼奥
Pinos Puente	皮诺斯蓬特
Fuentes de Carbajal	丰特斯德卡尔瓦哈尔
Garcibuey	加尔西武埃
Rollán	罗良
Moreruela de Tábara	莫雷鲁埃拉德塔瓦拉
El Bodón	埃尔沃东
Monasterio de la Sierra (Burgos)	莫纳斯特里奥德拉谢拉
Villamiel de la Sierra (Burgos)	比利亚米耶尔德拉谢拉
Santa Fe	圣费
Ólvega	奥尔韦加
Solarana (Burgos)	索拉拉纳
Barrio de Muñó (Burgos)	巴里奥德穆尼奥
Valmala (Burgos)	巴尔马拉
Casaseca de Campeán	卡萨塞卡德坎佩亚恩
Terradillos de Esgueva (Burgos)	特拉迪略斯德埃斯格瓦
Villamartín de Don Sancho	比利亚马尔廷德东桑乔
Viveiro	比韦罗
Burganes de Valverde	布尔加内斯德瓦尔韦尔德
Sobrado	索夫拉多
Basconcillos del Tozo (Burgos)	巴斯孔西略斯德尔托索
San Martín de Valderaduey	圣马尔廷德瓦尔德拉杜埃
Palapala ‘Āina Honua	世界地图
Magaña	马加尼亚
La Calzada de Béjar	拉卡尔萨达德韦哈尔
Abajas (Burgos)	阿瓦哈斯
Itero del Castillo (Burgos)	伊特罗德尔卡斯蒂略
Izagre	伊萨格雷
Reinosa	雷诺萨 (坎塔布里亚)
Centenera de Andaluz	森特内拉德亚恩达卢斯
Villalazán	比利亚拉桑
Almenara de Tormes	阿尔梅纳拉德托尔梅斯
Bermellar	贝尔梅利亚尔
Cacabelos	卡卡韦洛斯
Béjar	贝哈尔
Topas	托帕斯
Vidayanes	比代阿内斯
Villanázar	比利亚纳萨尔
Soto de la Vega	索托德拉韦加
Faramontanos de Tábara	法拉蒙塔诺斯德塔瓦拉
Manzanal de los Infantes	曼萨纳尔德洛辛凡特斯
Peque	佩克
Fermoselle	费尔莫塞列
Valle de Sedano (Burgos)	巴列德塞达诺
Junta de Traslaloma (Burgos)	洪塔德特拉斯拉洛马
Mansilla de las Mulas	曼西利亚德拉斯穆拉斯
Riocavado de la Sierra (Burgos)	里奥卡瓦多德拉谢拉
Belver de los Montes	贝尔韦尔德洛斯蒙特斯
Villanueva de Argaño (Burgos)	阿加尼奥新镇
Valderas	巴尔德拉斯
Menekikā	曼海蒂
Gradefes	格拉德费斯
Onzonilla	翁索尼利亚
Arenas de Iguña	阿雷纳斯德古尼亚
Ciudad Rodrigo	罗德里戈城
Sahagún	萨阿贡
Villatuelda (Burgos)	比利亚图埃尔达
Almarza	阿尔马萨
Aldealices	阿尔德亚利塞斯
Aldealafuente	阿尔德亚拉丰特
Alentisque	阿伦蒂斯克
Adradas	阿德拉达斯
Alconaba	阿尔科纳瓦
Abejar	阿韋哈爾
Almajano	阿尔马哈诺
Arenillas	阿雷尼利亚斯
Aldealpozo	阿尔德亚尔波索
Alcubilla de las Peñas	阿尔库维利亚德拉斯佩尼亚斯
Aldealseñor	阿尔德亚尔塞尼奥尔
Alcubilla de Avellaneda	阿尔库维利亚德亚韦利亚内达
Covaleda	科瓦莱达
Casarejos	卡萨雷霍斯
Cerbón	塞尔翁
Calatañazor	卡拉塔尼亚索尔
Almazul	阿尔马苏尔
Cidones	西多内斯
Alpanseque	阿尔潘塞克
Arcos de Jalón	阿尔科斯德哈隆
Aldehuela de Periáñez	阿尔德韦拉德佩里亚涅斯
Beratón	贝拉通
Almenar de Soria	阿尔梅纳尔德索里亚
Maján	马汉 (索里亚省)
Coscurita	科斯库里塔
Barcones	巴尔科内斯
Castilfrío de la Sierra	卡斯蒂尔夫里奥德拉谢拉
Castilruiz	卡斯蒂尔鲁伊斯
Miño de Medinaceli	米尼奥德梅迪纳塞利
Vinuesa	比努埃萨
Cigudosa	西古多萨
Candilichera	坎迪利切拉
Ausejo de la Sierra	奥塞霍德拉谢拉
Carabantes	卡拉万特斯
Soliedra	索列德拉
Taroda	塔罗达
Nepas	内帕斯
Valtajeros	巴尔塔赫罗斯
Arévalo de la Sierra	阿雷瓦洛德拉谢拉
Pozalmuro	波萨尔穆罗
Cabrejas del Pinar	卡夫雷哈斯德尔皮纳尔
Villasayas	比利亚赛阿斯
Cubilla	库维利亚
Castillejo de Robledo	卡斯蒂列霍德罗夫莱多
Escobosa de Almazán	埃斯科沃萨德亚尔马桑
Estepa de San Juan	埃斯特帕德圣胡安
Carrascosa de la Sierra	卡拉斯科萨德拉谢拉
Las Aldehuelas	拉萨尔德韦拉斯
Bayubas de Arriba	上巴尤瓦斯
Borobia	博罗维亚
Bliecos	布列科斯
Buberos	布韦罗斯
Muriel Viejo	穆列尔维耶霍
Oncala	翁卡拉
Fuentecambrón	丰特坎夫龙
Cabrejas del Campo	卡夫雷哈斯德尔坎波
Frechilla de Almazán	弗雷奇利亚德亚尔马桑
Valdelagua del Cerro	巴尔德拉瓜德尔塞罗
Ciria	西里亚
Buitrago	布伊特拉戈
Talveila	塔尔韦拉
Salduero	萨尔杜埃罗
Fuentes de Magaña	丰特斯德马加尼亚
Viana de Duero	比亚纳德杜埃罗
Tardelcuende	塔尔德尔昆德
Duruelo de la Sierra	杜鲁埃洛德拉谢拉
Bayubas de Abajo	下巴尤瓦斯
Fuentearmegil	丰特亚尔梅希尔
Fuentelmonge	丰特尔蒙赫
Rollamienta	罗利亚缅塔
Villar del Ala	比利亚尔德拉拉
Velilla de los Ajos	贝利利亚德洛萨霍斯
Momblona	蒙夫洛纳
Fresno de Caracena	弗雷斯诺德卡拉塞纳
Valdegeña	巴尔德赫尼亚
Velamazán	贝拉马桑
Torlengua	托尔伦瓜
Fuentecantos	丰特坎托斯
Carrascosa de Abajo	下卡拉斯科萨
Pinilla del Campo	皮尼利亚德尔坎波
Serón de Nágima	塞龙德纳希马
Blacos	布拉科斯
Valdeavellano de Tera	巴尔德亚韦利亚诺德特拉
Narros	纳罗斯
Valdeprado	巴尔德普拉多
Borjabad	博尔哈瓦德
Fuentelsaz de Soria	丰特尔萨斯德索里亚
San Leonardo de Yagüe	圣莱奥纳尔多德阿格
Muriel de la Fuente	穆列尔德拉丰特
Villar del Río	比利亚尔德尔里奥
Valderrodilla	巴尔德罗迪利亚
Espejón	埃斯佩洪
Liceras	利塞拉斯
Matalebreras	马塔莱夫雷拉斯
Quintana Redonda	金塔纳雷东达
Nafría de Ucero	纳夫里亚德乌塞罗
Sotillo del Rincón	索蒂略德尔林孔
Torrubia de Soria	托鲁维亚德索里亚
Noviercas	诺维耶尔卡斯
Tajueco	塔胡埃科
Valdenebro	巴尔德内夫罗
Villaciervos	比利亚希耶尔沃斯
Villanueva de Gormaz	戈尔马斯新镇
Yelo	耶洛
Montenegro de Cameros	蒙特内格罗德卡梅罗斯
Ucero	乌塞罗
Langa de Duero	兰加德杜埃罗
Quiñonería	基尼奥内里亚
Villar del Campo	比利亚尔德尔坎波
Portillo de Soria	波尔蒂略德索里亚
Gormaz	戈尔马斯
Santa Cruz de Yanguas	圣克鲁斯德安瓜斯
Villaseca de Arciel	比利亚塞卡德亚尔希耶尔
Reznos	雷斯诺斯
Cueva de Ágreda	库埃瓦德亚格雷达
Nolay	诺莱 (索里亚省)
Cirujales del Río	西鲁哈莱斯德尔里奥
Caracena	卡拉塞纳
Cubo de la Solana	库沃德拉索拉纳
Miño de San Esteban	米尼奥德圣埃斯特万
Fuentestrún	丰特斯特伦
Espeja de San Marcelino	埃斯佩哈德圣马尔塞利诺
Matamala de Almazán	马塔马拉德亚尔马桑
La Póveda de Soria	拉波韦达德索里亚
Los Rábanos	洛斯拉瓦诺斯
Quintanas de Gormaz	金塔纳斯德戈尔马斯
Santa María de Huerta	圣马里亚德韦尔塔
San Pedro Manrique	圣佩德罗曼里克
Velilla de la Sierra	贝利利亚德拉谢拉
Valdemaluque	巴尔德马卢克
San Felices	圣费利塞斯
Renieblas	雷涅夫拉斯
Toro (Zamora)	托罗 (萨莫拉省)
Morón de Almazán	莫龙德亚尔马桑
Los Villares de Soria	洛斯维利亚雷斯德索里亚
Torreblacos	托雷夫拉科斯
Vizmanos	比斯马诺斯
Tejado	特哈多
Retortillo de Soria	雷托尔蒂略德索里亚
Herrera de Soria	埃雷拉德索里亚
Deza	德萨
Monteagudo de las Vicarías	蒙特亚古多德拉斯维卡里亚斯
La Riba de Escalote	拉里瓦德埃斯卡洛特
Montejo de Tiermes	蒙特霍德铁尔梅斯
La Losilla	拉洛西利亚
Recuerda	雷库埃尔达
Tajahuerce	塔哈韦尔塞
Santa María de las Hoyas	圣马里亚德拉斯奥亚斯
Fuentepinilla	丰特皮尼利亚
Golmayo	戈尔迈奥
Rioseco de Soria	里奥塞科德索里亚
Gómara	戈马拉
Cihuela	西韦拉
Trabadelo	特拉瓦德洛
Caleruega	卡莱鲁埃加
Hospital de Órbigo	奥斯皮塔尔德奥尔维戈
Villafranca del Bierzo	比耶尔索自由镇
Pōmare II	波马雷二世
Pōmare I	波马雷一世
Pōmare III	波马雷三世
Peñausende	佩尼奥森德
Villadangos del Páramo	比利亚丹戈斯德尔帕拉莫
Vega de Valcarce	贝加德瓦尔卡尔塞
Valverde de la Virgen	巴尔韦尔德德拉维尔亨
Barbalos	巴尔瓦洛斯
Susinos del Páramo (Burgos)	苏西诺斯德尔帕拉莫
Quintanar de la Sierra (Burgos)	金塔纳尔德拉谢拉
Olmedillo de Roa (Burgos)	奥尔梅迪略德罗阿
Valle de Valdebezana (Burgos)	巴列德瓦尔德韦萨纳
Calzada del Coto	卡尔萨达德尔科托
Valdesamario	巴尔德萨马里奥
Fuentes de Oñoro	丰特斯德奥尼奥罗
Val de San Lorenzo	巴尔德圣洛伦索
Baños de Valdearados (Burgos)	巴尼奥斯德瓦尔德亚拉多斯
Losacino	洛萨西诺
Villaquilambre	比利亚基兰夫雷
Pradoluengo (Burgos)	普拉多伦戈
Aldearrodrigo	阿尔德亚罗德里戈
Padilla de Arriba (Burgos)	上帕迪利亚
Trabazos	特拉瓦索斯
La Cueva de Roa	拉库埃瓦德罗阿
Valdemora	巴尔德莫拉
Tardajos (Burgos)	塔尔达霍斯
Sotragero (Burgos)	索特拉赫罗
Hurones (Burgos)	乌罗内斯
Villanueva de Teba (Burgos)	特瓦新镇
Condado de Treviño	孔达多德特雷维尼奥
Castildelgado	卡斯蒂尔德尔加多
Cardeñuela Riopico	卡尔德纽埃拉里奥皮科
Villaveza del Agua	比利亚韦萨德拉瓜
Alba de Tormes	阿尔瓦－德托梅斯
Espinosa del Camino (Burgos)	埃斯皮诺萨德尔卡米诺
Villares de Órbigo	比利亚雷斯德奥尔维戈
Orbaneja Riopico (Burgos)	奥尔瓦内哈里奥皮科
Pozuelo de Tábara	波苏埃洛德塔瓦拉
Palazuelos de Muñó (Burgos)	帕拉苏埃洛斯德穆尼奥
Nebreda (Burgos)	内夫雷达
Benavente (Zamora)	贝纳文特
Galbarros (Burgos)	加尔瓦罗斯
Palacios de la Sierra (Burgos)	帕拉西奥斯德拉谢拉
Peñaranda de Duero (Burgos)	佩尼亚兰达德杜埃罗
Fuentesecas	丰特塞卡斯
Riego de la Vega	列戈德拉韦加
Viloria de Rioja (Burgos)	比洛里亚德里奥哈
Ferreras de Abajo	下费雷拉斯
Pinilla de los Barruecos (Burgos)	皮尼利亚德洛斯瓦鲁埃科斯
Villambistia (Burgos)	比良维斯蒂亚
Tosantos (Burgos)	托桑托斯
Hornillos del Camino (Burgos)	奥尔尼略斯德尔卡米诺
Villafranca Montes de Oca (Burgos)	蒙特斯德奥卡自由镇
Hontanas (Burgos)	翁塔纳斯
Villahoz (Burgos)	比利亚奥斯
Losacio	洛萨西奥
Mecerreyes (Burgos)	梅塞雷埃斯
Pardilla (Burgos)	帕尔迪利亚
Ledesma (Salamanca)	莱德斯马
Villafáfila	比利亚法菲拉
Figueruela de Arriba	上菲格鲁埃拉
Hontoria del Pinar (Burgos)	翁托里亚德尔皮纳尔
ʻAinaonao	食蟻獸
Benuza	贝努萨
Rabanales	拉瓦纳莱斯
Milles de la Polvorosa	米列斯德拉波尔沃罗萨
Celada del Camino	塞拉达德尔卡米诺
Forfoleda	福尔福莱达
Castrillo Matajudíos	卡斯特里略马塔胡迪奥斯
Villamanín	比利亚马宁
Vegalatrave	贝加拉特拉韦
Molinos de Duero	莫利诺斯德杜埃罗
Vozmediano	博斯梅迪亚诺
Hinojosa del Campo	伊诺霍萨德尔坎波
Mamo	夏威夷監督吸蜜鳥
Garcihernández	加尔西埃尔南德斯
La Alberca	拉尔韦尔卡
Redecilla del Camino (Burgos)	雷德西利亚德尔卡米诺
Rabé de las Calzadas (Burgos)	拉韦德拉斯卡尔萨达斯
Hua mele hapa ‘umikūmāono	十六分音符
Covarrubias	科瓦鲁维亚斯
Aldearrubia	阿尔德亚鲁维亚
Llano de Bureba (Burgos)	利亚诺德武雷瓦
Adrada de Haza (Burgos)	阿德拉达德阿萨
Cerezo de Río Tirón	塞雷索德里奥蒂龙
Lōʻihi	罗希海底山
Aiga-i-le-Tai	艾加伊勒泰
Bembibre	本维夫雷
Santovenia	桑托韦尼亚
Wikipedia:Nohona kuhina	Wikipedia:大使館
Poʻe Hawaiʻi	夏威夷族
Manuae	馬努瓦埃環礁
Alfoz de Lloredo	阿尔福斯德略雷多
Cármenes	卡尔梅内斯
Ampuero	安普埃罗
Palacios del Sil	帕拉西奥斯德尔西尔
Cabrillanes	卡夫里利亚内斯
Briviesca (Burgos)	布里维耶斯卡
Iznalloz	伊斯纳略斯
Māhele:Kelemānia	Category:德国
Māhele:ʻAmelika Hui Pū ʻia	Category:美国
Māhele:Sepania	Category:西班牙
Māhele:Mekiko	Category:墨西哥
Gallegos del Pan	加列戈斯德尔潘
La Bañeza	拉瓦涅萨
Carracedelo	卡拉塞德洛
Carucedo	卡鲁塞多
Corullón	科鲁利翁
Castrocontrigo	卡斯特罗孔特里戈
Fabero	法韦罗
Corrales	洛斯科拉莱斯德武埃尔纳
Anievas	阿涅瓦斯
Anguix (Burgos)	安吉斯
Arauzo de Miel (Burgos)	阿劳索德米耶尔
Arauzo de Salce (Burgos)	阿劳索德萨尔塞
Brazacorta (Burgos)	布拉萨科尔塔
Aguilar de Bureba (Burgos)	阿吉拉尔德武雷瓦
Bascuñana (Burgos)	巴斯库尼亚纳
Altable (Burgos)	阿尔塔夫莱
Barbadillo del Pez (Burgos)	巴尔瓦迪略德尔佩斯
Bahabón de Esgueva (Burgos)	巴阿翁德埃斯格瓦
Alfoz de Quintanadueñas (Burgos)	阿尔福斯德金塔纳杜埃尼亚斯
Barrios de Colina (Burgos)	巴里奥斯德科利纳
Berberana (Burgos)	贝尔韦拉纳
Berlangas de Roa (Burgos)	贝尔兰加斯德罗阿
Aguas Cándidas (Burgos)	阿瓜斯坎迪达斯
Belbimbre (Burgos)	贝尔温夫雷
Montorio (Burgos)	蒙托里奥 (布尔戈斯省)
Māhele:Pōlani	Category:波蘭
Māhele:Wiekanama	Category:越南
Māhele:Hōʻike honua	Category:地理
Māhele:Akeakamai	Category:科学
Guijuelo	吉胡埃洛
Vegas del Condado	贝加斯德尔孔达多
Borrenes	博雷内斯
Santovenia de la Valdoncina	桑托韦尼亚德拉瓦尔东西纳
La Pola de Gordón	拉波拉德戈尔东
Villablino	比利亚夫利诺
Torre del Bierzo	托雷德尔维耶尔索
Vega de Espinareda	贝加德埃斯皮纳雷达
Barjas	巴尔哈斯
Cistierna	西斯铁尔纳
Babilafuente	巴维拉丰特
Cereceda de la Sierra	塞雷塞达德拉谢拉
Cardeñajimeno	卡尔德尼亚希梅诺
Castil de Peones	卡斯蒂尔德佩奥内斯
Jurisdicción de Lara (Burgos)	胡里斯迪克西翁德拉拉
Arganza (León)	阿尔甘萨
Valdevimbre	巴尔德温夫雷
Villaturiel	比利亚图列尔
Valdepolo	巴尔德波洛
Gumiel de Mercado (Burgos)	古米耶尔德梅尔卡多
Oquillas (Burgos)	奥基利亚斯
Villamañán	比利亚马尼扬
Puente de Domingo Flórez	蓬特德多明戈夫洛雷斯
Olmillos de Muñó (Burgos)	奥尔米略斯德穆尼奥
Encío (Burgos)	恩西奥
Ibeas de Juarros (Burgos)	伊韦亚斯德华罗斯
Santibáñez del Val (Burgos)	桑蒂瓦涅斯德尔瓦尔
Urdiales del Páramo	乌尔迪亚莱斯德尔帕拉莫
Sena de Luna	塞纳德卢纳
Oña (Burgos)	奥尼亚 (西班牙)
Grisaleña (Burgos)	格里萨莱尼亚
Coruña del Conde	科鲁尼亚德尔孔德
Zazuar (Burgos)	萨苏阿尔
Buniel (Burgos)	布涅尔
Arauzo de Torre (Burgos)	阿劳索德托雷
Berzosa de Bureba (Burgos)	贝尔索萨德武雷瓦
Alfoz de Santa Gadea (Burgos)	阿尔福斯德圣加德亚
Barbadillo de Herreros (Burgos)	巴尔瓦迪略德埃雷罗斯
Albillos (Burgos)	阿尔维略斯
Arenillas de Riopisuerga (Burgos)	阿雷尼利亚斯德里奥皮苏埃尔加
Barbadillo del Mercado	巴尔瓦迪略德尔梅尔卡多
Medina de Pomar (Burgos)	梅迪纳德波马尔
Bozoó (Burgos)	博索奥
Fuentelisendo (Burgos)	丰特利森多
Zarzosa de Río Pisuerga (Burgos)	萨尔索萨德里奥皮苏埃尔加
Alcocero de Mola (Burgos)	阿尔科塞罗德莫拉
Valle de Mena (Burgos)	巴列德梅纳
Zael (Burgos)	赛尔
Ameyugo (Burgos)	阿梅乌戈
Villaquejida	比利亚克希达
Sariegos	萨列戈斯
Corbillos de los Oteros	科尔维略斯德洛索特罗斯
Vega de Infanzones	贝加登凡索内斯
Peranzanes	佩兰萨内斯
Sabero	萨韦罗
Candín (León)	坎丁
Valderrueda	巴尔德鲁埃达
Puebla de Lillo	普埃夫拉德利略
Soto y Amío	索托亚米奥
Laguna de Negrillos	拉古纳德内格里略斯
Villarejo de Órbigo	比利亚雷霍德奥尔维戈
La Vecilla	拉韦西利亚
San Andrés del Rabanedo	圣安德雷斯德尔拉瓦内多
Villazala	比利亚萨拉
Villamontán de la Valduerna	比利亚蒙坦德拉瓦尔杜埃尔纳
Nava de Roa (Burgos)	纳瓦德罗阿
Villasabariego	比利亚萨瓦列戈
Oencia	奥恩西亚
Encinedo	恩西内多
Zuñeda (Burgos)	苏涅达
Valdeande (Burgos)	巴尔德亚恩德
Destriana	德斯特里亚纳
Villagatón	比利亚加通
Arija (Burgos)	阿里哈
Busto de Bureba (Burgos)	布斯托德武雷瓦
Abezames	阿韦萨梅斯
Alcañices	阿尔卡尼伊塞斯
Laguna Dalga	拉古纳达尔加
Alaraz	阿拉拉斯 (萨拉曼卡省)
Brincones	布林科内斯
Aldeadávila de la Ribera	阿尔德亚达维拉德拉里韦拉
Castellanos de Castro	卡斯特利亚诺斯德卡斯特罗
Cascajares de la Sierra	卡斯卡哈雷斯德拉谢拉
Iglesiarrubia (Burgos)	伊格莱西亚鲁维亚
Castrillo de la Vega	卡斯特里略德拉韦加
Sasamón (Burgos)	萨萨蒙
Torrepadre (Burgos)	托雷帕德雷
Sotillo de la Ribera (Burgos)	索蒂略德拉里韦拉
Torrecilla del Monte (Burgos)	托雷西利亚德尔蒙特
Linares de Riofrío	利纳雷斯德里奥夫里奥
Ahigal de Villarino	阿伊加尔德维利亚里诺
Gumiel de Izán (Burgos)	古米耶尔德桑
Cabrerizos	卡夫雷里索斯
Cantalapiedra	坎塔拉彼德拉
Ahigal de los Aceiteros	阿伊加尔德洛萨塞特罗斯
Barceo	巴尔塞奥
Castellanos de Moriscos	卡斯特利亚诺斯德莫里斯科斯
Casafranca	卡萨夫兰卡
Vizcaínos (Burgos)	比斯凯诺斯
Casillas de Flores	卡西利亚斯德夫洛雷斯
Los Balbases (Burgos)	洛斯瓦尔瓦塞斯
Santibáñez de Esgueva (Burgos)	桑蒂瓦涅斯德埃斯格瓦
San Martín de Rubiales (Burgos)	圣马尔廷德鲁维亚莱斯
Tórtoles de Esgueva (Burgos)	托尔托莱斯德埃斯格瓦
Villaescusa de Roa (Burgos)	比利艾斯库萨德罗阿
Mamolar (Burgos)	马莫拉尔
Moradillo de Roa (Burgos)	莫拉迪略德罗阿
Mambrilla de Castrejón (Burgos)	曼夫里利亚德卡斯特雷洪
Pedrosa de Duero (Burgos)	佩德罗萨德杜埃罗
Quintanilla del Coco (Burgos)	金塔尼利亚德尔科科
Pinilla de los Moros (Burgos)	皮尼利亚德洛斯莫罗斯
Valle de Tobalina (Burgos)	巴列德托瓦利纳
Villanueva de Carazo (Burgos)	卡拉索新镇
Quemada (Burgos)	克马达
Torresandino (Burgos)	托雷桑迪诺
Villalba de Duero (Burgos)	比利亚尔瓦德杜埃罗
Rubena (Burgos)	鲁韦纳
Valluércanes (Burgos)	巴柳埃尔卡内斯
Villadiego (Burgos)	比利亚迭戈
Merindad de Río Ubierna (Burgos)	梅林达德里欧维耶尔纳
Mazuela (Burgos)	马苏埃拉
Valle de Zamanzas (Burgos)	巴列德萨曼萨斯
Quintana del Pidio (Burgos)	金塔纳德尔皮迪奥
Vadocondes (Burgos)	巴多孔德斯
Fuentelcésped (Burgos)	丰特尔塞斯佩德
Ciadoncha	西亚东查
Merindad de Montija (Burgos)	梅林达德蒙蒂哈
Pancorbo (Burgos)	潘科尔沃
Monterrubio de la Demanda (Burgos)	蒙特鲁维奥德拉德曼达
Fuentespina (Burgos)	丰特斯皮纳
Cillaperlata	西利亚佩尔拉塔
Fontioso (Burgos)	丰蒂奥索
La Sequera de Haza (Burgos)	拉塞克拉德阿萨
La Horra (Burgos)	拉奥拉
Cilleruelo de Arriba	上锡列鲁埃洛
Jurisdicción de San Zadornil (Burgos)	胡里斯迪克西翁德圣萨多尔尼尔
Cuevas de San Clemente	库埃瓦斯德圣克莱门特
Fuentemolinos (Burgos)	丰特莫利诺斯
Hontangas (Burgos)	翁坦加斯
Hoyales de Roa (Burgos)	奥亚莱斯德罗阿
Campolara	坎波拉拉
Carrias	卡里亚斯
Canicosa de la Sierra	卡尼科萨德拉谢拉
Cerralbo	塞拉尔沃
Cabezón de la Sierra	卡韦松德拉谢拉
Cabañes de Esgueva	卡瓦涅斯德埃斯格瓦
Cardeñadijo	卡尔德尼亚迪霍
Castrillo de Riopisuerga	卡斯特里略德里奥皮苏埃尔加
La Puebla de Arganzón (Burgos)	拉普埃夫拉德亚尔甘松
Agallas	阿加利亚斯
Abusejo	阿武塞霍
Posada de Valdeón	波萨达德瓦尔德翁
Valderrey	巴尔德雷
Joarilla de las Matas	霍阿里利亚德拉斯马塔斯
Neila (Burgos)	内拉
Santiago Millas	桑蒂亚戈米利亚斯
Turcia	图尔西亚
Prioro	普里奥罗
Valdelugueros	巴尔德卢格罗斯
Santas Martas	桑塔斯马尔塔斯
Vegaquemada	贝加克马达
Pobladura de Pelayo García	波夫拉杜拉德佩莱奥加尔西亚
Navas de Bureba (Burgos)	纳瓦斯德武雷瓦
Vegacervera	贝加塞尔韦拉
San Adrián del Valle	圣阿德里安德尔瓦列
Valdefuentes del Páramo	巴尔德丰特斯德尔帕拉莫
Jaramillo Quemado (Burgos)	哈拉米略克马多
Campillo de Aranda	坎皮略德亚兰达
Jaramillo de la Fuente (Burgos)	哈拉米略德拉丰特
Carcedo de Bureba	卡尔塞多德武雷瓦
Cebrecos	塞夫雷科斯
La Fuente de San Esteban	拉丰特德圣埃斯特万
Aldeanueva de Figueroa	菲格罗阿新村
Cerezal de Peñahorcada	塞雷萨尔德佩尼亚奥尔卡达
Cabeza del Caballo	卡韦萨德尔卡瓦略
Lumbrales	伦夫拉莱斯
Villabraz	比利亚夫拉斯
Villamejil	比利亚梅希尔
Villaornate y Castro	比廖尔纳泰卡斯特罗
Valverde-Enrique	巴尔韦尔德-恩里克
Villaobispo de Otero	比廖维斯波德奥特罗
Villazanzo de Valderaduey	比利亚桑索德瓦尔德拉杜埃
Villanueva de las Manzanas	曼萨纳斯新镇
Villamandos	比利亚曼多斯
Villamol	比利亚莫尔
Villaselán	比利亚塞兰
Villamoratiel de las Matas	比利亚莫拉铁尔德拉斯马塔斯
Toral de los Guzmanes	托拉尔德洛斯古斯马内斯
Bañobárez	巴尼奥瓦雷斯
Barruecopardo	巴鲁埃科帕尔多
Carrascal del Obispo	卡拉斯卡尔德洛维斯波
Castillejo de Martín Viejo	卡斯蒂列霍德马尔廷维耶霍
Fuenteguinaldo	丰特吉纳尔多
Iruelos	伊鲁埃洛斯
Tamames	塔马梅斯
Bóveda del Río Almar	博韦达德尔里奥阿尔马尔
Doñinos de Ledesma	多尼伊诺斯德莱德斯马
Encina de San Silvestre	恩西纳德圣西尔韦斯特雷
Canillas de Abajo	下卡尼利亚斯
Castellanos de Villiquera	卡斯特利亚诺斯德维利克拉
Carpio de Azaba	卡尔皮奥德亚萨瓦
Doñinos de Salamanca	多尼伊诺斯德萨拉曼卡
Cantaracillo	坎塔拉西略
Las Casas del Conde	拉斯卡萨斯德尔孔德
Aldeaseca de la Frontera	阿尔德亚塞卡德拉夫龙特拉
Castraz	卡斯特拉斯
Cepeda (Salamanca)	塞佩达
El Tornadizo	埃尔托尔纳迪索
Aldeaseca de Alba	阿尔德亚塞卡德亚尔瓦
Navamorales	纳瓦莫拉莱斯
El Cabaco	埃尔卡瓦科
Aldeanueva de la Sierra	谢拉新村
Cipérez	西佩雷斯
Cantalpino	坎塔尔皮诺
Colmenar de Montemayor	科尔梅纳尔德蒙特迈奥尔
Espadaña (Salamanca)	埃斯帕达尼亚
Cespedosa de Tormes	塞斯佩多萨德托尔梅斯
Carbajosa de la Sagrada	卡尔瓦霍萨德拉萨格拉达
Cabrillas	卡夫里利亚斯
Berrocal de Huebra	贝罗卡尔德韦夫拉
Calvarrasa de Abajo	下卡尔瓦拉萨
Cilleros de la Bastida	西列罗斯德拉瓦斯蒂达
Sotresgudo (Burgos)	索特雷斯古多
Arapiles	阿拉皮莱斯
Benavides	贝纳维德斯
Tordómar (Burgos)	托尔多马尔
Torrelara (Burgos)	托雷拉拉
San Millán de Lara (Burgos)	圣米良德拉拉
Sordillos (Burgos)	索尔迪略斯
Santa María del Mercadillo (Burgos)	圣马里亚德尔梅尔卡迪略
Santa Cruz de la Salceda (Burgos)	圣克鲁斯德拉萨尔塞达
Santa Gadea del Cid (Burgos)	圣加德亚德尔西德
Tamarón (Burgos)	塔马龙
San Mamés de Burgos (Burgos)	圣马梅斯德武尔戈斯
Santa María del Campo (Burgos)	圣马里亚德尔坎波
San Vicente del Valle (Burgos)	圣比森特德尔瓦列
Sarracín (Burgos)	萨拉辛
Salinillas de Bureba (Burgos)	萨利尼利亚斯德武雷瓦
Villazopeque (Burgos)	比利亚索佩克
Vilviestre del Pinar (Burgos)	比尔维耶斯特雷德尔皮纳尔
Saldaña de Burgos (Burgos)	萨尔达尼亚德武尔戈斯
Tejada (Burgos)	特哈达
Tobar (Burgos)	托瓦尔
Santa Olalla de Bureba (Burgos)	圣奥拉利亚德武雷瓦
San Adrián de Juarros (Burgos)	圣阿德里安德华罗斯
Santa María del Invierno (Burgos)	圣马里亚德林维耶尔诺
Tinieblas de la Sierra (Burgos)	蒂涅夫拉斯德拉谢拉
Villaquirán de la Puebla (Burgos)	比利亚基兰德拉普埃夫拉
Villalbilla de Gumiel (Burgos)	比利亚尔维利亚德古米耶尔
Villanueva de Gumiel (Burgos)	古米耶尔新镇
Villaverde del Monte (Burgos)	比利亚韦尔德德尔蒙特
Villaescusa la Sombría (Burgos)	比利艾斯库萨拉松夫里亚
Villayerno Morquillas (Burgos)	比利艾埃尔诺莫尔基利亚斯
Villegas (Burgos)	比列加斯
Vileña (Burgos)	比莱尼亚
Rezmondo (Burgos)	雷斯蒙多
Villafruela (Burgos)	比利亚夫鲁埃拉
Villariezo (Burgos)	比利亚列索
Villagalijo (Burgos)	比利亚加利霍
Rublacedo de Abajo (Burgos)	下鲁夫拉塞多
Villamayor de Treviño (Burgos)	特雷维尼奥大镇
Royuela de Río Franco (Burgos)	罗尤埃拉德里奥夫兰科
Villaldemiro (Burgos)	比利亚尔德米罗
Villaverde-Mogina (Burgos)	比利亚韦尔德-莫希纳
Revillarruz (Burgos)	雷维利亚鲁斯
Villamayor de los Montes (Burgos)	蒙特斯大镇
Villamedianilla (Burgos)	比利亚梅迪亚尼利亚
Villalmanzo (Burgos)	比利亚尔曼索
Villaespasa (Burgos)	比利艾斯帕萨
Valles de Palenzuela (Burgos)	巴列斯德帕伦苏埃拉
Quintanaélez (Burgos)	金塔奈莱斯
Vallejera (Burgos)	巴列赫拉
Vallarta de Bureba (Burgos)	巴利亚尔塔德武雷瓦
Redecilla del Campo (Burgos)	雷德西利亚德尔坎波
Quintanabureba (Burgos)	金塔纳武雷瓦
Quintanaortuño (Burgos)	金塔瑙尔图尼奥
Quintanapalla (Burgos)	金塔纳帕利亚
Valle de Losa (Burgos)	巴列德洛萨
Regumiel de la Sierra (Burgos)	雷古米耶尔德拉谢拉
Quintanilla Vivar (Burgos)	金塔尼利亚维瓦尔
Poza de la Sal (Burgos)	波萨德拉萨尔
Quintanilla del Agua y Tordueles (Burgos)	金塔尼利亚德拉瓜伊托尔杜埃莱斯
Quintanilla de la Mata (Burgos)	金塔尼利亚德拉马塔
Fuentenebro (Burgos)	丰特内夫罗
La Revilla y Ahedo (Burgos)	拉雷维利艾阿埃多
Hacinas (Burgos)	阿西纳斯
Prádanos de Bureba (Burgos)	普拉达诺斯德武雷瓦
Fresno de Rodilla (Burgos)	夫雷斯诺德罗迪利亚
La Vid	拉维迪瓦里奥斯
Junta de Villalba de Losa (Burgos)	洪塔德维利亚尔瓦德洛萨
Hortigüela (Burgos)	奥尔蒂格拉
Villangómez (Burgos)	比良戈梅斯
Madrigalejo del Monte (Burgos)	马德里加莱霍德尔蒙特
Mahamud (Burgos)	马阿穆德
Presencio (Burgos)	普雷森西奥
Cilleruelo de Abajo	下锡列鲁埃洛
Madrigal del Monte (Burgos)	马德里加尔德尔蒙特
Manciles (Burgos)	曼西莱斯
Fuentebureba (Burgos)	丰特武雷瓦
Padrones de Bureba (Burgos)	帕德罗内斯德武雷瓦
Melgar de Fernamental (Burgos)	梅尔加尔德费尔纳门塔尔
Ibrillos (Burgos)	伊夫里略斯
La Vid de Bureba (Burgos)	拉维德武雷瓦
Palazuelos de la Sierra (Burgos)	帕拉苏埃洛斯德拉谢拉
Merindad de Sotoscueva (Burgos)	梅林达德索托斯库埃瓦
Castrillo del Val	卡斯特里略德尔瓦尔
Valdorros (Burgos)	巴尔多罗斯
Los Ausines (Burgos)	洛绍西内斯
Merindad de Cuesta-Urria (Burgos)	梅林达德库埃斯塔-乌里亚
Los Barrios de Bureba (Burgos)	洛斯瓦里奥斯德武雷瓦
Valle de Manzanedo (Burgos)	巴列德曼萨内多
Hontoria de Valdearados (Burgos)	翁托里亚德瓦尔德亚拉多斯
Fuentecén (Burgos)	丰特森
Miraveche (Burgos)	米拉韦切
Fresnillo de las Dueñas (Burgos)	夫雷斯尼略德拉斯杜埃尼亚斯
Piérnigas (Burgos)	彼尔尼加斯
Ciruelos de Cervera	西鲁埃洛斯德塞尔韦拉
Pinilla Trasmonte (Burgos)	皮尼利亚特拉斯蒙特
Valdezate (Burgos)	巴尔德萨特
Trespaderne (Burgos)	特雷斯帕德尔内
Pineda Trasmonte (Burgos)	皮内达特拉斯蒙特
Peral de Arlanza (Burgos)	佩拉尔德亚尔兰萨
Puentedura (Burgos)	蓬特杜拉
Cogollos	科戈略斯
Cerratón de Juarros	塞拉通德华罗斯
Mambrillas de Lara (Burgos)	曼夫里利亚斯德拉拉
Castrillo de la Reina	卡斯特里略德拉雷纳
Merindad de Valdivielso (Burgos)	梅林达德瓦尔迪维耶尔索
Modúbar de la Emparedada (Burgos)	莫杜瓦尔德莱恩帕雷达达
Huerta de Rey	韦尔塔德雷
Cascajares de Bureba	卡斯卡哈雷斯德武雷瓦
Cayuela	凯韦拉
Villalonso	比利亚隆索
Moraleja del Vino	莫拉莱哈德尔维诺
Castrogonzalo	卡斯特罗贡萨洛
El Perdigón	埃尔佩尔迪贡
Santa Cristina de la Polvorosa	圣克里斯蒂纳德拉波尔沃罗萨
Lubián	卢维安
Valdefinjas	巴尔德芬哈斯
Morales del Vino	莫拉莱斯德尔维诺
Matilla la Seca	马蒂利亚拉塞卡
Navasfrías	纳瓦斯夫里亚斯
Coreses	科雷塞斯
Villalpando	比利亚尔潘多
Hermisende	埃尔米森德
Pobladura de Valderaduey	波夫拉杜拉德瓦尔德拉杜埃
Villaralbo	比利亚拉尔沃
Galende	加伦德
Puebla de Sanabria	普埃夫拉德萨纳夫里亚
Roales	罗阿莱斯
Mayalde	迈阿尔德
Robleda	罗夫莱达
Granucillo	格拉努西略
Bogajo	博加霍
Tarazona de Guareña	塔拉索纳德瓜雷尼亚
Gejuelo del Barro	赫胡埃洛德尔瓦罗
Nava de Francia	纳瓦德夫兰西亚
Tardáguila	塔尔达吉拉
Encinasola de los Comendadores	恩西纳索拉德洛斯科门达多雷斯
Tordillos	托尔迪略斯
Nava de Sotrobal	纳瓦德索特罗瓦尔
Yecla de Yeltes	耶克拉德埃尔特斯
Navalmoral de Béjar	纳瓦尔莫拉尔德韦哈尔
Trabanca	特拉万卡
Garcirrey	加尔西雷
Navarredonda de la Rinconada	纳瓦雷东达德拉林科纳达
Tejeda y Segoyuela	特赫代塞戈尤埃拉
Escurial de la Sierra	埃斯库里亚尔德拉谢拉
El Tejado	埃尔特哈多
Barbadillo	巴尔瓦迪略
Carrascal de Barregas	卡拉斯卡尔德瓦雷加斯
Campillo de Azaba	坎皮略德亚萨瓦
Aldeacipreste	阿尔德亚西普雷斯特
Ejeme	埃赫梅
Calzada de Don Diego	卡尔萨达德东迭戈
Añover de Tormes	阿尼奥韦尔德托尔梅斯
Aldeavieja de Tormes	阿尔德亚维耶哈德托尔梅斯
Torresmenudas	托雷斯梅努达斯
Espino de la Orbada	埃斯皮诺德劳尔瓦达
La Redonda	拉雷东达
Moncalvillo (Burgos)	蒙卡尔维略
Pedralba de la Pradería	佩德拉尔瓦德拉普拉德里亚
Dios le Guarde	迪奥斯莱瓜尔德
Galisancho	加利桑乔
Terradillos	特拉迪略斯
Fuenterroble de Salvatierra	丰特罗夫莱德萨尔瓦铁拉
Almendra (Salamanca)	阿尔门德拉
Estépar (Burgos)	埃斯特帕尔
Carrizo	卡里索
Vallecillo	巴列西略
Espinosa de Cervera (Burgos)	埃斯皮诺萨德塞尔韦拉
Úrbel del Castillo (Burgos)	乌尔韦尔德尔卡斯蒂略
Grijalba (Burgos)	格里哈尔瓦
Benegiles	贝内希莱斯
Almaraz de Duero	阿尔马拉斯德杜埃罗
Arcenillas	阿尔塞尼利亚斯
Carbajales de Alba	卡尔瓦哈莱斯德亚尔瓦
Argañín	阿尔加宁
Arrabalde	阿拉瓦尔德
Algodre	阿尔戈德雷
Bermillo de Sayago	贝尔米略德赛阿戈
Arcos de la Polvorosa	阿尔科斯德拉波尔沃罗萨
Alcubilla de Nogales	阿尔库维利亚德诺加莱斯
Andavías	安达维亚斯
Aldeatejada	阿尔德亚特哈达
Balboa (León)	巴尔沃阿
Buenamadre	布埃纳马德雷
Alba de Yeltes	阿尔瓦德埃尔特斯
Coca de Alba	科卡德亚尔瓦
Aldehuela de la Bóveda	阿尔德韦拉德拉沃韦达
Olmedo de Camaces	奥尔梅多德卡马塞斯
Gomecello	戈梅塞略
Cordovilla (Salamanca)	科尔多维利亚
Herguijuela del Campo	埃尔吉胡埃拉德尔坎波
Fuenteliante	丰特利安特
Herguijuela de Ciudad Rodrigo	埃尔吉胡埃拉德休达德罗德里戈
Herguijuela de la Sierra	埃尔吉胡埃拉德拉谢拉
Armenteros	阿尔门特罗斯
Encinas de Arriba	上恩西纳斯
Hinojosa de Duero	伊诺霍萨德杜埃罗
Encinas de Abajo	下恩西纳斯
Cabezabellosa de la Calzada	卡韦萨韦略萨德拉卡尔萨达
Cristóbal de la Sierra (Salamanca)	克里斯托瓦尔
La Orbada	劳尔瓦达
La Rinconada de la Sierra	拉林科纳达德拉谢拉
Chagarcía Medianero	查加尔西亚梅迪亚内罗
Berrocal de Salvatierra	贝罗卡尔德萨尔瓦铁拉
Manganeses de la Polvorosa	曼加内塞斯德拉波尔沃罗萨
Villavendimio	比利亚文迪米奥
Muelas del Pan	穆埃拉斯德尔潘
Fuentes de Ropel	丰特斯德罗佩尔
Videmala	比德马拉
Vezdemarbán	贝斯德马尔万
Maire de Castroponce	迈雷德卡斯特罗蓬塞
Cerecinos del Carrizal	塞雷西诺斯德尔卡里萨尔
Villanueva de Campeán	坎佩亚恩新镇
Brime de Urz	布里梅德乌尔斯
Cabañas de Sayago	卡瓦尼亚斯德赛阿戈
Pozoantiguo	波索安蒂果
Fresno de la Ribera	弗雷斯诺德拉里韦拉
Bustillo del Oro	布斯蒂略德洛罗
El Piñero	埃尔皮涅罗
Melgar de Tera	梅尔加尔德特拉
Pinilla de Toro	皮尼利亚德托罗
Sanzoles	桑索莱斯
Madridanos	马德里达诺斯
Monfarracinos	蒙法拉西诺斯
Fresno de la Polvorosa	弗雷斯诺德拉波尔沃罗萨
Entrala	恩特拉拉
Jambrina	汉夫里纳
Villaseco del Pan	比利亚塞科德尔潘
Castronuevo	卡斯特罗努埃沃
Fuente Encalada	丰滕卡拉达
Torres del Carrizal	托雷斯德尔卡里萨尔
Villardondiego	比利亚尔东迭戈
Calzadilla de Tera	卡尔萨迪利亚德特拉
Cubo de Benavente	库沃德韦纳韦恩特
Molezuelas de la Carballeda	莫莱苏埃拉斯德拉卡尔瓦列达
Santibáñez de Vidriales	桑蒂瓦涅斯德维德里亚莱斯
Fonfría (Zamora)	丰夫里亚
San Cristóbal de Entreviñas	圣克里斯托瓦尔登特雷维尼亚斯
Villar de Fallaves	法利亚韦斯村
Santa María de Valverde	圣马里亚德瓦尔韦尔德
Riofrío de Aliste	里奥夫里奥德亚利斯特
Revilla del Campo (Burgos)	雷维利亚德尔坎波
Humada (Burgos)	乌马达
Pampliega (Burgos)	潘普列加
Padilla de Abajo (Burgos)	下帕迪利亚
Valle de las Navas (Burgos)	巴列德拉斯纳瓦斯
Valle de Santibáñez (Burgos)	巴列德桑蒂瓦涅斯
Santa María Rivarredonda (Burgos)	圣马里亚里瓦雷东达
Valle de Oca (Burgos)	巴列德奥卡
Villaquirán de los Infantes (Burgos)	比利亚基兰德洛辛凡特斯
Valle de Valdelucio (Burgos)	巴列德瓦尔德卢西奥
Rebolledo de la Torre (Burgos)	雷沃列多德拉托雷
Villoruebo (Burgos)	比略鲁埃沃
Cubo de Bureba	库沃德武雷瓦
Cubillos	库维略斯
Viñas	比尼亚斯
Villasur de Herreros (Burgos)	比利亚苏尔德埃雷罗斯
Villasandino (Burgos)	比利亚桑迪诺
Santa Cruz del Valle Urbión (Burgos)	圣克鲁斯德尔瓦列乌尔维翁
Revilla Vallejera (Burgos)	雷维利亚瓦列赫拉
Rábanos (Burgos)	拉瓦诺斯
Quintanilla San García (Burgos)	金塔尼利亚圣加尔西亚
Torregalindo (Burgos)	托雷加林多
Pineda de la Sierra (Burgos)	皮内达德拉谢拉
Pedrosa de Río Úrbel (Burgos)	佩德罗萨德里欧尔韦尔
Quintanavides (Burgos)	金塔纳维德斯
Pedrosa del Páramo (Burgos)	佩德罗萨德尔帕拉莫
Salas de Bureba (Burgos)	萨拉斯德武雷瓦
Reinoso (Burgos)	雷诺索
Fresno de Río Tirón (Burgos)	夫雷斯诺德里奥蒂龙
Hontoria de la Cantera (Burgos)	翁托里亚德拉坎特拉
Las Hormazas (Burgos)	拉斯奥尔马萨斯
Las Quintanillas (Burgos)	拉斯金塔尼利亚斯
Frandovínez (Burgos)	夫兰多维内斯
Horcajo de Montemayor	奥尔卡霍德蒙特迈奥尔
Rosinos de la Requejada	罗西诺斯德拉雷克哈达
Villalcampo	比利亚尔坎波
Quintanilla del Olmo	金塔尼利亚德洛尔莫
Trefacio	特雷法西奥
Palacios del Pan	帕拉西奥斯德尔潘
Venialbo	贝尼亚尔沃
Bretó	布雷托
Santa Clara de Avedillo	圣克拉拉德亚韦迪略
Otero de Bodas	奥特罗德沃达斯
Ferreras de Arriba	上费雷拉斯
Peleagonzalo	佩莱亚贡萨洛
Pías	皮亚斯
Tábara	塔瓦拉
Fuentespreadas	丰特斯普雷亚达斯
Villanueva del Campo	坎波新镇
Robleda-Cervantes	罗夫莱达-塞尔万特斯
Valcabado	巴尔卡瓦多
Friera de Valverde	弗列拉德瓦尔韦尔德
Olmillos de Castro	奥尔米略斯德卡斯特罗
Riaño	里亚尼奥
Villadecanes	比利亚德卡内斯
Matilla de Arzón	马蒂利亚德亚尔松
La Torre del Valle	拉托雷德尔瓦列
Aldehuela de Yeltes	阿尔德韦拉德埃尔特斯
Mombuey	蒙武埃
Fresneña (Burgos)	夫雷斯内尼亚
Monasterio de Rodilla (Burgos)	莫纳斯特里奥德罗迪利亚
Cuelgamures	库埃尔加穆雷斯
Coomonte	科奥蒙特
Huerta de Arriba	上韦尔塔
La Hiniesta	拉伊涅斯塔
Fuentesaúco	丰特绍科
Arquillinos	阿尔基利诺斯
Alfaraz de Sayago	阿尔法拉斯德赛阿戈
Almeida de Sayago	阿尔梅达德赛阿戈
Ayoó de Vidriales	艾奥奥德维德里亚莱斯
Molacillos	莫拉西略斯
Huérmeces (Burgos)	韦尔梅塞斯
Brime de Sog	布里梅德索格
Anaya de Alba	阿奈阿德亚尔瓦
Bretocino	布雷托西诺
Cubillo del Campo	库维略德尔坎波
Montamarta	蒙塔马尔塔
Micereces de Tera	米塞雷塞斯德特拉
Moreruela de los Infanzones	莫雷鲁埃拉德洛辛凡索内斯
Casaseca de las Chanas	卡萨塞卡德拉斯查纳斯
Luelmo	卢埃尔莫
Santo Domingo de Silos (Burgos)	桑托多明戈德西洛斯
San Vicente de la Cabeza	圣比森特德拉卡韦萨
San Miguel de la Ribera	圣米格尔德拉里韦拉
Barcial del Barco	巴尔西亚尔德尔瓦尔科
Santa María de la Vega	圣马里亚德拉韦加
Torregamones	托雷加莫内斯
San Pedro de la Nave-Almendra	圣佩德罗德拉纳韦-阿尔门德拉
San Pedro de Ceque	圣佩德罗德塞克
Santibáñez de Tera	桑蒂瓦涅斯德特拉
Aspariegos	阿斯帕列戈斯
Porto (Zamora)	波尔托
San Vitero	圣比特罗
Quintanilla de Urz	金塔尼利亚德乌尔斯
Salce	萨尔塞
Quiruelas de Vidriales	基鲁埃拉斯德维德里亚莱斯
Pueblica de Valverde	普埃夫利卡德瓦尔韦尔德
San Agustín del Pozo	圣阿古斯廷德尔波索
Villabuena del Puente	比利亚武埃纳德尔蓬特
San Cebrián de Castro	圣塞夫里安德卡斯特罗
Tabera de Abajo	下塔韦拉
Samir de los Caños	萨米尔德洛斯卡尼奥斯
Tenebrón	特内夫龙
Villamayor de Campos	坎波斯大镇
Vadillo de la Guareña	巴迪略德拉瓜雷尼亚
Tapioles	塔皮奥莱斯
Santa Colomba de las Monjas	圣科隆瓦德拉斯蒙哈斯
Vega de Tera	贝加德特拉
Valdescorriel	巴尔德斯科列尔
Santa Croya de Tera	圣克罗亚德特拉
Pobladura del Valle	波夫拉杜拉德尔瓦列
Villadepera	比利亚德佩拉
Villarrín de Campos	比利亚林德坎波斯
Zamarra	萨马拉 (萨拉曼卡省)
San Esteban del Molar	圣埃斯特万德尔莫拉尔
Revellinos	雷韦利诺斯
Villárdiga	比利亚尔迪加
Vallesa de la Guareña	巴列萨德拉瓜雷尼亚
San Miguel del Valle	圣米格尔德尔瓦列
Robliza de Cojos	罗夫利萨德科霍斯
Fresnedoso	弗雷斯内多索
Nava de Béjar	纳瓦德韦哈尔
Narros de Matalayegua	纳罗斯德马塔莱埃瓜
Fresno Alhándiga	弗雷斯诺阿尔安迪加
Florida de Liébana	弗洛里达德列瓦纳
Navales	纳瓦莱斯
Navacarros	纳瓦卡罗斯
La Bastida	拉瓦斯蒂达 (萨拉曼卡省)
La Fregeneda	拉夫雷赫内达
Muga de Sayago	穆加德赛阿戈
Cobreros	科夫雷罗斯
Villar del Buey	布埃村
El Pego	埃尔佩戈
Moraleja de Sayago	莫拉莱哈德赛阿戈
Villageriz	比利亚赫里斯
Perilla de Castro	佩里利亚德卡斯特罗
Mahide	马伊德
Moralina	莫拉利纳
Pajares de la Lampreana	帕哈雷斯德拉兰普雷亚纳
Cerecinos de Campos	塞雷西诺斯德坎波斯
Morales de Valverde	莫拉莱斯德瓦尔韦尔德
Fresno de Sayago	弗雷斯诺德赛阿戈
Villalba de la Lampreana	比利亚尔瓦德拉兰普雷亚纳
Villamor de los Escuderos	比利亚莫尔德洛塞斯库德罗斯
Vega de Villalobos	贝加德维利亚洛沃斯
Moral de Sayago	莫拉尔德赛阿戈
Rionegro del Puente	里奥内格罗德尔蓬特
Pereruela	佩雷鲁埃拉
Muelas de los Caballeros	穆埃拉斯德洛斯卡瓦列罗斯
Morales de Rey	莫拉莱斯德雷
Fuentelapeña	丰特拉佩尼亚
Piedrahita de Castro	彼德拉伊塔德卡斯特罗
Roelos	罗埃洛斯德赛阿戈
Espadañedo	埃斯帕达涅多
Villabrázaro	比利亚夫拉萨罗
Villardeciervos	比利亚尔德希耶尔沃斯
Uña de Quintana	乌尼亚德金塔纳
Prado (Zamora)	普拉多
Cotanes del Monte	科塔内斯德尔蒙特
Navianos de Valverde	纳维亚诺斯德瓦尔韦尔德
Palacios de Sanabria	帕拉西奥斯德萨纳夫里亚
Cernadilla	塞尔纳迪利亚
Larrodrigo	拉罗德里戈
La Bóveda de Toro	拉沃韦达德托罗
Manganeses de la Lampreana	曼加内塞斯德拉兰普雷亚纳
Endrinal (Salamanca)	恩德里纳尔
Espeja	埃斯佩哈
Rágama	拉加马
El Cerro (Salamanca)	埃尔塞罗
El Cubo del Vino	埃尔库沃德铁拉德尔维诺
Truchas	特鲁查斯
Villanueva de Azoague	阿索阿格新镇
La Alameda de Gardón	拉拉梅达德加尔东
La Alamedilla	拉拉梅迪利亚
Galindo y Perahuy	加林多伊佩拉维
La Cabeza de Béjar	拉卡韦萨德韦哈尔
Galinduste	加林杜斯特
Justel	胡斯特尔
Ledrada	莱德拉达
La Hoya (Salamanca)	拉奥亚
Guarrate	瓜拉特
Gallegos de Argañán	加列戈斯德亚尔加尼扬
La Alberguería de Argañán	拉尔韦尔格里亚德亚尔加尼扬
Horcajo Medianero	奥尔卡霍梅迪亚内罗
Arcediano	阿尔塞迪亚诺
Candelario	坎德拉里奥
Guadramiro	瓜德拉米罗
Boada	博阿达
Manzanal de Arriba	上曼萨纳尔
Gallegos de Solmirón	加列戈斯德索尔米龙
Juzbado	胡斯瓦多
Golpejas	戈尔佩哈斯
La Tala	拉塔拉
Gamones	加莫内斯
Granja de Moreruela	格兰哈德莫雷鲁埃拉
Asturianos	阿斯图里亚诺斯
Argujillo	阿尔古希略
Castroverde de Campos	卡斯特罗韦尔德德坎波斯
Castrillo de la Guareña	卡斯特里略德拉瓜雷尼亚
Carbellino	卡尔韦利诺
Los Altos (Burgos)	洛斯阿尔托斯 (西班牙)
Retortillo (Salamanca)	雷托尔蒂略
El Arco	埃拉尔科
Villalobos	比利亚洛沃斯
Villaveza de Valverde	比利亚韦萨德瓦尔韦尔德
Quintanilla del Monte	金塔尼利亚德尔蒙特
Rábano de Aliste	拉瓦诺德亚利斯特
Ferreruela	费雷鲁埃拉
Villanueva de las Peras	佩拉斯新镇
San Justo (Zamora)	圣胡斯托 (萨莫拉省)
Villaferrueña	比利亚费鲁埃尼亚
Fariza	法里萨
Villaescusa (Zamora)	比利艾斯库萨
Malva (Zamora)	马尔瓦 (萨莫拉省)
Cantagallo	坎塔加略
Māhele:Disambig	Category:消歧义
Valle de Valdelaguna (Burgos)	巴列德瓦尔德拉古纳
Beleña	贝莱尼亚
Cavia (Burgos)	卡维亚
Lagunilla	拉古尼利亚
Gajates	加哈特斯
Fuentes de Béjar	丰特斯德韦哈尔
Santa Inés (Burgos)	圣伊内斯
Guijo de Ávila	吉霍德亚维拉
Contreras	孔特雷拉斯
Buenavista	布埃纳维斯塔
Isar (Burgos)	伊萨尔
Huerta (Salamanca)	韦尔塔
Wailuku	怀卢库
Hua mele hapa hanelekūmāiwakāluakūmāwalu	一百二十八分音符
Hua mele hapa kanaonokūmāhā	六十四分音符
Sanna Nielsen	桑娜·尼尔森
Nakayama Miki	中山美伎
Māhele:Nā ‘āinapuni‘ole	Category:大洲
Anakuhi:Nā hōkū hele o ke kahua o nā hōkū	Template:太阳系
Úrsula Murayama	厄休拉村山富市
Kula ʻo Punahou	普納荷學校
Anakuhi:WikipediaLang	Template:Wikipedialang
Wikipedia:Nā kahu	Wikipedia:管理员
Wikipedia:Nā noi e ho‘oki‘eki‘e	Wikipedia:申请成为管理人员
Wikipedia:Lopako	Wikipedia:机器人
‘Aikupika	埃及
Anakuhi:Lopako	Template:Bot
Kanakā	加拿大
Māhele:Hunakalia	Category:匈牙利
Māhele:Helene	Category:希腊
Māhele:Solowakia	Category:斯洛伐克
Māhele:ʻEulopa	Category:欧洲
Māhele:Wikipedians by language	Category:用户语言
Wikipedia:‘Ōmuku	Wikipedia:小作品
Sung Jae-gi	成在基
Anakuhi:Softredirect	Template:軟重定向
Anakuhi:Kāpae	Template:Delete
Māhele:‘Ōlelo	Category:语言
Māhele:Wikipikia	Category:维基百科
Wikipedia:Nā a‘o ‘ana laulā	Wikipedia:免责声明
Wikipedia:Manuale Kaila	Wikipedia:格式手册
Anakuhi:Navbox	Template:Navbox
Nina Andrycz	尼娜·安德雷奇
Anakuhi:Tnavbar	Template:Navbar
Anakuhi:Okina	Template:Okina
Māhele:ʻApelika	Category:非洲
Anakuhi:Papela	Template:Babel
Anakuhi:Commons	Template:Commons
Anakuhi:ʻŌmuku	Template:Stub
Anakuhi:User de	Template:User de
Anakuhi:User en	Template:User en
Anakuhi:User fr	Template:User fr
Māhele:ʻĀkia	Category:亚洲
Māhele:21st century	Category:21世纪
Anakuhi:Mod	Template:Mod
Anakuhi:Aloha	Template:Welcome
Anakuhi:Wikipediasister	Template:Wikipediasister
Anakuhi:Wide image	Template:Wide image
Māhele:Palika	Category:巴黎
Māhele:User en	Category:En 使用者
Anakuhi:User ru	Template:User ru
Māhele:Nā hōkū hele o ke kahua o nā hōkū	Category:太阳系行星
Anakuhi:User blank	Template:User language-N
Anakuhi:Ho‘okele nā makahiki	Template:YearTOC
Anakuhi:Pule	Template:星期中的日子
Anakuhi:Huaʻōlelo puana like	Template:Disambig
Māhele:Aliʻi o Hawai‘i	Category:夏威夷王國君主
Anakuhi:Nā ‘āinapuni‘ole	Template:洲
Māhele:User fr	Category:Fr 使用者
Māhele:Mea hoʻohana haw	Category:Haw 使用者
Māhele:Panalāʻau o Quảng Binh	Category:廣平省
Māhele:User de	Category:De 使用者
Māhele:User de-N	Category:De 母語使用者
Māhele:User en-N	Category:En 母语使用者
Anakuhi:ʻŌnaehana helu	Template:數
Māhele:Huli kanaka	Category:社会科学
Māhele:Kahawai o Palani	Category:法國河流
Māhele:User ru	Category:Ru 使用者
Anakuhi:Sepania	Template:西班牙行政区
Māhele:Kahaki‘i	Category:画家
Māhele:Hawai‘i	Category:夏威夷州
Māhele:Kanaka o Hawaiʻi	Category:夏威夷人
Māhele:Kelewikiona	Category:电视
Māhele:Nolewai	Category:挪威
Māhele:Nā moana	Category:远洋
Māhele:Kapikala	Category:首都
Māhele:Honolulu	Category:檀香山
Trojany	特洛疆尼
Māhele:Haku mele (ho‘okani)	Category:作曲家
Māhele:Oʻahu	Category:歐胡島
Module:Citation/CS1/Whitelist	模块:Citation/CS1/Whitelist
Module:Yesno	模块:Yesno
Module:Category handler	模块:Category handler
Yun Hyon-seok	六友堂
Module:Arguments	模块:Arguments
Papa nui:NāLoliHou	Special:最近更改
Module:Citation/CS1	模块:Citation/CS1
Module:Citation/CS1/Configuration	模块:Citation/CS1/Configuration
Module:Namespace detect	模块:Namespace detect
Module:HtmlBuilder	模块:HtmlBuilder
Module:Navbar	模块:Navbar
Module:Navbox	模块:Navbox
Module:Userbox	模块:Userbox
