អាហ្វ្រិក	非洲
ជប៉ុន	日本
អង់គ្លេស	英格兰
ស្កុតឡែន	蘇格蘭
វ៉ែល	威爾士
អៀរឡង់ខាងជើង	北爱尔兰
សាធារណរដ្ឋអៀរឡង់	爱尔兰共和国
ប្រទេសហុងគ្រី	匈牙利
អេស្ប៉ាញ	西班牙
សហរដ្ឋអាមេរិក	美国
ផែនដី	地球
ប៊ឺណឺស លី	蒂姆·伯纳斯-李
ស៊ុយអែត	瑞典
ប្រទេសប៉ូឡូញ	波兰
អ៊ីតាលី	意大利
ព័រទុយហ្គាល់	葡萄牙
អឺរ៉ុប	欧洲
អាស៊ី	亚洲
វិគីភីឌា	维基百科
ភីអេចភី	PHP
ទីក្រុងញូវយ៉ក	纽约
កុំព្យូទ័រ	電子計算機
អ៊ីនធើណេត	互联网
បារ៉ាក់ អូបាម៉ា	贝拉克·奥巴马
ប៉ារីស	巴黎
អាប្រាហាម លីនខូន	亚伯拉罕·林肯
ប្រព័ន្ធប្រតិបត្តការ Android	Android
Google ស្វែងរក	Google
ម៉ិកស៊ិក	墨西哥
មហាសមុទ្រអាត្លង់ទិក	大西洋
មហាសមុទ្រប៉ាស៊ីហ្វិក	太平洋
ថ្ងៃច័ន្ទ	星期一
ខែមករា	1月
ខែកុម្ភៈ	2月
ខែមីនា	3月
ភពអង្គារ	火星
ខែមេសា	4月
ខែឧសភា	5月
ខែមិថុនា	6月
ខែកក្កដា	7月
ខែសីហា	8月
ខែកញ្ញា	9月
ខែតុលា	10月
ខែវិច្ឆិកា	11月
ខែធ្នូ	12月
អង្គារ	星期二
ថ្ងៃពុធ	星期三
ថ្ងៃព្រហស្បតិ៍	星期四
ថ្ងៃសុក្រ	星期五
ថ្ងៃសៅរ៍	星期六
ថ្ងៃអាទិត្យ	星期日
សេះ (​អុក​)	馬 (國際象棋)
បារាំង	法国
សត្វឆ្កែ	犬
រាជាណាចក្ររួម	英国
ឆ្មា	猫
ភាសាបារាំង	法语
ប្រេស៊ីល	巴西
រុស្ស៊ី	俄罗斯
ការ៉េ	正方形
សមុទ្រ	海
អាល្លឺម៉ង់	德国
ភាសាអាល្លឺម៉ង់	德语
ប្រទេសអាយឡែន	冰岛
ភពសៅរ៍	土星
១ (លេខ)	1
២ (លេខ)	2
៣ (លេខ)	3
៥	5
ចតុកោណកែង	矩形
មុំកែង	直角
អ៊ុយក្រែន	乌克兰
ទីក្រុងរ៉ូម	罗马
អាល់បានី	阿尔巴尼亚
អាស៊ែបៃហ្សង់	阿塞拜疆
អង់ដូរ៉ា	安道尔
សាធារណរដ្ឋកាហ្សាក់ស្ថាន	哈萨克斯坦
បុរីវ៉ាទីកង់	梵蒂冈
គុយបា	古巴
ឥណ្ឌូនេស៊ី	印度尼西亚
អាហ្វ្រិកខាងត្បូង	南非
ប្រវត្តិសង្ខេប ក្រុមតន្រ្តី រ៉ុក linkin park	聯合公園
ប្រទេសអាល់ហ្សេរី	阿尔及利亚
ស្រា	葡萄酒
ទឹក	水
ទូរទស្សន៏	电视
ភាសាអាយឡែន	冰岛语
ឈីលី	智利
ព្រះយេស៊ូវ គ្រីស្ទ	耶稣
ភពពុធ	水星
ប្រវត្តិសាស្ត្រ	历史
ភពសុក្រ	金星
ភាសា	語言
ភពព្រហស្បតិ៍	木星
ភពអ៊ុយរ៉ានុស	天王星
វិគីភីឌាភាសាអង់គ្លេស	英语维基百科
ភពណិបទូន	海王星
សិង្ហបុរី	新加坡
ភ្លុយតុង	冥王星
ហ្វេសប៊ុក	Facebook
សង្គ្រាមលោកលើកទីមួយ	第一次世界大战
សង្គ្រាមលោកលើកទី២	第二次世界大战
ទំព័រគំរូ:Corruption	贪污
Ubuntu	Ubuntu
លីនុច	Linux
គណិតវិទ្យា	数学
បារ៉ែន	巴林
ព្រះចន្ទ	月球
អូស្ត្រាលី	澳大利亚
រូបវិទ្យា	物理学
ជីវវិទ្យា	生物学
កូរ៉េខាងជើង	朝鲜民主主义人民共和国
ព្រះរាជាណាចក្រកម្ពុជា	柬埔寨
ឌីណូស័រ	恐龙
សាសនាឥស្លាម	伊斯兰教
សេរីភាព	和平
សហភាពអឺរ៉ុប	欧洲联盟
ចេក	香蕉
ណាប៉ូលេអុងបូណាប៉ារត៍	拿破仑一世
ព្រះអាទិត្យ	太阳
ឆ្នាំពន្លឺ	光年
អូសេអានី	大洋洲
ប្រព័ន្ធព្រះអាទិត្យ	太阳系
អុីដ្រូសែន	氢
ទីម័រខាងកើត	东帝汶
ម៉ុង ប្លុង	勃朗峰
សឺរេស	穀神星
អៀរីស	阋神星
ភព	行星
តន្ត្រី	音乐
ភាសាអ៊ីតាលី	意大利语
អាលុយមីញ៉ូម	铝
នូវែលសេឡង់	新西兰
ឥណ្ឌា	印度
អង់ដ្រេ ម៉ារី អំពែរ	安德烈-馬里·安培
វីលីម ហ្សេកស្ពែរ	威廉·莎士比亚
ប៉ាឡាវ	帛琉
ម៉ុងហ្គោលី	蒙古国
ជេនហ្គិស ខាន់	成吉思汗
កូឡុំប៊ី	哥伦比亚
ព្រះពុទ្ធសាសនា	佛教
ហ្គាតេម៉ាឡា	危地马拉
មហាសមុទ្រអាកទិក	北冰洋
អ៊ីរ៉ង់	伊朗
ភាសាប៉ូឡូញ	波兰语
ហ្សកដង់	约旦
កៀហ៊្សីស៊ីស្ថាន	吉尔吉斯斯坦
គុយវ៉ែត	科威特
ឡាវ	老挝
លីបង់	黎巴嫩
ទ្វីបអាមេរិក	美洲
ម៉ាឡេស៊ី	马来西亚
មីយ៉ាន់ម៉ា	缅甸
នេប៉ាល់	尼泊尔
ប៉ាគីស្ថាន	巴基斯坦
MySQL	MySQL
អារ៉ាប៊ីសាអូឌីត	沙特阿拉伯
ស្រីលង្កា	斯里蘭卡
ផ្លាតូ	柏拉图
តាជីគីស្ថាន	塔吉克斯坦
YouTube	YouTube
អារីស្តូត	亚里士多德
ថៃ	泰国
វិទ្យុ	无线电
តួរមិនីស្ថាន	土库曼斯坦
វៀតណាម	越南
កូរ៉េខាងត្បូង	大韩民国
សាធារណរដ្ឋឥស្លាមអាហ្វហ្កានីស្ថាន	阿富汗
ព្រែកជីកស៊ុយអែស	苏伊士运河
បង់ក្លាដែស្ស	孟加拉国
សូក្រាត	苏格拉底
ធ្វិតថឺរ	Twitter
ប៊្រុយណេ	文莱
ហ្វីលីពីន	菲律宾
អ៊ីសាក់ ញូតុន	艾萨克·牛顿
OpenStreetMap	開放街圖
អាល់បឺត អែងស្តែង	阿尔伯特·爱因斯坦
ប្រទេសហ្សំប៊ី	赞比亚
ប៉េកាំង	北京市
មហាត្មះគន្ធី	圣雄甘地
ឆាលែស ដាវីន	查尔斯·达尔文
ជូលីស៍ សេសារ	尤利烏斯·凱撒
ឥន្ទធនូ	彩虹
អង្គការសហប្រជាជាតិ	联合国
ភូមិវិទ្យា	地理学
ទីក្រុងប្រាក	布拉格
បន្ទុកអគ្គីសនី	電荷
ខេត្តជើងភ្នំ (ប្រទេសអ៊ីតាលី)	皮埃蒙特
មហាសមុទ្រឥណ្ឌា	印度洋
អូសាម៉ា ប៊ីន ឡាឌែន	奥萨马·本·拉登
ភាសាអេស្ប៉ាញ	西班牙语
ភីឡាដេលផ្យា	費城
ញូវយ៉ក	纽约州
វ្លាឌីមៀរ អ៊ីលីច លេនីន	列宁
អូហ្គុសទុស	奥古斯都
លោកកៃយុសសេសារ	卡利古拉
ត្រាហ្សាន	圖拉真
Kde	KDE
កូរ៉ាស៊ូន អាគីណូ	柯拉蓉·艾奎諾
ទីក្រុងតូខ្យូ	東京都
ហ្វឺឌីណាន់ដ៏ ម៉ាហ្សេឡង់	斐迪南·麥哲倫
ស៊ីសេរ៉ូ	西塞罗
ភ្នំពេញ	金边
ទីក្រុងព្រៃនគរ	胡志明市
ទីក្រុងហានូយ	河內市
គ្រិស្តសាសនា	真耶稣教会
ភាសាអង់គ្លេស	英语
គូឡាឡាំពួ	吉隆坡
២០០១	2001年
JavaScript	JavaScript
HTML5	HTML5
ល្បឿនពន្លឺ	光速
JPEG	JPEG
អេឡិចត្រុង	电子
ចក្រភព រ៉ូម	羅馬帝國
Microsoft	微软
គីមីវិទ្យា	化學
ស៊ីទ្រុងជ្រូក	C♯
បេណេឌីកទី១៦	本篤十六世
៧ កក្កដា	7月7日
បាល់ទាត់	足球
ទីក្រុងបូកូតា	波哥大
ថ្ងៃទី៣១ខែធ្នូ	12月31日
រិសថា	灶神星
ស៊ីដនីយ៏	悉尼
ភ្លើង	火
ខ្យល់	地球大气层
កោះស៊ូម៉ាត្រា	蘇門答臘
ចាការតា	雅加达
ចំណាត់ថ្នាក់ក្រុម:Wikipedia templates	Category:維基百科模板
កោះជ្វា	爪哇岛
ចំណាត់ថ្នាក់ក្រុម:ចំណាត់ថ្នាក់ក្រុមនៃទំព័រគំរូវិគីភីឌា	Category:按内容分类的模板
កាលីម៉ាន់តាន់	加里曼丹
ខេត្តបន្ទាយមានជ័យ	班迭棉吉省
វិគីភីឌា:ប្រអប់ខ្សាច់	Wikipedia:沙盒
អាកាសយានដ្ឋាន ដុង ហ៊យ	同海機場
អាន់ ហ្វ្រែង	安妮·弗蘭克
ខុង ជឺ	孔子
ម៉ារីលីន ម៉ុនរ៉ូ	玛丽莲·梦露
ចំណាត់ថ្នាក់ក្រុម:គណិតវិទ្យា	Category:数学
ទំព័រគំរូ:ទិន្នន័យប្រទេស អ៊ីរ៉ង់	Template:Country data Iran
ចំណាត់ថ្នាក់ក្រុម:ប្រវត្តិសាស្ត្រខ្មែរ	Category:柬埔寨历史
ចំណាត់ថ្នាក់ក្រុម:ប្រវត្តិសាស្រ្តសិង្ហបុរី	Category:新加坡歷史
សមុទ្រ មេឌីទែរ៉ានេ	地中海
វីនដូអេច	Windows 8
ទំព័រគំរូ:ប្រទេសនៅទ្វីបអាស៊ី	Template:亞洲
ទំព័រគំរូ:Agree	Template:Support
ទន្លេហ្គារ៉ូន	加龍河
ស៊ីតថល	西雅圖
ជញ្ជាំង ប៊ែរឡាំង	柏林圍牆
ស្រូវ	稻
ទំព័រគំរូ:Lang-tr	Template:Lang-tr
ទំព័រគំរូ:ផតថល	Template:Portal
ទំព័រគំរូ:តំបន់នៃពិភពលោក	Template:世界分区
ប៊ីល ហ្គេត	比尔·盖茨
ភាសាជប៉ុន	日语
ប្រជុំវីជ្ជា	百科全书
ឌីវីឌី	數碼多功能影音光碟
ទំព័រដើម	Wikipedia:首页
Central processing unit	中央处理器
រេស៊ីស្ទ័រ	電阻器
កីឡាអូឡាំពិក	奥林匹克运动会
សមុទ្រ កាសព្យែន	裏海
ឈី ហ្គីវ៉ារ៉ា	切·格瓦拉
ទីក្រុងកាបូល	喀布尔
ហ្គ្រាប្រីអ៊ែល ហ្រ្គារ៉ាស្សៀ ម៉ារ៉ាហ្គេស	加夫列尔·加西亚·马尔克斯
ទស្សនវិជ្ជា	哲学
ចំណាត់ថ្នាក់ក្រុម:លុប	Category:快速删除候选
លិទ្ធិកុម្មុយនិស្ត	共产主义
ហ៊ីលឡារី រូដហេម គ្លីនតុន	希拉里·罗德姆·克林顿
Boeing 737	波音737
អាហារនៅប្រទេសបារំាង និង របៀបធ្វើ	法國飲食文化
មណ្ឌលម៉ាញេតូ	磁层
UTC+7	UTC+7
ភាសាកាតាឡាន	加泰罗尼亚语
បណ្ណាល័យ	图书馆
នីល ហេនរីក ដេវីដ ប៊័រ	尼尔斯·玻尔
និវេសនវិទ្យា	生态学
ក្លឹបបាល់ទាត់បារសេឡូណា	巴塞罗那足球俱乐部
នយោបាយ	政治
ធនាគារពិភពលោក	世界银行
ប្រជាធិបតេយ្យ	民主
អង្គការសន្ធិសញ្ញាអាត្លង់ទិកខាងជើង	北大西洋公约组织
ម៉ារី ស្កូដូស្កា គុយរី	玛丽·居里
រង្វាន់ណូបែល	诺贝尔奖
មជ្ឈិមបូព៌ា	中东
រាជវង្សហាន	汉朝
ប្រទេស	國 (政治)
គ្រឹស្តុបផើ កូឡំបូស (Christopher Columbus)	克里斯托弗·哥伦布
ព្រែកជីកប៉ាណាម៉ា	巴拿马运河
មហាសមុទ្រខាងត្បូង	南冰洋
ត្រីផ្សោតនៅកម្ពុជា	海豚
ក្មេង	儿童
លេអុនហាដ អយល័រ	萊昂哈德·歐拉
ណាប៉ូលេអុងទី៣	拿破仑三世
ភាសារុស្ស៊ី	俄语
ល្វី ដ៏អស្ចារ្យ	路易十四
សមាគមប្រជាជាតិអាស៊ីអាគ្នេយ៍	东南亚国家联盟
ប្រវត្តិសាស្ត្របារាំង	法國歷史
តុលាការយុត្តិធម៌អន្តរជាតិ	国际法院
យូណេស្កូ	联合国教科文组织
អង្គការសុខភាពពិភពលោក	世界卫生组织
អង្គការពាណិជ្ជកម្មពិភពលោក	世界贸易组织
ភាសាចិន	汉语
ធម្មជាតិ	自然
ឈាម	血液
រញ្ជួយផែនដី	地震
សមុទ្រឡាប់តែវ	拉普捷夫海
ភ្លើងចរាចរ	交通號誌
ម៉ាទីន ឡូតធឺរ ឃីង	马丁·路德·金
ត្រីកោណមាត្រ	三角学
ធរណីមាត្រ	几何学
វេយ្យាករណ៍	语法
សេដ្ឋកិច្ច	经济学
អក្សរក្រិច	希腊字母
អក្សរឡាតាំង	拉丁字母
រឿងមហាភារតយុទ្ធ	摩诃婆罗多
ការិយាល័យសហព័ន្ធស៊ើបអង្កេត	联邦调查局
វីយោឡុង	小提琴
អេឡិចសាន់ដឺ ដឹ ហ្គារ៉ែត	亚历山大大帝
សង្គម	社会
ការអប់រំ	教育
មនុស្សប្រុស	男性
វិគីភីឌាភាសាអេស៉្បាញ	西班牙語維基百科
សិទ្ធិមនុស្ស	人权
ទាសភាព	奴隶制度
សង្គ្រាមស៊ីវិល	内战
ភ្នំ	山
ហុងកុង	香港
សង្គ្រាមត្រជាក់	冷战
សេអ៊ូល	首爾
សង្គ្រាមវៀតណាម	越南战争
ម៉ៃឃើល ហ្វារ៉ាដេយ	麥可·法拉第
អង់រីកូ ហ្វែរមី	恩里科·费米
ភាសាអ៊ុយក្រែន	乌克兰语
HTML	HTML
ច្យូហានេស គូទេនបឺគ	约翰内斯·古腾堡
ភាសាដាណឺម៉ាក	丹麦语
ភាសាអេស្តូនី	爱沙尼亚语
ហិណ្ឌូសាសនា	印度教
ភាសាពែក	波斯语
សាសនា	宗教
ភាសាកូរ៉េ	朝鮮語
ភាសាខ្មែរ	高棉语
ហ្រ្គេតស៊ីងមួន	西格蒙德·弗洛伊德
ភាសាថៃ	泰语
ភាសាម៉ាឡេ	马来语
ភាសាឥណ្ឌូនេស៊ី	印尼语
ភាសាហេប្រ៊ូ	希伯来语
ចន ឡុក	约翰·洛克
ថ្លើម	肝臟
ចិត្តវិទ្យា	心理学
មហាសមុទ្រ	洋
ពុទ្ធប្រវត្តិសង្ខេប	释迦牟尼
ចរិយាមារយាទ	伦理学
សារជីវកម្មផ្សព្វផ្សាយព័ត៌មានរបស់ចក្រភពអង់គ្លេស(BBC)	英国广播公司
ក្លិបបាល់ទាត់ឆេលស៊ី	切尔西足球俱乐部
គ្រោងឆ្អឹងមនុស្ស	人體骨架
ក (អវយវៈ)	頸
រាជវង្សថាង	唐朝
John F. Kennedy	约翰·肯尼迪
LibreOffice	LibreOffice
ផ្លូវរូងដីក្រោមសមុទ្រ	英法海底隧道
តារាងខួបនៃធាតុគីមី	元素周期表
ប្រូម៉ាស	乾酪
ទំពាំងបាយជូរ	葡萄
បន្លែ	蔬菜
បច្ចេកវិទ្យា	技术
វិស្វកម្ម	工程学
ទំនាក់ទំនង	通信
វិជ្ជាជីវៈខាងសារព័ត៌មាន	新闻学
កាសែត	報紙
ទូរស័ព្ទ	电话
វប្បធម៌	文化
សំស្ក្រឹត	梵语
ប្រដាប់របត់ឈាម	循环系统
The Guardian	衛報
សមីការឌីផេរ៉ង់ស្យែល	微分方程
មៃក្រូសូហ្វអ៊ិសេល	Microsoft Excel
មុំ	角
សំទុះ	加速度
ព្រះសិវៈ	湿婆
ព្រះវិស្ណុ	毗湿奴
Local Area Network	局域网
Wide Area Network	广域网
ព្រះព្រហ្ម	梵天
កម្លាំង	力
អេឡិចត្រូម៉ាញ៉េទិច	电磁学
កសិកម្ម	农业
សំលៀកបំពាក់	服装
ល្បឿន	速度
ក្រដាស	纸
សុញ្ញកាស	真空
ស៊ីនេម៉ាទិច	运动学
ក្រលាផ្ទៃ	面积
ទ្រឹស្តីបទពីតាករ	勾股定理
ចំនួនកុំផ្លិច	复数 (数学)
Cristiano Ronaldo	基斯坦奴·朗拿度
អ្នកថតរូប	摄影
ល្ខោន	劇場 (藝術)
គ្រឿងអេឡិចត្រូនិច	電子元件
ព័ត៌មានវិទ្យា	信息技术
អាស៊ីអាគ្នេយ៍	东南亚
ក្រុងសៀមរាប	暹粒市
បញ្ជីរាយនាម ប្រទេស	世界政區索引
វិគីភីឌាភាសាព័រទុយហ្គាល់	葡萄牙語維基百科
ប្រដាប់រំលាយអាហារ	消化作用
កីឡាចាក់សាប	击剑
រោគផ្ដាសាយធម្មតា	普通感冒
រោគសរសៃប្រសាទ	精神病
ប្រតិទិន ក្រេកូរី	公历
សុខភាព	健康
ជម្ងឺរលាកទងសួត	肺炎
ជំងឺអេដស៍	艾滋病
កូដ QR	QR碼
ជំងឺទឹកនោមផ្អែម	糖尿病
ទំព័រគំរូ:Location map Belgium	Template:Location map Belgium
ទំព័រគំរូ:Location map Croatia	Template:Location map Croatia
ទំព័រគំរូ:Location map Ukraine	Template:Location map Ukraine
ទំព័រគំរូ:Location map Burma	Template:Location map Myanmar
ទំព័រគំរូ:Location map Philippines	Template:Location map Philippines
ទំព័រគំរូ:Location map Vietnam	Template:Location map Vietnam
ទំព័រគំរូ:Location map Cambodia	Template:Location map Cambodia
ទំព័រគំរូ:Location map Thailand	Template:Location map Thailand
ទំព័រគំរូ:Location map Indonesia	Template:Location map Indonesia
ទំព័រគំរូ:Location map Australia	Template:Location map Australia
ញូតុន	牛頓 (單位)
ចក្រភព អូតូម៉ង់	奥斯曼帝国
ម៉ាស៊ីនចំហេះក្នុង	内燃机
ក្បាច់គិតលេខ	算盘
វឺតប្រែស	WordPress
Joomla!	Joomla!
ដើមដូង	椰
ភាសាណាវ៉ាថ្ល៍	納瓦特爾語
ភាសាម៉ាយ៉ាយូកាតិក	猶加敦馬雅語
អែនជេលីណា ចូលី	安吉丽娜·朱莉
អ៊ីលដឺហ្រ្វែន	法兰西岛
ភាសាអារ៉ាប់	阿拉伯语
Thanksgiving	感恩节
តំបន់ឃ្ជឺស្សឺ	九州 (日本)
តំបន់ស៊ីកុគឹ	四國
នាយករដ្ឋមន្ត្រី	总理
ទង់ជាតិ	旗幟
ខ្មៅដៃ	铅笔
សហភាពសូវៀត	苏联
ចំណុចរលាយ	熔点
កាមេរ៉ា	照相機
កម្មវិធីទូរទស្សន៍	电视节目
ខេត្តខាហ្គុស៊ីម៉ា	鹿儿岛县
ភាសាស៊ី	C语言
ម៉ង់តេរីយើ	孟德斯鸠
វិគីភីឌា:អត្ថបទពិសេស	Wikipedia:特色条目
ទំព័រគំរូ:Link FA	Template:Link FA
ពិភពលោក	世界
ឈូក	莲
ឡងប៊ិច (កាលីផ្វនញ៉ា)	長灘 (加利福尼亞州)
រង្វង់	圆
ប្លង់	平面
វិគីភីឌាភាសាកូរ៉េ	朝鮮語維基百科
ទៀបកោះម៉ាឡេ	马来半岛
អេប៉ុងហ្ស៍ (ពពុះទឹក)	多孔动物门
មធ្យមនព្វន្ធ	算术平均数
World Cup	世界盃足球賽
សម្ដេចប៉ាប	教宗
IATA	國際航空運輸協會
បុណ្យណូអែល	圣诞节
ត្រីកោណ	三角形
លោកអេលីសេ រីខ្លាស	埃利泽·何可律
អ្នកប្រើប្រាស់:អេង ឡុង/សង្គមវិទ្យាមូលដ្ឋាន	社会学
សញ្ញាសំលេងអន្តរជាតិ	國際音標
តៃវ៉ាន់	臺灣
Friedrich Schiller	弗里德里希·席勒
ជំនឿបាហៃ	巴哈伊信仰
១	1年
អាប្រាហាម ម៉ាស្លូ	亚伯拉罕·马斯洛
ខ្ទឹមស	蒜
អ៊ូលេនបាធរ	乌兰巴托
កោះ	島嶼
ភាសាផ្លូវការ	官方语言
ខ្សែអេក្វាទ័រ	赤道
ទិស	方位
លេខអាតូម	原子序数
អាល់ហ្វ្រិដ ណូបែល	阿尔弗雷德·诺贝尔
សម្ដេចប៉ាប យូហាន ទី២៣	若望二十三世
កិរិយាសព្ទ	动词
ទីតានិច	泰坦尼克号
សត្វឆ្អឹងកង	脊椎动物
បាគូ	戴胜
អំពែរ	安培
ISO 3166-1	ISO 3166-1
១ មុនគ.ស	前1年
ម៉ែត្រការ៉េ	平方米
ជំនួយ:Interlanguage links	浮游生物
សហស្សវត្សរ៍ទី២	2千纪
ខេត្តកំពង់គោ	隆安省
ទ្រឹស្តីបទទ្វេធា	二项式定理
សមុទ្រជប៉ុន	日本海
អាស៊ីខាងកើត	东亚
អាមេរិក កណ្ដាល	中美洲
គ្រីស្ទអឌែលហ្វៀន	基督弟兄會
បរិមាត្រ	周长
ចក្រភព អូទ្រីស-ហុងគ្រី	奥匈帝国
បណ្ណាល័យជាតិ	公共图书馆
ផាយថុន	Python
អានន្ទ	阿难
អាស៊ីហ្គេមឆ្នាំ១៩៥១	1951年亚洲运动会
បាកាន	蒲甘
ចិន	中國
សំទុះទំនាញដី	重力加速度
ច្បាប់ធម្មតា	英美法系
អ្នកម្តាយ តេរេសា​ (Mother Teresa)	真福加爾各答的德肋撒
ប្លូក	網誌
រោគគ្រុនចាញ់	骨痛熱症
ដុល្លារហុងកុង	港元
Xian JH-7	殲轟-7
ខ្សែបណ្ដោយ	经线
ខេត្តឃ្លាំង	朔莊省
ខេត្តទឹកខ្មៅ	金甌省
សមុទ្រខារ៉ា	喀拉海
ផ្លេតបន្ទោរ	闪电
កំរងកោះ	群島
តួប្រុស	演員
អំបូរភាសាយូតូអាហ្សតិក	猶他－阿茲特克語系
ចាស្ទីន ពីពេ្រ	贾斯汀·比伯
ក្រុម​ភាសា​ថៃកៈដៃ	壯侗語族
ចក្រភព រុស្ស៊ី	俄罗斯帝国
មឞវជ	莫绍夫采
បេណាហ្សៀរ ប៊ូតូ	贝娜齐尔·布托
ស៊ីឌី	CD
ឧទ្ធម្ភាគចក្រ	直升機
គុណនាម	形容词
វីតាមីន	维生素
វែបសាយ	網站
តំបន់ហុកកៃដូ	北海道
រូបមន្តសមមូលម៉ាស់-ថាមពល	質能等價
សមុទ្រ អារ៉ាល់	鹹海
ហូ ជីមិញ	胡志明
ម៉ាក ហ្សុកឃឺបឺក	马克·扎克伯格
ប្រតិកម្មគីមី	化学反应
ខេត្តក្រមួនស	堅江省
ខេត្តមាត់ជ្រូក	安江省
ខេត្តរោងដំរី	西寧省
ខេត្តព្រះត្រពាំង	茶榮省
Binomial nomenclature	二名法
ខេត្តពលលាវ	薄遼省
ខេត្តផ្សារដែក	同塔省
វ៉ែសបែង	約旦河西岸地區
ភាសាបាលី	巴利语
គេហទំព័រ	網頁
ចតុកោណ	四邊形
ឈិន ឡុង	成龍
ទិវាកុមារអន្តរជាតិ	兒童節
Yahoo!	雅虎
បន្ទាត់	直线
ហ្មរិឩពឡ	马里乌波尔
G8	八大工業國組織
អង្កត់ផ្ចិត	直径
គ្រូបង្រៀន	教师
ស្នាដៃនៃបុព្វបុរសខ្មែរ	寫作
ស្ដេចប៉ាប យ៉ូហាន ប៉ូលទី១	若望·保禄一世
ណៃពិដោ	奈比多
ISO 4217	ISO 4217
ព្យែរ គុយរី	皮埃尔·居里
ក្រុមប្រឹក្សាសន្តិសុខ អង្គការសហប្រជាជាតិ	联合国安全理事会
ពហុកោណ	多边形
ទិវានៃក្ដីស្រលាញ់	情人节
ហ្គូហ្គល	市场
សមុទ្រចិនខាងត្បូង	南海
និវេសនប្រព័ន្ធ	生态系统
សមុទ្រលឿង	黄海
យ៉ាំងហ្គូន	仰光
សូរព្យញ្ជនៈ	辅音
ច្បាប់ចលនារបស់ញូតុន	牛顿运动定律
ឈូងសមុទ្របេងហ្គាល់	孟加拉灣
ទិវានារីអន្តរជាតិ	国际妇女节
.jp	.jp
ភ្នំហ្វឹជី	富士山
ប៉ុលពត	波尔布特
Xian H-6	轰-6
Chengdu J-7	歼-7
Shenyang J-8	歼-8
ភ្នំភ្លើង អ៊ីស៊ាឡឺក	埃亚菲亚德拉冰盖
ម៉ាក្រូសេដ្ឋកិច្ច	宏观经济学
Harbin SH-5	水轟-5
ដីជ្រោយហ្គាស្សា	加沙地带
​វិទ្យុ​ស្ទូឌីយោ 54 បណ្តាញ	第54演播室電台聯播網
អេលីប	椭圆
វិទ្យុអាស៊ីសេរី	自由亚洲电台
សមាគមន៍សារព័ត៌មាន	美联社
អធិដ្ឋាន	祷告
គណៈកម្មាធិការអូឡាំពិកអន្តរជាតិ	国际奥林匹克委员会
Skype	Skype
.kh	.kh
ចតុកោណស្មើ	菱形
ទន្លេមេគង្គ	湄公河
មេកានិច	力学
វិចិត្រសាលវលញ្ឆករប្រទេស	国徽列表
ហែងរីហ ហឺត	海因里希·赫兹
អង់រី បិកកឺរ៉ែល	亨利·贝可勒尔
ទស្សនាវដ្ដី	杂志
សមីការដឺក្រេទី២	一元二次方程
រូពីឥណ្ឌូនេស៊ី	印尼盾
សមុទ្រអុកហុតស្គ៍	鄂霍次克海
ចិត្តវិភាគ	精神分析学
ខ្មែរម៉ាស្ទើ	網站管理員
.kr	.kr
URL	统一资源定位符
ក្រុមបាល់ទាត់ជម្រើសជាតិ អេស្ប៉ាញ	西班牙國家足球隊
Google Earth	Google地球
ប៊ែនហាដ រីម៉ាន	波恩哈德·黎曼
កោន	圆锥
អាតុល	環礁
ទិន្នន័យ	数据
ខ្លែង	风筝
ស្ថាបត្យករ	建筑师
មហាអំណាច អាប់ស៊ីស	轴心国
វិគីភីឌា:FAQ	Wikipedia:常见问题解答
.th	.th
ចក្រភព អាល្លឺម៉ង់	德意志帝國
ក្រុមបាល់ទាត់ជម្រើសជាតិ អាល្លឺម៉ង់	德國國家足球隊
ហេរី ផោតធ័រ និង សិលាទេព	哈利·波特与魔法石
អង្គការ Creative Commons	创作共用
ឥណ្ឌូចិន	中南半島
ប្រាសាទអង្គរវត្ត	吴哥窟
ទ្រឹស្ដីរ៉ឺឡាទីវីតេ	相对论
ប្រុស	雄性
Toulon	土伦
ប៉ាស្កាល់	帕斯卡
ទ្រឹស្ដីល្បែង	博弈论
នីតិរដ្ឋ	法治
សមុទ្រចិនខាងកើត	东海
ខ្នុរ	波罗蜜
ប្រលេឡូក្រាម	平行四边形
ប្រាសាទព្រះវិហារ	柏威夏寺
ចតុកោណព្នាយ	梯形
ស៊ូស៊ី	寿司
រូប៊ិក ខ្យូប	魔方
កាល	普劳图斯
ចង្រិត	蟋蟀
ទិវាពលកម្មអន្ដរជាតិ	国际劳动节
ស្ទឹង	溪
សមុទ្រអង់ដាម៉ង់	安达曼海
ប៉ិបស៊ី	百事可樂
ក្រុមបាល់ទាត់ជម្រើសជាតិ អង់គ្លេស	英格蘭足球代表隊
ក្រុមបាល់ទាត់ជម្រើសជាតិ បារាំង	法國國家足球隊
ទំព័រគំរូ:Commonscat	Template:Commons category
វិគីភីឌាភាសាអាល្លឺម៉ង់	德語維基百科
អាស៊ីខាងលិច	近東
យេនឌ័រ	性別認同
អង្គការសហភាពអន្តរជាតិដើម្បីអភិរក្សធម្មជាតិ	國際自然保護聯盟
ទីក្រុងមេឌេយីណ	麦德林
ប៉ារ៉ាបូល	抛物线
ខេត្តអ៊ីវ៉ាតិ	岩手县
ទ្វារសមុទ្រមលក្កា	马六甲海峡
មហាយាន	大乘佛教
ប្រព័ន្ធប្រតិបត្តការ iOS	IOS
ចំនួនបឋម	素数
សង្គ្រាម ប្រាំមួយ ថ្ងៃ	第三次中东战争
ក្រុងឡូវែល រដ្ឋម៉ាស្សាឈូស៊ែត	洛厄尔 (马萨诸塞州)
សមុទ្រជ្វា	爪哇海
សិប្បកម្មខ្ញុំ	我的世界
ច្រកសមុទ្រធ្ងន់ធ្ងរ	險峻海峽
វីហ្សួលបេហ៊្សិក.ណេត	Visual Basic .NET
បំណែងចែករដ្ឋបាលនៃកម្ពុជា	柬埔寨行政区划
អនុគមន៍ដឺក្រេទី២	二次函数
ច្បាប់អំពែរ	安培定律
ជំងឺអ៊ីបូឡា	埃博拉出血热
ច្រកកូរ៉េ	朝鲜海峡
ឆកសមុទ្រកូរ៉េ	西朝鲜湾
កង្កែប	无尾目
ខ្សែទឹកឃឹរ៉ុស៊ីអុ	黑潮
ចំណាត់ថ្នាក់ក្រុម:ព្រះមហាក្សត្រ	Category:君主
ចំណាត់ថ្នាក់ក្រុម:រដ្ឋាភិបាល	Category:政府
ទំព័រគំរូ:Infobox legislature	Template:Infobox legislature
ទន្លេយ៉ាលូ	鸭绿江
ទំព័រគំរូ:ប្រវត្តិសាស្ត្រថៃ	Template:泰國歷史
ទំព័រគំរូ:ប្រវត្តិសាស្ត្រចិន	Template:中国历史
ទំព័រគំរូ:ប្រវត្តិសាស្ត្រអាស៊ី	Template:亚洲各国历史模板
មីហ្គេល អ៊ីដាលហ្គោ អ៊ី កុស្ទីយ៉ា	米格尔·伊达尔戈·伊·科斯蒂利亚
នរោត្តម សីហមុនី	诺罗敦·西哈莫尼
ហ៊ុន សែន	洪森
តូក្យូស្កាយទ្រី	東京晴空塔
ហោ ណាំហុង	何南豐
ភាសាប៉ាស្តូ	普什图语
ធនាគារកណ្ដាល	中央银行
Pidgin	Pidgin
​វិលហែម វុឌ	威廉·冯特
យិដា តាដូ	格爾達·塔羅
មនុស្សពីងពាង	蜘蛛人
សារធាតុគីមី	化学物质
ចលនានៅក្នុងរូបវិទ្យា	運動 (物理學)
ជម្ងឺកញ្ជ្រឹល	痲疹
ក្រុមបាល់ទាត់ជម្រើសជាតិ អាហ្សង់ទីន	阿根廷國家足球隊
ខ្យល់ព្រះអាទិត្យ	太阳风
បាល់ទាត់ពិភពលោក ២០១៤	2014年世界盃足球賽
ម៉ូបាល (អាល់ឡាបាម៉ា)	莫比尔 (亚拉巴马州)
កុំព្យូទ័រផ្រូក្រាមមីង(Computer programming)	程序设计
ខេត្តឈីបា	千葉縣
អាំងតេក្រាល	积分
ខេត្តអៃឈិ	愛知縣
វិបត្តិសេដ្ឋកិច្ចឆ្នាំ ១៩៩៧	亞洲金融危機
ខ្មែរ	成年人
សិល្បៈប្រើវោហារបង្ហូរគំនិត	修辞学
ឃីមីហ្គាយ៉ុ	君之代
សាល អូហ្គុស្ទីន ដឺ គូឡុំ	夏尔·奥古斯丁·库仑
ខេត្តអាគីតា	秋田县
ថ្នាក់ពាក្យ	詞類
ស្ថានភាពអភិរក្ស	保护状况
កាន់ជិ	日本汉字
នាម	名称
ប្រវត្តិសាស្ត្រចិន	中国历史
អវតារ	化身 (印度教)
ច្បាប់គូឡុំ	库仑定律
រឿង រ៉ូមេអូ និង ហ្ស៊ុយលីយេ	罗密欧与朱丽叶
សាលីណា កូមាស់	賽琳娜·戈梅茲
ក្រុម (តារាងខួបនៃធាតុគីមី)	族 (化学)
ក្រុមបាល់ទាត់ជម្រើសជាតិ ប្រេស៊ីល	巴西國家足球隊
កាល ឡែមស្ដែនណឺ	卡尔·兰德施泰纳
បាល់ប៉ូឡូញ	波兰球
ឯកសារភាពយន្ត	紀錄片
អនុគមន៍ត្រីកោណមាត្រ	三角函数
ហ្រាន្ដកូស ហ្វីឡុន	弗朗索瓦·菲永
ខួប (តារាងខួបនៃធាតុគីមី)	元素周期
ល្បែងទាញព្រ័ត្រ	拔河
Article (grammar)	冠词
មេដ្យានទ័រ	圆规
Rfid	射频识别
អ៊ីប៉ូតេនុស	斜邊
ហិចហ្វាន់	对冲基金
ISO 3166	ISO 3166
សញ្ញាជាតិកូរ៉េខាងជើង	朝鲜国徽
មេហ្គា	兆 (前綴)
គីឡូ	千 (前綴)
ការតាំងសមាធិ	冥想
ប៉េតា	拍它
យ៉ុតតា	佑
ហ្គីហ្គា	吉咖
តេរ៉ា	太拉
ហ្វង់តូ	飞母托
ហ្សិតតា	泽它
ច្រកតារតារី	韃靼海峽
ហ្សិបតូ	仄普托
កាតែត	直角邊
អាត់តូ	阿托
យ៉ុកតូ	攸
ចំណែករដ្ឋបាលនៃម៉ិចស៊ិក	墨西哥行政區劃
ម៉ាស៊ីនស្វែងរក	元搜索引擎
អាំងតេក្រាលមិនកំនត់	不定积分
Shenyang J-15	歼-15战斗机
គណបក្សហ៊្វុនស៊ិនប៉ិច	奉辛比克黨
ខេត្តក្យូតុ	京都府
តំលៃដាច់ខាត	绝对值
ហេដ្ឋារចនាសម្ព័ន្ធ	基础设施
សាស្ត្រាចារ្យ	教授
តេគីឡា	龍舌蘭酒
សន្ធិសញ្ញាប្រេស្ត-លីតូវស្ក	布列斯特-立陶夫斯克條約
William Thomson, 1st Baron Kelvin	第一代开尔文男爵威廉·汤姆森
អាណាខេត្តអូសាកា	大阪府
ខេត្តអិហ៊ីមិ	爱媛县
វាំងននដែក	铁幕
Kara (band)	Kara
វីលៀម ជែម	威廉·詹姆士
ខេត្តយ៉ាម៉ាកាតា	山形县
ច្រកតៃវ៉ាន់	台灣海峽
គំរោងម៉ាន់ហាត់ថាន់	曼哈顿计划
ខេត្តយ៉ាម៉ាហ្គឹឈិ	山口县
ខេត្តខាន់ណាហ្គាវ៉ា	神奈川縣
បញ្ចកោណ	五边形
តំបន់ជឺហ្គុកឹ	中国地方
ខេត្តណាហ្គាណុ	长野县
ខេត្តសៃតាម៉ា	埼玉縣
ខេត្តមីអិ	三重县
ណុត	節 (單位)
តំបន់តុហុកកឹ	东北地方 (日本)
ខេត្តហ្គឺនម៉ា	群馬縣
ជ្រូកទឹក	儒艮
ខ្សែទឹកមហាសមុទ្រ	洋流
ខេត្តមីយ៉ាសាគី	宮崎縣
ខេត្តឃឹម៉ាម៉ុតុ	熊本縣
Mikoyan MiG-29	米格-29戰鬥機
សប្ដាហ៏ពិសិដ្ឋ	圣周
ឈូងសមុទ្រថៃ	泰國灣
លី ក្វាន់យូ	李光耀
កម្មសិទ្ធិបញ្ញា	知识产权
អាណាខេត្តណារ៉ា	奈良县
បុព្វបទនៅក្នុងប្រព័ន្ធខ្នាតអន្តរជាតិ	国际单位制词头
យន្តហោះប៉ូឡូញកំទេចឆ្នាំ២០១០	2010年波兰空军图-154坠机事件
ជនភៀសខ្លួន	难民
ហង់រី កាវិនឌីស	亨利·卡文迪什
បុណ្យចូលឆ្នាំចិន	春節
ថេរវាទ	上座部佛教
តំបន់ខាន់តូ	關東地方
ខេត្តនីហ្គាតាក់	新潟县
ខេត្តយ៉ាម៉ាណាស៊ី	山梨县
ខេត្តស៊ីម៉ាណិ	岛根县
ខេត្តតុយ៉ាម៉ា	富山縣
ខេត្តអូកាយ៉ាម៉ា	岡山縣
ISO 3166-2	ISO 3166-2
ខេត្តអយតាក់	大分县
ខេត្តខូឈិ	高知县
អង្គការអន្តរជាតិនៃនយោបាយរបស់បារាំង	法語圈國際組織
ភ្នំមេរ៉ាពី	默拉皮火山
ព្រះធម៌	法 (印度哲學)
តំបន់ឈឺប៊ឹ	中部地方
វ៉ាក់សាំង	疫苗
រោគក្អកមាន់	百日咳
គន្ថនិទ្ទេស	目录学
កម្ពុជា នៅកីឡាអូឡាំពិករដូវក្ដៅ ២០០៨	2008年夏季奥林匹克运动会柬埔寨代表团
គីមឈី	韓式泡菜
ខេត្តកំពង់ចាម	磅湛省
ខ្សែទឹកហ្គ្រីនលែនខាងកើត	東格陵蘭洋流
ខ្សែទឹកប៉ាស៊ីហ្វិកខាងជើង	北太平洋洋流
ខ្សែទឹកហាំបុល	秘鲁寒流
ខ្សែទឹកអូស្ត្រាលីខាងកើត	東澳洋流
ជ័រទឹក	树脂
ដុនបូស្កូ	聖若望·鮑思高
ធ្នូរង្វង់	弧
អប្សរា	飛天女神
រាជវង្សចោឡា	朱罗王朝
ខ្លារខិន ២ (រថក្រោះ)	豹2型坦克
មហាអំណាច កណ្ដាល	同盟國 (第一次世界大戰)
អិចសា	艾可萨
ហិកតូ	百 (词头)
រ៉ូបឺតកាប៉ា	安德鲁·弗里德曼
មីក្រូ	微
ពីកូ	皮可
ណាណូ	奈
លីប៉ូល ស៊ីដាស៊ាងហ័រ	利奥波德·塞达尔·桑戈尔
វិគីភីឌាភាសាឥណ្ឌូនេស៊ី	印尼語維基百科
ទន្ដគោម	龍舌蘭屬
វីមេអូ	Vimeo
អំពើអនិត្យានុកូល	家庭暴力
ហង់រី ការចេរ ប្រេស្សុង	亨利·卡蒂尔-布雷松
ត្រីកោណសម័ង្ស	正三角形
ម៉ាក់ណូលា	木蘭屬
ចូសេហ្វ ហិនរី	約瑟·亨利
មន ស	白桑
ពិធីបញ្ជាប់ពាក្យ	訂婚
ត្រីកោណកែង	直角三角形
សមុទ្រហ្វីលីពីន	菲律宾海
ប្រព័ន្ធកូអ័រដោណេភូមិសាស្ត្រ	地缘政治学
Eurocopter Tiger	虎式直升机
តេត្រាអែត	四面體
ម៉ោងផែនដី	地球一小时
នរោត្ដម សីហនុ	諾羅敦·西哈努克
ទន្លេរីយ៉ូហ្គ្រែនដេ	格蘭德河
សំព័រ	桂木属
កម្មវិធីអភិវឌ្ឍន៍សហប្រជាជាតិ	联合国开发计划署
ម៉ាស៊ីនថត លេកា	徕卡相机
មេគុណជីនី	基尼系数
នីត្រូគ្លីសេរីន	硝酸甘油
វណ្ណយុត្តិ	附加符号
ទង់ជាតិកម្ពុជា	柬埔寨國旗
ក្រុងអង្គរ	吴哥古迹
ក្រពេញទីមុស	胸腺
ទ្រឹស្តីបទកូស៊ីនុស	餘弦定理
ទក្សិណ ជិនវ័ត្រ	達新·欽那瓦
ប្រធាន	主語
ហិនរី រ៉េម៉ុន	亨利·贾维斯·雷蒙德
អ៊ែង​ហ្គ្រី បឺដ	愤怒的小鸟
អ៊ីពែបូល	双曲线
វិសមភាពស្វ័យគុណ	不等
ប៊ិច	筆
ចេក​	大蕉
XHTML	XHTML
គ្រោះទុរ្ភិក្ស	饑荒
អរិយសច្ច៤	四谛
ស្តាទិច	静力学
ខេត្តណាហ្គាសាគី	长崎县
វិគីភីឌាភាសាស្វីស	瑞典語維基百科
ភ្លើងឆេះព្រៃ	山火
ទ្រឹស្តីបទស៊ីនុស	正弦定理
ច្បាប់ហ៊ូក	胡克定律
ក្រុមបាល់ទាត់ជម្រើសជាតិ ជប៉ុន	日本國家男子足球隊
រោគឈឺចាប់ក្នុងសន្លាក់ឆ្អឹង	关节炎
ប្លុកហ្គឺ (Blogger)	Blogger
ធម្មនុញ្ញនៃអង្គការសហប្រជាជាតិ	联合国宪章
Boeing AH-64 Apache	AH-64阿帕契直升机
រោគហើមសួត	支气管炎
អេមីល្យូ ហ្គីណូ សេហ្គ្រែ	埃米利奥·塞格雷
Sukhoi Su-27	苏-27战斗机
ម៉ាស៊ីនត្រជាក់	空氣調節
កាំ	半径
អភិសិទ្ធិ វេជ្ជាជីវៈ	阿披实·威差奇瓦
HAL Tejas	光輝戰鬥機
លីមីត	极限 (数学)
អ៊ីដ្រូស្តាទិច	流体静力学
វិគីភីឌាភាសាជប៉ុន	日語維基百科
គោលនយោបាយរូបិយវត្ថុ	货币政策
យានដឹកជញ្ជូនសាធារណៈ	公共交通
ការសំភាសន៏	面談
ពាណិជ្ជកម្មអន្តរជាតិ	国际贸易
ចក្រភពអាណានិគមបារាំង	法蘭西殖民帝國
ពន្ធលើប្រាក់ចំណូល	所得稅
HTML tag	HTML元素
រូបចំលាក់	塑像
នាឡិកាខ្សាច់	沙漏
ពុយមីស	浮岩
FM	频率调制
សង្គមស៊ីវិល	公民社会
សមុទ្របូហៃ	渤海
ការិយាល័យ	辦公室
ការបង្រៀនដែនដីបរិសុទ្ធ	線上學習
ម៉ែត្រក្នុងមួយវិនាទី	米每秒
រូបមន្តហេរុង	海伦公式
ទន្សោង	爪哇野牛
វីតាមីន B	维生素B
គណៈកម្មាធិការជាតិអូឡាំពិក	國家奧林匹克委員會
ប៉មតូក្យូ	东京铁塔
ទិវាទឹកអន្តរជាតិ	世界水日
រូបមន្តអយល័រ	欧拉公式
ស៊ីយ៉ាញួរ	氰化物
អរិយដ្ឋង្គិកមគ្គ	八聖道分
សហភាពឥណ្ឌូចិន	法屬印度支那
ចន្ទគតិ	阴历
ការវិភាគតាមអ៊ីនធើណែត	網站分析
សំទុះមុំ	角加速度
អាស៊ីហ្គេមឆ្នាំ១៩៧០	1970年亚洲运动会
គោលនយោបាយសារពើពន្ធ	财政政策
ឡាហ្គូន	潟湖
Mathew Brady	马修·布雷迪
អប់សិន (ហិរញ្ញវត្ថុ)	期权
អង្កត់ធ្នូ	弦 (幾何)
អាយុសង្ឃឹម	预期寿命
ខុទ្ទកាល័យ	董事会
សីដក់	藤球
ធនាគារអភិវឌ្ឍន៍អាស៊ី	亞洲開發銀行
បញ្ជីរដ្ឋមានអាវុធនុយក្លេអ៊ែរ	擁有核武器的國家列表
ទីផ្សារអ៊ីធើណែត	网络营销
សៀវភៅ	叢林奇譚
បារីអេឡិចត្រូនិច	電子煙
Eagles (ក្រុមភ្លេង)	老鹰乐队
កំណើនសេដ្ឋកិច្ច	经济增长
អាឌាម លេមបឺត	亚当·兰伯特
រូបមន្តដឺម័រ	棣莫弗公式
អនុគមន៍ហ្គាំម៉ា	Γ函数
ច្បាប់ប៉ាស្កាល់	帕斯卡定律
សញ្ញាជាតិបង់ក្លាដែស្ស	孟加拉国国徽
នាង​សីតា	悉多
សូរ (​ភាសាសាស្ត្រ​)	聲調
ខ្មែរក្រហម	紅色高棉
ម៉ូឌុល​យ៉ាំង	弹性模量
យុន ជីមិ-ហូ	尹致昊
កែវម៉ាស៊ីនថត	鏡頭
ទីភ្នាក់ងារសារព័ត៌មាន	通讯社
វិគីភីឌាភាសាស្លូវ៉ាគី	斯洛伐克語維基百科
ថេរហ្វារ៉ាដេយ	法拉第常数
និមិត្តសញ្ញាគីមី	元素符号列表
ប្រវត្តិអ៊ីនធើណេត	互联网历史
សមភាពគួរកត់សំគាល់	二项式
ខូប្រា	椰子核
ទ្រឹស្តីបទមេនេឡូស	梅涅劳斯定理
ការធ្វើពាណិជ្ជកម្ម	互動式廣告
អត្ថបទ(ប្រើបា្រស់ភាសា)	語境
ជូគ័រលាង	诸葛亮
បំលែងឡាប្លាស	拉普拉斯变换
សញ្ញាជាតិតួរគី	土耳其國徽
បឹងទន្លេសាប	洞里萨湖
Dassault Mirage 2000	幻影2000战斗机
ចំនួនអវិជ្ជមាន	负数
វិសុទ្ធិមគ្គ	清淨道論
សញ្ញាជាតិវៀតណាម	越南國徽
ខ្មែរ (ជនជាតិ)	高棉族
សញ្ញាជាតិកូរ៉េខាងត្បូង	韩国国徽
សញ្ញាជាតិឡាវ	老挝国徽
សញ្ញាជាតិប៉ាគីស្ថាន	巴基斯坦国徽
Tigranes the Great	提格兰二世
អាណាចក្រខ្មែរ	高棉帝国
សម្ដេចព្រះមហាឃោសនន្ន	玛哈·哥沙纳达
ត្រីពណ៌	三色旗
សញ្ញាជាតិប៊្រុយណេ	文萊國徽
រង្វង់ត្រីកោណមាត្រ	单位圆
ចំរៀករង្វង់	扇形
អនុគមន៍ដឺក្រេទី៣	三次方程
អនុគមន៍អ៊ីពែបូលីក	双曲函数
ឆាវ ឆាវ	曹操
Sukhoi Su-30	苏-30战斗机
កម្មវិធីស្បៀងអាហារពិភពលោក	世界糧食計劃署
រៀល	柬埔寨瑞爾
សមុទ្រស្ទើរបិទ	陆缘海
ច្រកសិង្ហបុរី	新加坡海峡
វិគីភីឌាភាសារុស្ស៊ី	俄語維基百科
សញ្ញាជាតិអូម៉ង់	阿曼国徽
ភាសាកម្មវិធី Lua	Lua
សញ្ញាជាតិប៊ូតាន	不丹国徽
ភ្លេងជាតិថៃ	泰國國歌
ព្រះរតនត្រ័យ	三宝 (佛教)
ច្រកឡាប៉េរូស	宗谷海峡
ខ្នាតកំលាយនៅក្នុងប្រព័ន្ធខ្នាតអន្តរជាតិ	国际单位制导出单位
ផ្សារហិរញ្ញវត្ថុ	金融市场
ញ៉ែ	搭訕
ព្រះឆាយាល័ក្ខកម្ពុជា	柬埔寨國徽
ទិវាអង្គការសហប្រជាជាតិ	联合国日
ខ្សែទឹកអាត្លង់ទិកខាងជើង	北大西洋漂流
ប្រវត្តិសាស្ត្រវៀតណាម	越南歷史
ខ្សែទឹកខាណារី	加那利洋流
ទ្រឹស្តីបទឆិវ៉ា	塞瓦定理
LinkedIn	領英
ព្រះត្រៃបិដក	巴利文大藏經
បុណ្យវិសាខបូជា	卫塞节
ទីក្រុងព្រែកឫស្សី	芹苴市
ជនជាតិចាម	占婆
រីស្ស៉ាត កាពុសស៊ីនស្គី	雷沙德·卡普钦斯基
ប្រវត្តិសាស្ត្រភូមា	缅甸历史
ស៊ាន ឃីងស្តន	尚恩·金斯顿
កងទ័ពជើងទឹកបារាំង	法國海軍
ចំប៉ី	緬梔花
ពហុកីឡាដ្ឋានសុផាចាឡាសៃ	蘇帕查拉賽體育場
អនុគមន៍បេសែ្សល	贝塞尔函数
វិធីហ្វៃណៃថ៍អ៊េលម៉ិន	有限元分析
ច្បាប់អគ្គីសនីវិភាគរបស់ហ្វារ៉ាដេយ	法拉第电解定律
មានប្រ	安谷
និកាយនៃព្រះពុទ្ធសាសនា	佛教派别
ដុនបូស្កូសាឡេស៊ាន្ត	慈幼會
ខ្នាតគោលនៅក្នុងប្រព័ន្ធខ្នាតអន្តរជាតិ	国际单位制基本单位
អង្គរធំ	吴哥城
១៤១	141
ព្រះបាទសុទ្ធោទន	净饭王
ប្រទេសនៅអឺរ៉ុប	歐洲國家和地區列表
វិទ្យុសម្លេងសហរដ្ឋអាមេរិក	美国之音
ជេឃ្វីរី	JQuery
ទិវាពិភពលោកគ្មានថ្នាំជក់	世界无烟日
គម្ពីរបញ្ចតន្ត្រ	五卷书
មេដ្យាន	中线
T-80	T-80主戰坦克
សញ្ញាជាតិកាតារ	卡塔尔国徽
សញ្ញាយ៉ាកូប៊ី	雅可比符号
ភាសាចាម	占語
សត្វព្រៃ	野生动物
មីហ៊្គោ	MeeGo
វិភាគចិត្តវិទ្យា	分析心理学
លីវ ប៉ី	刘备
ម៉ាត្សឹស៊ីតា ខូណុស្កិ	松下幸之助
សង្គ្រាមគ្រីមៀ	克里米亚战争
ក្ងោកបៃតង	绿孔雀
នាវាចរណ៏	领航员
Pinterest	Pinterest
អាស៊ីហ្គេមឆ្នាំ១៩៦២	1962年亚洲运动会
អៀង ធីរិទ្ធ	英蒂迪
ភ្នំសេមេរូ	塞梅魯火山
កោះសមុយ	苏梅岛
ថវិការដ្ឋាភិបាល	政府预算
អាំងតេក្រាលដោយផ្នែក	分部積分法
ផ្សោតក្បាលត្រឡោក	短吻海豚
Near Field Communication	近場通訊
ហិរញ្ញវត្ថុសាធារណៈ	公共財政
សាលាសំណាក់	洋亭
ជយវម៌្មទី១	阇耶跋摩一世
ខ្សែទឹកកាលីហ្វរនៀ	加利福尼亞洋流
១៤៨	148
នគរឆាវ	曹國
AIDC F-CK-1 Ching-kuo	F-CK-1經國號戰鬥機
ប្រមោញ	帚尾豪猪
ខេត្តសាឡៈវ៉ាន់	沙拉湾省
WikiHow	WikiHow
ប្រាសាទមេបុណ្យខាងកើត	东湄本寺
ទិន្នន័យបើកចំហ	開放資料
ទិន ហ្វី	周星馳
ហាំង ង៉ោ	吳漢潤
ព្រះបាទសូរ្យវរ្ម័នទី២	蘇利耶跋摩二世
ហ្គោស ចុកតុង	吴作栋
ហិនរី វីលសុន	亨利·威尔逊
ហុងដា សូអ៊ិជិរ៉ូ	本田宗一郎
ស៊ុន ឈាន	孙权
ឆាវ ភី	曹丕
សមុទ្រកូរ៉ូ	科羅海
ពិម្ពិសារ	頻毘娑羅
ក្រុមបាល់ទាត់ជម្រើសជាតិកម្ពុជា	柬埔寨國家足球隊
Seo Jae-pil	徐載弼
ព្រះសារីបុត្រ	舍利弗
ទ្រឹស្តីបទគ្រីន	格林公式
ប្រាសាទអូសាកា	大阪城
ការប្រើប្រាស់ភាសា	应用语言学
គោព្រៃ	林牛
VCD	影音光碟
ថ្ងៃបាស់ស្ទីល	巴士底日
កម្ពុជាប្រជាធិបតេយ្យ	民主柬埔寨
សាលាក្ដីខ្មែរក្រហម	柬埔寨法院特別法庭
ណាសសែរ អាល់ មូហាមមេដ អាល់ អាហ៍មេដ អាល់ អាបាហ៍	纳赛尔·穆罕默德·艾哈迈德·萨巴赫
ស៊ុនធិ បុណ្យ រ័តក្លិន	颂提·汶雅叻格林
ខេត្តផុងសាលី	丰沙里省
ខេត្តបកែវ	博胶省
ខេត្តចំប៉ាសក្តិ	占巴塞省
កិលេស	激情
ព្រះបាទជ័យវរ្ម័នទី៧	阇耶跋摩七世
កស្សបៈ	摩訶迦葉
កាំង ហ្កិច អ៊ាវ	康克由
អាយតនៈ	處 (佛教)
ស៊ឺ ម៉ាអ៉ី	司马懿
ចំនុចហ្គែរហ្គោន	内切圆
ឋានន្តរសក្ដិរាជវង្សនិងអភិជន	贵族等级
ក្រុមហ៊ុនអាកាសចរណ៍ជាតិ កម្ពុជាអង្គរអ៊ែរ	柬埔寨吴哥航空
វិសមភាពនេស្ប៉ីត	內斯比特不等式
មហាបរិនិព្វានសូត្រ	大般涅槃经 (上座部)
ទ្រឹស្តីបទមេអំបៅ	蝴蝶定理
កន្ថឹក	树鼩
ហេង សំរិន	韓桑林
ខៀវ សំផន	乔森潘
ព្យែរ វ៉ារីញ៉ុង	皮埃爾·伐里農
នួន ជា	农谢
អៀង សារី	英沙里
ជយវម៌្មទី៣	阇耶跋摩二世
អជាតសត្តុ	阿闍世王
បន្ទាត់អយល័រ	歐拉線
ប្រវត្តិសាស្ត្រថៃ	泰国历史
បុណ្យសែនព្រះខែ	中秋节
មហាមោគ្គលាន	目犍連
ប្រេម ទីនសូឡានុន្ទ	炳·廷素拉暖
គុណកិរិយា	副詞
ឌីណាមិក HTML	動態HTML
នូហាក់ ភូមសៈវ៉ាន់	诺哈·冯沙万
កុំផ្លិចឆ្លាស់	共轭复数
ការកើនឡើងនៃចំនួនប្រជាជននៅលើពិភពលោក	人口自然增长率
ហង់រី មូហូ	亨利·穆奥
ប្រវត្តិសាស្ត្រលាវ	老挝历史
តារាងអាំងតេក្រាល	积分表
បន្ទាត់សេកង់	割线
ប្រាសាទតាកែវ	茶胶寺
សម្ដេចប៉ាបហ្វ្រង់សូ័រ	方濟各 (教宗)
ទ្រឹស្តីបទតូលេមី	托勒密定理
Regional Internet registry	区域互联网注册管理机构
ខ្វែងជ័យបុរី	沙耶武里省
ខ្វែងជើងខ្វែង	川圹省
ខេត្តឧត្តមជ័យ	乌多姆塞省
ខេត្តកោះកុង	戈公省
ខេត្តកណ្ដាល	干丹省
ព្រះនាងយសោធរា	耶输陀罗
អនុគមន៍បែតា	Β函数
ទ្រឹស្តីបទតង់សង់	正切定理
លិង្គ	林伽
មធ្យមនព្វន្ធ-ធរណីមាត្រ	算术-几何平均数
កូម៌ៈ	俱利摩
អាស៊ីហ្គេមឆ្នាំ១៩៧៤	1974年亚洲运动会
អាកាសយានដ្ឋានអន្តរជាតិតានសូនណាត្ត	新山一國際機場
KAI T-50 Golden Eagle	T-50金鷹式高級教練機
ឧបទ្វីបកូរ៉េ	朝鲜半岛
វីគីប្រជុំ	維基媒體國際會議
អាស៊ីហ្គេម	亚洲运动会
ទង់ជាតិសិង្ហបុរី	新加坡国旗
បង្អួចឆ្នាំ 2000	Windows 2000
តារាងអាំងតេក្រាលនៃអនុគមន៍សនិទាន	有理函数积分表
តារាងអាំងតេក្រាលនៃអនុគមន៍អ៊ីពែបូលីក	双曲函数积分表
សមីការដឺក្រេទី១	一次方程
តារាងអាំងតេក្រាលនៃអនុគមន៍ច្រាស់អ៊ីពែបូលីក	反双曲函数积分表
សញ្ញាជាតិអាហ្វហ្គានីស្ថាន	阿富汗国徽
E-commerce	电子商务
Sukhoi Superjet 100	苏霍伊超级喷气机-100
គណកម្មាធិការអូឡាំពិកកូរ៉េ	大韓民國奧林匹克委員會
កីឡាអាស៊ីខាងកើតឆ្នាំ១៩៩៧	1997年東亞運動會
ច្រកខាន់ម៉ុង	關門海峽
អាស៊ីហ្គេមឆ្នាំ២០០២	2002年亚洲运动会
ឆកសមុទ្រលាវតុង	辽东湾
ឆកសមុទ្របូហៃ	渤海湾
T-ARA	T-ara
អាស៊ីហ្គេមឆ្នាំ១៩៨៦	1986年亚洲运动会
អាណាស្រុកម៉ូបាល (អាល់ឡាបាម៉ា)	莫比爾縣
កូរ៉េ	韓國教育
ម្កាក់	番橄榄
បារខែម	BarCamp
ដើមត្នោត	糖棕
ព្រះបាទសូរ្យវរ្ម័នទី១	蘇利耶跋摩一世
ខេត្តកំពង់ធំ	磅同省
ខេត្តព្រះវិហារ	柏威夏省
ខេត្ត ហួ ផាន់	华潘省
ខ្វែងអាចម៍ក្រពើ	阿速坡省
បញ្ជីទីក្រុងនិងទីប្រជុំជននៅកម្ពុជា	柬埔寨城市列表
ខេត្តខាំមួន	甘蒙省
ខេត្តប៉ៃលិន	拜林市
ឆាយាលក្សសារព័ត៌មាន	攝影記者
បារីសង់	几何中心
វិសមភាពប៊ូល	布尔不等式
ស៊ីសុវត្ថិ មុនីវង្ស	西索瓦·莫尼旺
អង្គឌួង	安东 (柬埔寨)
រូបមន្តប្រេឆ្នៃដឺ	布雷特施奈德公式
ក្រុមបាល់ទាត់ជម្រើសជាតិ កូរ៉េខាងត្បូង	韓國國家男子足球隊
សុញ្ញតា	空性
គោលនយោបាយសាធារណៈ	公共政策
Xian MA60	新舟60
ប្រមា	马来豪猪
ភូមិសាស្រ្ដនៃប្រទេសកម្ពុជា	柬埔寨地理
នរោត្តម	诺罗敦·安·吴哥
ម៉ាសែលលីន ចាមប៉ាញេត	馬塞林·尚巴納
ព្រះបាទយសោវរ្ម័នទី១	耶输跋摩一世
Chengdu J-20	歼-20战斗机
វេយ្យាករណ៍អង់គ្លេស	英語語法
ព្រះបាទឥន្រ្ទវរ្ម័នទី១	因陀罗跋摩一世
ស៊ីឡាត	席拉
ទ្រឹស្តីបទវ្យែត	韦达定理
ប្រាសាទភ្នំបាខែង	巴肯寺
តារាងអាំងតេក្រាលនៃអនុគមន៍អិចស្ប៉ូណង់ស្យែល	指数函数积分表
តារាងអាំងតេក្រាលនៃអនុគមន៍អសនិទាន	无理函数积分表
តារាងអាំងតេក្រាលនៃអនុគមន៍លោការីត	对数函数积分表
អាំងតេក្រាលហ្វ្រេនែល	菲涅耳積分
គោលនយោបាយសេដ្ឋកិច្ច	经济政策
ប្រាសាទភិមានអាកាស	空中宫殿
Baskin​-Robbins បាន	31冰淇淋
ទិវាសេរីភាពសារព័ត៌មានពិភពលោក	世界新聞自由日
ប្រាសាទតាព្រហ្ម	塔布茏寺
អាជ្ញាធរអន្តរកាលសហប្រជាជាតិនៅកម្ពុជា	联合国柬埔寨过渡时期权力机构
ប្រាសាទធម្មនន្ទ	塔瑪儂遺址
អាំងតេក្រាលផ្ទៃ	曲面积分
ប្រាសាទបន្ទាយក្តី	斑黛喀蒂寺
មជ្ឈិមនិកាយ	中部 (佛經)
ស្រះស្រង់	皇家浴池
ខេត្តតាកែវ	茶胶省
បជាបតិគោតមី	摩訶波闍波提
ខេត្តហ៊ីរ៉ូស៊ីម៉ា	廣島縣
ព្រះសហគមន៏កាតូលិកភូមិភាគភ្នំពេញ	天主教金边宗座代牧区
បន្ទប់រៀន	教室
ជំរំជនភៀសខ្លួន	难民营
ហ្គូតហ្គោល	Google协作平台
ខេត្តឧត្ដរមានជ័យ	奥多棉吉省
ប្រភេទស្រាទំពាំងបាយជូរពីប្រទេសបារាំង	法国葡萄酒
អុក	泰國象棋
បទនគររាជ	王國 (柬埔寨)
នគររាជសីមា	呵叻
ចំនួនអាកស៊ីម៉ែដ	阿基米德数
សង្គ្រាមកម្ពុជា-វៀតណាម	柬越戰爭
តំលៃលើការចាប់អារម្មណ៍	千次印象费用
អនុគមន៍អ៊ីពែបូលីកច្រាស់	反双曲函数
បញ្ជីរាយនាម ជ័យលាភីរង្វាន់ណូបែលសន្តិភាព	諾貝爾和平獎得主列表
១៥០	150
ស្ទឹងស៊ីលីវូង	吉利翁河
ទ្រឹស្តីបទពីក	皮克定理
ខេត្តសៀមរាប	暹粒省
ខេត្តមណ្ឌលគិរី	蒙多基里省
ខេត្តកំពង់ស្ពឺ	磅士卑省
អុនសេន	日式溫泉
ឧត្តមស្នងការអង្គការសហប្រជាជាតិទទួលបន្ទុកសិទ្ធិមនុស្ស	联合国人权事务高级专员办事处
សម រង្ស៊ី	桑蘭西
ត្រីតុកកែជ្រូក	驼背鲈
ជាតក	本生 (佛教)
ក្រុងហាកុណិ (ខេត្តកាណាហ្គាវ៉ា)	箱根町
អនុគមន៍ត្រីកោណមាត្រច្រាស់	反三角函数
ប្រវត្តិសាស្ត្រខ្មែរ	柬埔寨历史
ម៉ាជូ ពីជូ	马丘比丘
គណនីធនាគារ	銀行帳戶
ខ្សែទឹកប្រេស៊ីល	巴西洋流
ត្រកៀតប៉ោង	凤眼蓝
ជ្រោយណុតុ	能登半島
ចតុកោណចារឹកក្នុងរង្វង់	圆内接四边形
១៣៨	138
គីឡូម៉ែត្រការ៉េ	平方千米
ជី កុង	济公
ពហុកោណនិយ័ត	正多边形
ប្រទេសនៅអាស៊ី	亚洲国家和地区列表
១៤៤	144
ឆកសមុទ្រឡៃចូ	莱州湾
រលួស	刺桐
១៤០	140
១៤៣	143
១៤៧	147
១៤៦	146
១៤៩	149
១៤២	142
១៣៩	139
១៤៥	145
ប្រទេសមួយ ប្រព័ន្ធពីរ	一国两制
ត្រកៀត	雨久花科
បណ្តាញផ្លូវហាយវេអាស៊ី	亞洲公路網
អាស៊ីហ្គេមឆ្នាំ១៩៥៤	1954年亚洲运动会
អាស៊ីហ្គេមឆ្នាំ១៩៥៨	1958年亚洲运动会
អាស៊ីហ្គេមឆ្នាំ១៩៦៦	1966年亚洲运动会
អាស៊ីហ្គេមឆ្នាំ១៩៧៨	1978年亚洲运动会
អាស៊ីហ្គេមឆ្នាំ១៩៨២	1982年亚洲运动会
អាស៊ីហ្គេមឆ្នាំ១៩៩០	1990年亚洲运动会
អាស៊ីហ្គេមឆ្នាំ១៩៩៤	1994年亚洲运动会
អាស៊ីហ្គេមឆ្នាំ១៩៩៨	1998年亚洲运动会
Hongdu JL-8	教练-8
ច្រកចូហរ	柔佛海峡
ព្រះសង្ឃ	出家人
នគរលូ	鲁国
ត្រីរាជ	巨無齒𩷶
ទ្រឹស្តីបទស្តេអាត	斯图尔特定理
Yeghishe Charents	叶格依舍·恰连茨
Hongdu L-15	教练-10教练机
CAC/PAC JF-17 Thunder	梟龍戰機
ខេត្តរតនគិរី	腊塔纳基里省
បញ្ចក្ខន្ធ	蘊 (佛教)
Gloomy Sunday	憂鬱的星期天
ខេត្តហ្លួងព្រះបាង	琅勃拉邦省
ខេត្តកំពត	贡布省
សង្គ្រាមឥណ្ឌូចិនលើកទី១	第一次印度支那戰爭
ខេត្តស្វាយរៀង	柴楨省
សង្គាយនា	集结
ISO 9362	ISO 9362
ប៉ាកាយ៉ា	帕卡亚火山
ខ្លែងប្រម៉ង់	红腿小隼
ទិវាអក្ខរកម្មអន្តរជាតិ	国际扫盲日
ទ្រឹស្ដីបទការ៉េទាំង៤របស់ឡាហ្គ្រង់	四平方和定理
សុត្តន្តបិដក	经藏
ខេត្តអូគីណាវ៉ា	沖繩縣
មឹង អ៊ី	蒙毅
គណបក្សប្រជាជនកម្ពុជា	柬埔寨人民黨
អាស៊ីខាងត្បូង	南亚
អាំងតេក្រាលឌីរិចឡេ	狄利克雷積分
កំណាត់រង្វង់	弓形
ខេត្តក្រចេះ	桔井省
ប្រាសាទបាគង	巴孔寺
ប្រាសាទបន្ទាយស្រី	女王宫
ប្រាសាទបាពួន	巴普昂寺
សមីការឌីផេរ៉ង់ស្យែលប៊ែរនូយី	伯努利微分方程
កណ្ដុរភ្នំ	竹鼠屬
ឃុំបន្ទាយឆ្មារ	卜迭色瑪寺
ខេត្តបាត់ដំបង	馬德望省
តំបន់ត្រីកោណមាស	金三角
ប្រាសាទបឹងមាលា	崩密列
សង្គ្រាមផ្ទៃក្នុងកម្ពុជា	柬埔寨內戰
ESET	ESET
អាស៊ីហ្គេមរដូវរងារ	亞洲冬季運動會
ក្រុងយ៉ាណៃ	柳井市
កុសិនារា	拘尸那揭羅
KM	千米
BRIC	金砖四国
បញ្ជីព្រះមហាក្សត្រកម្ពុជា	柬埔寨君主列表
ផ្លូវកណ្ដាល	中道 (佛教)
ជម្រើសអ្នកប្រើប្រាស់	消费者理论
ខេត្តពោធិ៍សាត់	菩萨省
វិស័យអប់រំនៅប្រទេសជប៉ុន	日本教育
ខេត្តស្ទឹងត្រែង	上丁省
ប្រព័ន្ធគោល	底数 (对数)
ក្រុមប្រឹក្សាអូឡាំពិកអាស៊ី	亚洲奥林匹克理事会
McDonnell Douglas F-15E Strike Eagle	F-15E打擊鷹式戰鬥轟炸機
២៤២	242
តារាងអាំងតេក្រាលនៃអនុគមន៍ត្រីកោណមាត្រ	三角函数积分表
ច្រកកាលីម៉ាតា	卡里马塔海峡
បញ្ជី ប្រទេស មានចំនួនអ្នកអានសៀវភៅ	世界各国识字率列表
សារមន្ទីរទួលស្លែង	吐斯廉屠殺博物館
ខេត្តកែប	白馬市 (柬埔寨)
ទ្រឹស្តីបទវីវីអានី	维维亚尼定理
បញ្ជីអ្នកទទួលបានជ័យលាភីណូបែលខាងរូបវិទ្យា	诺贝尔物理学奖得主列表
VietJet Air	越捷航空
ភវវម៌្មទី១	拔婆跋摩一世
ក្រុងកំពង់ចាម	磅湛
សាកលវិទ្យាល័យ ចុឡាលុងករណ៍	朱拉隆功大学
Gallery of dependent territory flags	属地旗帜列表
អនុគមន៍ស៊ីនុសកាឌីណាល់	Sinc函数
ខេត្តព្រៃវែង	波萝勉省
អនុគមន៍ពហុហ្គាំម៉ា	多伽玛函数
ទ្រឹស្តីបទកូស៊ី-អាដាម៉ា	柯西－阿达马公式
គណៈកម្មាធិការជាតិអូឡាំពិកកម្ពុជា	柬埔寨奧林匹克委員會
កប្ប	劫數
ខ្សែទឹកអេក្វាទ័រខាងជើង	北赤道暖流
សាធារណរដ្ឋប្រជាមានិតកម្ពុជា	柬埔寨人民共和國
នគរវ្នំ	扶南
ក្រុងកំពត	贡布 (城市)
ខេត្តកំពង់ឆ្នាំង	磅清扬省
ស៊ីហ្គេម	东南亚运动会
ទ្រឹស្តីបទមេដ្យាន	中線定理
ISO 3166-3	ISO 3166-3
ព្រះនាងមាយា	摩耶夫人
ស៊ីសុវត្ថិ	西索瓦
ពោធិបក្ខិយធម៌	三十七菩提分法
ពោជ្ឈង្គ៧	七覺支
ព្រហ្មវិហារធម៌	四梵住
វីគីភីឌាភាសាខ្មែរ	挥发性有机物
ប្រទេសនៅអាមេរិកខាងត្បូង	南美洲国家和地区列表
ចំប៉ីសៀម	沙漠玫瑰
ជំនួយ:មាតិកា	Help:目录
ស៊ីហ្គេមលើកទី២៣	2005年東南亞運動會
ច្បាប់ប្រលេឡូក្រាម	平行四邊形恆等式
ចំនុចប៊្រូការ	布罗卡点
ទ្រឹស្តីបទកន្លះបន្ទាត់ពុះមុំ	角平分線定理
AgustaWestland Apache	阿帕契AH MK1直昇機
សាលាប្រព័ន្ធសាលារដ្ឋស្រុកម៉ូបាល	莫比尔县公立学校
ភ្នំភ្លើងអ៊ីស៊ាឡឺកធ្វើអោយខកខានការហោះហើរនៅអឺរ៉ុប	2010年埃亚菲亚德拉火山爆发导致欧洲领空关闭
មីក្រូម៉ែត្រការ៉េ	数量级 (面积)
ព្រៃវែង	波蘿勉
ធនធានដែលមិនកកើតឡើងវិញ	不可再生能源
ស៊ីហ្គេមលើកទី១១	1981年東南亞運動會
ជួរភ្នំដងរែក	扁擔山脈
ប្រាសាទព្រះខ័ន	圣剑寺
រូបមន្តញូតុន-កូត្ស	牛頓－寇次公式
កបិលវត្ថុ	迦毗羅衛
ទីភ្នាក់ងារសហប្រតិបត្តិការអន្តរជាតិជប៉ុន	国际协力机构
Nanchang Q-5	強-5
សុន សេន	宋先
គណកម្មាធិការអូឡាំពិកជប៉ុន	日本奧林匹克委員會
ចំនួនតេត្រាអែក	四面體數
ឧបាលិ	優婆離
អាំងតេក្រាលសេកង់គូប	正割函数的立方的积分
ព្រះពុទ្ធសាសនា​នៅ​ស្រីលង្កា	斯里兰卡佛教
ចំណុចរំពុះ	沸点
ក្រុងប៉ោយប៉ែត	波別
វិសមភាពភីដូ	佩多不等式
ក្រុងកំពង់ឆ្នាំង	磅清扬
តារាងអាំងតេក្រាលនៃអនុគមន៍ច្រាស់ត្រីកោណមាត្រ	反三角函数积分表
គណកម្មាធិការអូឡាំពិកជាតិសិង្ហបុរី	新加坡奧林匹克理事會
ត្រៃលក្ខណ៍	三相 (佛教)
អាកាសយានដ្ឋានអន្តរជាតិភ្នំពេញ	金邊國際機場
វិសមភាពហាតវីហ្គឺហ្វីនស្លឺ	芬斯拉不等式
ព្រះនិព្វាន៤ថ្នាក់	四向四果
សាធារណរដ្ឋខ្មែរ	高棉共和國
អក្សរខ្មែរ	高棉文
អាកាសយានដ្ឋានអន្តរជាតិសៀមរាបអង្គរ	暹粒-吴哥国际机场
ក្មេងទំនើង	青少年犯罪
ចេនឡា	真腊
វិសមភាព ហ្គោលដិន-ថមសុន	高登─湯普森不等式
ប្រកែកនយោបាយថៃ ស.ក.២០១០	2010年泰国反政府示威
ស្ដេចចក្រពត្តិ	轉輪王
តថាគត	如来
វិភង្គ	分別論
បុគ្គលបញ្ញត្តិ	人施設論
ជា ស៊ីម	谢辛
នគរឆឹន	陈国
ប្រព័ន្ធផ្សព្វផ្សាយសុក្រិត្យ	社交媒體優化
អាំងតេក្រាលប្តូរអថេរ	换元积分法
កម្មវីធីសូនីវីហ្គាស	Sony Vegas Pro
ស៊ីហ្គេមលើកទី២៥	2009年東南亞運動會
ខ្សែទឹកអេក្វាទ័រខាងត្បូង	南赤道洋流
សិក្ខាបទ៥	五戒
ការប្រកួតកីឡាជើងឯកចុងបូព៌ា	远东运动会
ប្រាសាទក្រវាន់	豆蔻寺
តារាងដេរីវេ	导数列表
មេកានិច​សូលីដ	固体力学
ការប្រកួតកីឡា កម្ពុជា	柬埔寨足球联赛
ប្រាសាទតាសោម	塔逊寺
អនុគមន៍ស្ករ៉ឺ	斯科惹函数
មធ្យមធរណីមាត្រ-អាម៉ូនិក	几何-调和平均数
CAIC Z-10	武直-10
អាំងតេក្រាលត្រីកោណមាត្រ	三角积分
សមីការឌីផេរ៉ងស្យែលក្លែរ៉ូ	克萊羅方程
រូបមន្តបេយ៉ា	貝拉公式
វិមានឯករាជ្យ	独立纪念碑 (金边)
ទ្រឹស្តីបទផលគុណកត្តា	因式定理
ប្រតិទិនឈប់សំរាកប្រចាំឆ្នាំ២០០៨	柬埔寨節日
ទង់ព្រះពុទ្ធសាសនា	国际佛教旗
វិសមភាពញូតុន	牛頓不等式
មករ	摩伽罗
តំបន់អឌ្ឍច័ន្ទមាស	金新月
សហរដ្ឋ	政治统一
អាស៊ីហ្គេមលើឆ្នេរខ្សាច់	亞洲沙灘運動會
បណ្ឌិត្យ​សភា​នីតិ​អន្តរជាតិ​នៃ​ទីក្រុង​ឡាអេ	海牙國際法學院
ស៊ីហ្គេមលើកទី២៦	2011年東南亞運動會
សម្រែកនៃដុលោរ៉េស៏	多洛雷斯呼声
ប្រពលវប្បកម្ម	精耕细作
សមភាពការ៉េទាំង៤របស់អឺលែរ	欧拉四平方和恒等式
ស៊េរីត្រីកោណមាត្រ	三角级数
រូបមន្តប្រាម៉ាហ្គឹបតា	婆羅摩笈多公式
មហាភូតរូប	大種
Shenyang J-11	歼-11战斗机
មុំក្នុង	內角和外角
ប្រាសាទអ៊ីវ៉ាឃឹនី	岩國城
សេដ្ឋកិច្ចតំបន់ អាសីុ	亞洲經濟
គ្រឹះស្ថានឧត្តមសិក្សាសាធារណៈនៅប្រទេសជប៉ុន	日本国立大学法人
កីឡាអាស៊ីខាងកើតឆ្នាំ១៩៩៣	1993年東亞運動會
កីឡាចុងបូព៌ាឆ្នាំ១៩៣៨	1938年远东运动会
មធ្យមហេរ៉ុង	希羅平均數
វិសមភាព វេតស្សឹនបុក	外森比克不等式
រូប	色 (佛教)
Kawasaki OH-1	川崎OH-1
កីឡាអាស៊ីខាងកើត	東亞運動會
បុណ្យ តារា	日本七夕
ស្ពានឃីងតៃ	錦帶橋
សមីការកូស៊ី-អយល័រ	柯西-歐拉方程
ស្ពានខាន់ម៉ុងក្យូ	關門橋
កីឡាអាស៊ីខាងត្បូង	南亞運動會
OSGeo	开源地理空间基金会
វិគីភីឌា:ស្ថានទូតខ្មែរ	Wikipedia:大使館
Bottleneck	瓶颈期
ស៊ីហ្គេមលើកទី២៧	2013年东南亚运动会
ស៊ីហ្គេមលើកទី១០	1979年東南亞運動會
រាជវង្សហុងបាង	鴻龐氏
ស៊ីហ្គេមលើកទី២៤	2007年東南亞運動會
ទីឃនិកាយ	長部 (佛經)
រដ្ឋសភាជាតិកម្ពុជា	柬埔寨国民议会
កូស៊ីនុស	餘弦
ខ្សែទឹកហ្គ្រីនលែនខាងលិច	西格陵蘭洋流
អាន ដ្យឿង វឿង	安阳王
ខ្សែទឹកកោះបាហ្វហ្វីន	巴芬島洋流
នគរតាវ	道國
កីឡាឧបទ្វីបអាស៊ីអាគ្នេយ៍លើកទី៣	1965年東南亞運動會
វិសមភាពស្យ៉ឺរ	舒尔不等式
អនុគមន៍ហ្គុឌែរម៉ាន់	古德曼函數
សាកលវិទ្យាល័យអាគីតា	秋田大學
ឃុនបរម	皮罗阁
មួយម៉ូនីកា	杨诗曼
Candies	糖果合唱團
កីឡាឧបទ្វីបអាស៊ីអាគ្នេយ៍លើកទី១	1959年東南亞運動會
កីឡាអាស៊ីកណ្ដាល	中亞運動會
កីឡាអាស៊ីខាងកើតឆ្នាំ២០០៥	2005年東亞運動會
កីឡាឧបទ្វីបអាស៊ីអាគ្នេយ៍លើកទី៧	1973年東南亞運動會
កីឡាអាស៊ីខាងកើតឆ្នាំ២០០១	2001年東亞運動會
សាកលវិទ្យាល័យហ្វឹគឹអ៊ី	福井大學
ស៊ីហ្គេមលើកទី២២	2003年東南亞運動會
ទ្រឹស្តីបទកាសី	开世定理
សមាគមអូឡាំពិកឥណ្ឌា	印度奧林匹克協會
កីឡាចុងបូព៌ាឆ្នាំ១៩១៥	1915年远东运动会
កីឡាចុងបូព៌ាឆ្នាំ១៩១៣	1913年遠東運動會
ESET NOD32 Antivirus	ESET NOD32
ស្រីសុរិយោពណ៌ទី២	奔哈·亚
វិគីភីឌា:Glossary	Wikipedia:术语表
នីវរណធម៌	五蓋
ចំណាត់ថ្នាក់ក្រុម:ប្រទេសជប៉ុន	Category:日本
ចំណាត់ថ្នាក់ក្រុម:ម៉ិកសិច	Category:墨西哥
ទ្រឹស្តីបទប្រាម៉ាហ្គឹបតា	婆羅摩笈多定理
ស្ងោរជ្រក់សាច់មាន់	雞湯
ចំណាត់ថ្នាក់ក្រុម:ឥណ្ឌូនេស៊ី	Category:印尼
ចំណាត់ថ្នាក់ក្រុម:សិង្ហបុរី	Category:新加坡
ចំណាត់ថ្នាក់ក្រុម:រូបវិទ្យា	Category:物理学
ចំណាត់ថ្នាក់ក្រុម:វិទ្យាសាស្រ្តធម្មជាតិ	Category:自然科学
ចំណាត់ថ្នាក់ក្រុម:ជីវវិទ្យា	Category:生物学
ចំណាត់ថ្នាក់ក្រុម:សាសនា	Category:宗教
ចំណាត់ថ្នាក់ក្រុម:កីឡា	Category:体育
ចំណាត់ថ្នាក់ក្រុម:វិទ្យាសាស្ត្រ	Category:科学
ប្រជាមតិទាក់ទងនឹងឯករាជភាពរបស់ស្កុតឡែនឆ្នំា២០១៤	2014年苏格兰独立公投
សំយុត្តនិកាយ	相應部
សាសនាក្នុងប្រទេសចិន	中国宗教
ចំនួនហ្គាលីលេ	伽利莱数
ត្រីគល់រាំង	巨暹羅鯉
ប្រវត្តិសាស្រ្តរបស់ទូរទស្សន៍	电视史
នើនដូ	Nuendo
អង្គាបុស្ប	老鸦烟筒花
Guizhou JL-9	教练-9
ចំនុចកណ្ដាល	中點
ខុទ្ទកនិកាយ	小部 (佛經)
ចាន់ ស៊ី	姜西
ទំព័រគំរូ:Dts	Template:Dts
បុណ្យកឋិន	供僧衣節
ទីក្រុងរ៉ូមបុរាណ	古罗马
ទំព័រគំរូ:Box-footer	Template:Box-footer
រឹសគូប	立方根
នរោត្ដម សុរាម្រិត	诺罗敦·苏拉玛里特
អាស៊ីហ្គេមអ៊ីនដរ	亞洲室內運動會
ទ្រឹស្តីបទរូទ	罗斯定理
សញ្ញាណលោការីត	对数恒等式
កោះត្រឡាច	昆仑岛
ក្រុមហ៊ុនអាកាសចរណ៏រ៉ូយ៉ាល់ខ្មែរអ៊ែរឡាញ	皇家高棉航空
ប៉ែន សុវណ្ណ	宾索万
ចំណាត់ថ្នាក់ក្រុម:អូឡាំពិក	Category:奥林匹克运动会
ចំណាត់ថ្នាក់ក្រុម:ព្រះពុទ្ធសាសនា	Category:佛教
វប្បធម៍បារាំង	法国文化
ប្រទេសនៅអាមេរិកខាងជើង	北美洲国家和地区列表
បញ្ជីឈ្មោះអនុគមន៍គណិតវិទ្យា	函数列表
ប្រអប់ខ្សាច់	沙盒
ពហុកីឡដ្ឋានជាតិអូឡាំពិក	奧林匹克體育場 (金邊)
កម្ពុជាសម័យលង្វែក	洛韦
អាកាសយានដ្ឋានអន្តរជាតិក្រុងព្រះសីហនុ	西哈努克國際機場
អង្គការសង្គមអភិរក្សសត្វព្រៃ	国际野生生物保护学会
សាកលវិទ្យាល័យអប់រំអៃឈិ	愛知教育大學
ការដឹងគ្រប់គ្រាន់នៃវិធីដកដង្ហើម១៦យ៉ាង	安那般那念
នគរគ័រខាងកើត	东虢国
ចម្ប៉ា	白蘭
ទំព័រគំរូ:Lang-ta	Template:Lang-ta
បរិស្ថាន	生态环境
ចំនួនអូតូម៉ហ្វីស	自守数
អូរកែវ	喔㕭文化
ពហុធាប៊ែរនូយី	伯努利多項式
ច្បាប់កំលាំងរបស់អំពែរ	安培力定律
ព្រះធម្មចក្កប្បវត្តនសូត្រ	转法轮经
ការផ្សាយពាណិជ្ជកម្ម	顯示廣告營銷
ខេត្តបលិខាំសៃ	博利坎赛省
ខណ្ឌរដ្ឋបាលសាលាភីឡាដេលផ្យា	费城教育局
ស្ពានព្រះមុនីវង្ស	莫尼旺大桥
ភ្នំឧដុង្គ	乌栋
ទ្រឹស្តីបទមីកេល	密克定理
ជនជាតិចារាយ(ខ្មែរលើ)	嘉莱族
ធម្មសង្គណី	法集論
អភិញ្ញា៦	神通
ចំនួនថេរត្រីកោណមាត្រពិត	三角函數精確值
បដ្ឋាន	發趣論
កថាវត្ថុ	論事
ធាតុកថា	界論
យមក	雙論
ព្រះរាជាណាចក្រកម្ពុជា (១៩៥៣-១៩៧០)	柬埔寨王国 (1953年－1970年)
រូបមន្តតង់សង់កន្លះមុំ	正切半角公式
ដប់ប្រាំពីរមេសាជោគជ័យ	光榮的四月十七日
មហេន្ទ្រវម៌្មទី១	摩诃因陀罗跋摩
បណ្តុំកន្សោមរ៉ាឌីកាល់	双重根号
កីឡាចុងបូព៌ាឆ្នាំ១៩២១	1921年远东运动会
ច្បាប់នៃកម្ម	因果论 (佛教)
កោណ្ឌញ្ញៈ	阿若憍陈如
កត្តាអាំងតេក្រាល	积分因子
ប្រជាសាស្ត្រនៃកម្ពុជា	柬埔寨人口
ទំព័រគំរូ:Location map USA2	Template:Location map USA2
ទ្រឹស្តីបទអូស្រ្តូស្គី	奥斯特洛夫斯基定理
ព្រហ្មជាលសូត្រ	梵網經 (上座部)
ចំណាត់ថ្នាក់ក្រុម:អត្ថបទខ្លីមិនពេញលេញ	Category:小作品
ចំណាត់ថ្នាក់ក្រុម:ទ្វីប	Category:大洲
ចំណាត់ថ្នាក់ក្រុម:ភូមិវិទ្យា	Category:地质学
ចំណាត់ថ្នាក់ក្រុម:យន្តហោះ	Category:航空器
ពិធីបុណ្យចូលឆ្នាំខ្មែរ	柬埔寨新年
ព្រះរាជពិធីច្រត់ព្រះនង្គ័ល	春耕节
បសេនទិកោសល	波斯匿王
ព្រឹទ្ធសភាកម្ពុជា	柬埔寨参议院
អនុគមន៍ដសុន	道森积分
ជនជាតិខ្មែរអ៊ីស្លាម	柬埔寨伊斯蘭教
កម្ពុជាសម័យអាណានិគមបារាំង	柬埔寨保护国
ទំព័រគំរូ:ប្រព័ន្ធព្រះអាទិត្យ	Template:太阳系
សាលារៀនសាធារណៈស៊ីតថល	西雅圖公立學校
ទុង សៀន	董贤
មធ្យមពីតាករ	毕达哥拉斯平均
អនុរុទ្ធ	阿尼律陀
ពីរ៉ាមីត	棱锥
និតិភូមិ នវរ័ត្ន	尼迪蓬·纳瓦拉
បុណ្យភ្ជុំបិណ្ឌ	亡人節
ពន្ធតែមប្រិ៍	印花税
ជំនួយ:ការកត់ឈ្មោះចូល	Help:登录
ការបោះឆ្នោតជ្រើសតាំងតំណាងរាស្ត្រ នីតិកាលទី៥ ឆ្នាំ២០១៣	2013年柬埔寨大选
គ្រោះមហន្តរាយ	灾害
វិគីភីឌា:Reference desk	Wikipedia:知识问答
ទំព័រគំរូ:Authority control	Template:Authority control
ទំព័រគំរូ:Quote	Template:Quote
ទំព័រគំរូ:Wikipedia languages	Template:Wikipedialang
ទំព័រគំរូ:Location map Scotland	Template:Location map Scotland
ទំព័រគំរូ:Location map England	Template:Location map England
ចំណាត់ថ្នាក់ក្រុម:សេដ្ឋកិច្ច	Category:经济学
វិគីភីឌា:សុំប្តូរអត្តនាម	Wikipedia:更改用户名
វិគីភីឌា:Oversight	Wikipedia:监督
វិគីភីឌា:IP block exemption	Wikipedia:IP封禁例外
ចំណាត់ថ្នាក់ក្រុម:Container categories	Category:母分类
វិគីភីឌា:រូបយន្ត	Wikipedia:机器人
ចំណាត់ថ្នាក់ក្រុម:Hidden categories	Category:隐藏分类
ទេវតា	天人 (佛教)
ក្រលាផ្ទៃរង្វង់	圆的面积
ទំព័រគំរូ:WP:UBS	Template:UBS
អេហ៊្សីប	埃及
វេយ្យាករណ៍ភាសាខ្មែរ	高棉語語法
ជំនួយ:ទំព័រគំរូ	Help:模板
ឦសានវម៌្មទី១	伊奢那跋摩一世
វិគីភីឌា:វិគីគម្រោង	Wikipedia:专题
យីហ៊ុប	夜香木兰
ទំព័រគំរូ:Bot	Template:Bot
វិគីភីឌា:អ្វីៗដែលវិគីភីឌាមិនអនុញ្ញាត	Wikipedia:维基百科不是什么
កាណាដា	加拿大
ចំណាត់ថ្នាក់ក្រុម:ប្រទេសអាយឡែន	Category:冰島
វិគីភីឌា:អំពីវិគីភីឌា	Wikipedia:关于
ចំណាត់ថ្នាក់ក្រុម:ខ្នាតក្រលាផ្ទៃ	Category:面積單位
ជំនួយ:ពាក្យទិព្វ	Help:魔术字
ទំព័រគំរូ:Flagicon	Template:Flagicon
ចំណាត់ថ្នាក់ក្រុម:អឺរ៉ុប	Category:欧洲
ចំណាត់ថ្នាក់ក្រុម:ជំនួយក្នុងវិគីភីឌា	Category:帮助文档
វិគីភីឌា:ទំព័រអ្នកប្រើប្រាស់	Wikipedia:使用者頁面
វិគីភីឌា:ព្រឹត្តិការណ៍​ថ្មីៗ	Portal:新聞動態
ទំព័រគំរូ:Documentation	Template:Documentation
វិគីភីឌា:អ្នកប្រើប្រាស់	Wikipedia:用户权限级别
ចំណាត់ថ្នាក់ក្រុម:Wikipedia pages with incorrect protection templates	Category:保護狀態與保護標誌不符的頁面
វិគីភីឌា:Protection policy	Wikipedia:保護方針
វិគីភីឌា:WikiLove	Wikipedia:维基友爱
វិគីភីឌា:Userboxes	Wikipedia:用戶框
វិគីភីឌា:ហត្ថលេខា	Wikipedia:签名
វិគីភីឌា:អត្ថបទខ្លីមិនពេញលេញ	Wikipedia:小作品
វិគីភីឌា:លក្ខណៈវិនិច្ឆ័យនៃលុបជាបន្ទាន់	Wikipedia:快速删除守则
វិគីភីឌា:Most wanted articles	Wikipedia:条目请求
ចំណាត់ថ្នាក់ក្រុម:ទំព័រអសង្ស័យកម្ម អំពីឈ្មោះទីកន្លែង	Category:地名消歧义
្ឞ្ញ ហ្សអិ-អិអៀ	成在基
ទំព័រគំរូ:Facebook navbox	Template:Facebook navbox
វិគីភីឌា:Huggle	Wikipedia:Huggle
អ្នកយកការណ៍នៅទ្វីបអាស៊ី (Asian Correspondent)	Asian Correspondent
ទំព័រគំរូ:Softredirect	Template:軟重定向
ទំព័រគំរូ:លុបជាបន្ទាន់	Template:Delete
ក្លោងទ្វារ:ចិន	Portal:中国
វិគីភីឌា:វិគីគម្រោង ជីវប្រវត្តិ	Wikipedia:传记专题
ទំព័រគំរូ:Succession	Template:Succession
ការត្រួតត្រារបស់ជប៉ុននៅកម្ពុជា	柬埔寨日占时期
ឫសទី១២នៃ២	2的12次方根
នរោត្តម មុនីនាថ សីហនុ	诺罗敦·莫尼列
កូក្លេអូអ៊ីត	蜗牛线
ឧទ្យានជាតិមុនីវង្យបូកគោ	波哥国家公园
សតិប្បដ្ឋាន	大念处经
ចំណាត់ថ្នាក់ក្រុម:ភាសា	Category:语言
ចំណាត់ថ្នាក់ក្រុម:វេយ្យាករណ៍	Category:语法
ចំណាត់ថ្នាក់ក្រុម:វិគីភីឌា	Category:维基百科
វិគីភីឌា:ការបដិសេធ ទូទៅ	Wikipedia:免责声明
ជំនួយ:ចំណាត់ថ្នាក់ក្រុម	Help:分类
វិគីភីឌា:សារទំព័រគំរូ	Wikipedia:模板消息
វិគីភីឌា:អសង្ស័យកម្ម	Wikipedia:格式手册
Portal:Contents/Portals	Portal:首頁
គណបក្សសង្គ្រោះជាតិ	柬埔寨救国党
ទំព័រគំរូ:Navbox	Template:Navbox
ជំនួយ:រូបមន្ត	Help:数学公式
ទំព័រគំរូ:Coat of arms	Template:Coat of arms
ជំនួយ:តំណភ្ជាប់	Help:链接
ទំព័រគំរូ:Citation needed	Template:Fact
តំបន់ពាណិជ្ជកម្មសេរី	自由贸易区
ទំព័រគំរូ:Error	Template:Error
ចំណាត់ថ្នាក់ក្រុម:Flag templates	Category:旗帜模板
ទំព័រគំរូ:((	Template:((
ទំព័រគំរូ:))	Template:))
ទំព័រគំរូ:=	Template:=
ទំព័រគំរូ:Navbar	Template:Navbar
ទំព័រគំរូ:Loop	Template:Loop
ទំព័រគំរូ:Void	Template:Void
ទំព័រគំរូ:Key press	Template:键盘按钮
ទំព័រគំរូ:Okina	Template:Okina
ទំព័រគំរូ:Transclude	Template:Transclude
ទំព័រគំរូ:Sc	Template:Smallcaps
ទំព័រគំរូ:Small	Template:Small
ទំព័រគំរូ:Clear	Template:Clear
ទំព័រគំរូ:Col-break	Template:Col-break
ទំព័រគំរូ:Col-begin	Template:Col-begin
ទំព័រគំរូ:Col-end	Template:Col-end
ទំព័រគំរូ:Trim	Template:Trim
ទំព័រគំរូ:Color	Template:Color
ទំព័រគំរូ:Nowrap	Template:Nowrap
ទំព័រគំរូ:Bots	Template:Bots
ទំព័រគំរូ:Abbr	Template:Abbr
ទ្រឹស្តីបទមុំក្រៅ	外角定理
ចំណាត់ថ្នាក់ក្រុម:ខ្សែកោង	Category:曲線
ទំព័រគំរូ:Babel	Template:Babel
ទំព័រគំរូ:Commons	Template:Commons
ទំព័រគំរូ:Link GA	Template:Link GA
ទំព័រគំរូ:Reflist	Template:Reflist
ទំព័រគំរូ:NavPeriodicTable	Template:NavPeriodicTable
វិគីភីឌា:Citing sources	Wikipedia:列明来源
ទំព័រគំរូ:អត្ថបទខ្លីមិនពេញលេញ	Template:Stub
ទំព័រគំរូ:User af-1	Template:User af-1
ទំព័រគំរូ:User az	Template:User az
ទំព័រគំរូ:User bar-1	Template:User bar-1
ទំព័រគំរូ:See also	Template:See also
ទំព័រគំរូ:User de	Template:User de
ទំព័រគំរូ:User de-1	Template:User de-1
ទំព័រគំរូ:User et-1	Template:User et-1
ទំព័រគំរូ:User el	Template:User el
ទំព័រគំរូ:User es	Template:User es
ទំព័រគំរូ:User de-3	Template:User de-3
ទំព័រគំរូ:User en-3	Template:User en-3
ទំព័រគំរូ:User en-1	Template:User en-1
ទំព័រគំរូ:User en-2	Template:User en-2
ទំព័រគំរូ:User en-4	Template:User en-4
ទំព័រគំរូ:User fi	Template:User fi
ទំព័រគំរូ:User en-0	Template:User en-0
ទំព័រគំរូ:User es-4	Template:User es-4
ទំព័រគំរូ:User en	Template:User en
ទំព័រគំរូ:User de-2	Template:User de-2
ទំព័រគំរូ:User es-1	Template:User es-1
ទំព័រគំរូ:User fa	Template:User fa
ទំព័រគំរូ:User fr-1	Template:User fr-1
ទំព័រគំរូ:User id-3	Template:User id-3
ទំព័រគំរូ:User it-3	Template:User it-3
ទំព័រគំរូ:User tr-2	Template:User tr-2
ទំព័រគំរូ:User fr-2	Template:User fr-2
ទំព័រគំរូ:User tr	Template:User tr
ទំព័រគំរូ:User ja	Template:User ja
ទំព័រគំរូ:User ja-1	Template:User ja-1
ទំព័រគំរូ:User it-1	Template:User it-1
ទំព័រគំរូ:User fr	Template:User fr
ទំព័រគំរូ:User gsw-1	Template:User gsw-1
ទំព័រគំរូ:Location map/Info	Template:Location map/Info
ចំណាត់ថ្នាក់ក្រុម:Navigational boxes	Category:導航模板
ទំព័រគំរូ:ទិន្នន័យ នៃប្រទេសតាជីគីស្ថាន	Template:Country data Tajikistan
ចំណាត់ថ្នាក់ក្រុម:អាស៊ី	Category:亚洲
ចំណាត់ថ្នាក់ក្រុម:User uk-N	Category:Uk 母語使用者
ទំព័រគំរូ:Intricate template	Template:Esoteric
ទំព័រគំរូ:Lang-ja	Template:Lang-ja
ទំព័រគំរូ:Football squad player	Template:Football squad player
ទំព័រគំរូ:ទិន្នន័យប្រទេស គុយវ៉ែត	Template:Country data Kuwait
ទំព័រគំរូ:Mod	Template:Mod
ទំព័រគំរូ:Now Commons	Template:NowCommons
ទំព័រគំរូ:User it	Template:User it
ទំព័រគំរូ:User uk	Template:User uk
ទំព័រគំរូ:User es-2	Template:User es-2
ទំព័រគំរូ:ស្វាគមន៍	Template:Welcome
ទំព័រគំរូ:គម្រោងវិគីជាបងប្អូន	Template:Wikipediasister
ចំណាត់ថ្នាក់ក្រុម:External link templates	Category:外部资源模板
ទំព័រគំរូ:ទិន្នន័យប្រទេស ស្លូវ៉ាគី	Template:Country data Slovakia
ចំណាត់ថ្នាក់ក្រុម:ទំព័រគំរូសំរាប់កូអរដោនេ	Category:經緯模板
ទំព័រគំរូ:USA	Template:USA
ទំព័រគំរូ:ទិន្នន័យប្រទេស អេត្យូពី	Template:Country data Ethiopia
ទំព័រគំរូ:ទិន្នន័យប្រទេស ឆេក	Template:Country data Czech Republic
ទំព័រគំរូ:ទិន្នន័យ នៃប្រទេសថៃ	Template:Country data Thailand
ទំព័រគំរូ:Scinote	Template:Scinote
ទំព័រគំរូ:ទិន្នន័យប្រទេស គុយបា	Template:Country data Cuba
ទំព័រគំរូ:Lang-km	Template:Lang-km
ទំព័រគំរូ:ទិន្នន័យប្រទេស អាល់បានី	Template:Country data Albania
ទំព័រគំរូ:ទិន្នន័យ នៃប្រទេសប៉េរូ	Template:Country data Peru
ទំព័រគំរូ:ទិន្នន័យ នៃប្រទេសម៉ាកាវ	Template:Country data Macau
ទំព័រគំរូ:User wikipedia	Template:User wikipedia
ទំព័រគំរូ:ទិន្នន័យប្រទេស សាធារណរដ្ឋចិន	Template:Country data Republic of China
ទំព័រគំរូ:ទិន្នន័យ នៃប្រទេសអ៊ូបេគីស្ថាន	Template:Country data Uzbekistan
ចំណាត់ថ្នាក់ក្រុម:User ms	Category:Ms 使用者
ទំព័រគំរូ:ទិន្នន័យ នៃប្រទេសឡាតវី	Template:Country data Latvia
ទំព័រគំរូ:Football kit	Template:Football kit
ទំព័រគំរូ:ទិន្នន័យ នៃប្រទេសម៉ាល់តា	Template:Country data Malta
ទំព័រគំរូ:ទិន្នន័យ នៃប្រទេសម៉ូណាកូ	Template:Country data Monaco
ទំព័រគំរូ:ទិន្នន័យ នៃប្រទេសដាណឺម៉ាក	Template:Country data Denmark
ទំព័រគំរូ:ទិន្នន័យ នៃប្រទេសប៉ូឡូញ	Template:Country data Poland
ទំព័រគំរូ:Wikipedia policies and guidelines	Template:Rules
ចំណាត់ថ្នាក់ក្រុម:User fr-1	Category:Fr-1 使用者
ទំព័រគំរូ:ទិន្នន័យ នៃប្រទេសណ័រវ៉េ	Template:Country data Norway
ទំព័រគំរូ:ទិន្នន័យប្រទេស ហ្សកហ៊្សី	Template:Country data Georgia
ទំព័រគំរូ:Navbox suite	Template:Navbox suite
ទំព័រគំរូ:Wikiquote	Template:Wikiquote
ទំព័រគំរូ:Country showdata	Template:Country showdata
ទំព័រគំរូ:Image label	Template:Image label
ទំព័រគំរូ:Cat handler	Template:Category handler
ទំព័រគំរូ:ទិន្នន័យប្រទេស ស្រីលង្កា	Template:Country data Sri Lanka
ទំព័រគំរូ:ទិន្នន័យ នៃប្រទេសមិចសិច	Template:Country data Mexico
ទំព័រគំរូ:ទិន្នន័យប្រទេស ក្រិច	Template:Country data Greece
ទំព័រគំរូ:Infobox dot-com company	Template:Infobox dot-com company
ទំព័រគំរូ:ទិន្នន័យ នៃប្រទេសអារ៉ាប៊ីសាអូឌីត	Template:Country data Saudi Arabia
ទំព័រគំរូ:Category tree	Template:Category tree
ទំព័រគំរូ:ទិន្នន័យប្រទេស ក្រូអាត	Template:Country data Croatia
ទំព័រគំរូ:ប្រអប់ព័ត៌មាន អ្នកនិពន្ធ	Template:Infobox Writer
ទំព័រគំរូ:Stub category	Template:Stub Category
ទំព័រគំរូ:Ja icon	Template:Ja icon
ទំព័រគំរូ:ទិន្នន័យ នៃប្រទេសសហភាពអារ៉ាប់អេមីរ៉េត	Template:Country data United Arab Emirates
ទំព័រគំរូ:Infobox television	Template:电视节目信息框
ទំព័រគំរូ:Geographic location	Template:Geographic Location
ទំព័រគំរូ:Prose	Template:Prose
ទំព័រគំរូ:Infobox musical artist	Template:Infobox musical artist
ទំព័រគំរូ:Finance	Template:金融
ទំព័រគំរូ:ទិន្នន័យប្រទេស Serbia	Template:Country data Serbia
ទំព័រគំរូ:Collapsible list	Template:Collapsible list
ទំព័រគំរូ:ទិន្នន័យ នៃប្រទេសអូស្រ្តាលី	Template:Country data Australia
ទំព័រគំរូ:ទិន្នន័យ​នៃប្រទេសប៉ាឡេស្ទីន	Template:PSE
ទំព័រគំរូ:Subatomic particle	Template:次原子粒子
ទំព័រគំរូ:Sidebar	Template:Sidebar
ទំព័រគំរូ:In use	Template:Inuse
ទំព័រគំរូ:Es icon	Template:Es icon
ទំព័រគំរូ:ទិន្នន័យ នៃប្រទេសបារាំង	Template:Country data France
ទំព័រគំរូ:Ambox	Template:Ambox
ទំព័រគំរូ:Update	Template:更新
ទំព័រគំរូ:ប្រអប់ព័ត៌មាន មន្ទីរពេទ្យ	Template:Infobox Hospital
ទំព័រគំរូ:ប្រអប់ព័ត៌មាន ទស្សនាវដ្ដី	Template:Infobox Magazine
ទំព័រគំរូ:Image requested	Template:Reqimage
ទំព័រគំរូ:ប្រអប់ព័ត៌មាន ភ្លេងជាតិ	Template:Infobox Anthem
ទំព័រគំរូ:Navigation templates	Template:Navigational templates
ទំព័រគំរូ:Very long	Template:冗长
ទំព័រគំរូ:ទិន្នន័យ​នៃប្រទេសគាហ្គីស្ថាន	Template:KGZ
ទំព័រគំរូ:ប្រអប់ព័ត៌មាន សាលារៀន	Template:Infobox School
ទំព័រគំរូ:Fossil range/bar	Template:Fossil range/bar
ទំព័រគំរូ:Userboxbottom	Template:Userboxbottom
ទំព័រគំរូ:Copy to Wikimedia Commons	Template:Copy to Wikimedia Commons
ទំព័រគំរូ:Rnd	Template:Rnd
ទំព័រគំរូ:ចំណាត់ថ្នាក់ក្រុមនៃទំព័រគំរូ	Template:Template category
ទំព័រគំរូ:Font color	Template:Fontcolor
ទំព័រគំរូ:ប្រអប់ព័ត៌មាន ប្រទេស	Template:國家基礎資訊
ទំព័រគំរូ:Max	Template:Max
ទំព័រគំរូ:Infobox software	Template:Infobox software
ទំព័រគំរូ:Column-count	Template:Column-count
ទំព័រគំរូ:Commons&cat	Template:Commons and category
ទំព័រគំរូ:ទិន្នន័យប្រទេស ឡាវ	Template:Country data Laos
ទំព័រគំរូ:Infobox airline	Template:Infobox Airline
ទំព័រគំរូ:Wide image	Template:Wide image
ទំព័រគំរូ:ទិន្នន័យ នៃប្រទេសអូទ្រីស	Template:Country data Austria
ទំព័រគំរូ:Collapsible option	Template:Collapsible option
ទំព័រគំរូ:ប្រអប់ព័ត៌មាន ជម្លោះយោធា	Template:Infobox Military Conflict
វិគីភីឌា:សំណួរ	Wikipedia:問題
ទំព័រគំរូ:Redirect4	Template:Str left
ទំព័រគំរូ:ទិន្នន័យ នៃប្រទេសនេប៉ាល់	Template:Country data Nepal
ទំព័រគំរូ:Pagelist	Template:Pagelist
ទំព័រគំរូ:Px	Template:Px
ទំព័រគំរូ:Resolved	Template:完成
ទំព័រគំរូ:Str sub long	Template:Str sub old
ទំព័រគំរូ:Documentation/docname	Template:Documentation/docname
ទំព័រគំរូ:ទិន្នន័យ នៃប្រទេសហ្វាំងឡង់	Template:Country data Finland
ទំព័រគំរូ:Selfref	Template:Selfref
ទំព័រគំរូ:Flatlist	Template:Flatlist
ទំព័រគំរូ:ទិន្នន័យ​នៃប្រទេសហ្វីលីពីន	Template:PHL
ទំព័រគំរូ:ទិន្នន័យ នៃប្រទេសអេស៊ីប	Template:Country data Egypt
ទំព័រគំរូ:ទិន្នន័យ នៃប្រទេសលីថូនី	Template:Country data Lithuania
ទំព័រគំរូ:ប្រអប់ព័ត៌មាន គណបក្សនយោបាយ	Template:Infobox Political Party
ទំព័រគំរូ:Used in system	Template:Used in system
ទំព័រគំរូ:ទិន្នន័យប្រទេស ជប៉ុន	Template:Country data Japan
ទំព័រគំរូ:Expand section	Template:Expand section
ទំព័រគំរូ:ទិន្នន័យ នៃប្រទេសហូឡង់	Template:Country data Netherlands
ទំព័រគំរូ:Tmbox	Template:Tmbox
ទំព័រគំរូ:Navbox with columns	Template:Navbox with columns
ទំព័រគំរូ:ប្រអប់ព័ត៌មាន ល្បែងវីដេអូ	Template:Infobox VG
ទំព័រគំរូ:S-start	Template:Start
ទំព័រគំរូ:Age in years and days	Template:Age in years and days
ទំព័រគំរូ:Nom	Template:Nom
ទំព័រគំរូ:Facebook	Template:Facebook
ទំព័រគំរូ:Cleanup	Template:Cleanup
ទំព័រគំរូ:ប្រអប់ព័ត៌មាន សាកលវិទ្យាល័យ	Template:Infobox university
ទំព័រគំរូ:Cite journal	Template:Cite journal
ទំព័រគំរូ:ទិន្នន័យប្រទេស អាស៊ែបៃហ្សង់	Template:Country data Azerbaijan
ទំព័រគំរូ:ទិន្នន័យ​នៃប្រទេសប្រ៊ុយណេ	Template:BRN
ទំព័រគំរូ:វិគីសៀវភៅ	Template:Wikibooks
ទំព័រគំរូ:Hatnote	Template:Dablink
ទំព័រគំរូ:User browser:Firefox	Template:User Firefox
ទំព័រគំរូ:Xpd	Template:Xpd
ទំព័រគំរូ:User es-0	Template:User es-0
ទំព័រគំរូ:Time ago	Template:Time to
ទំព័រគំរូ:Familytree	Template:Familytree
ទំព័រគំរូ:ទិន្នន័យប្រទេស វៀតណាម	Template:Country data Vietnam
ទំព័រគំរូ:Redirect3	Template:Redirect3
ទំព័រគំរូ:S-aft	Template:S-after
ទំព័រគំរូ:Featured article	Template:Featured article
ទំព័រគំរូ:ទិន្នន័យ នៃប្រទេសរុស្ស៊ី	Template:Country data Russia
ទំព័រគំរូ:Infobox monarch	Template:Infobox Monarch
ទំព័រគំរូ:Decdeg	Template:Decdeg
ចំណាត់ថ្នាក់ក្រុម:User en-4	Category:En-4 使用者
ចំណាត់ថ្នាក់ក្រុម:User en	Category:En 使用者
ទំព័រគំរូ:Ordinal	Template:Ordinal
ចំណាត់ថ្នាក់ក្រុម:User zh	Category:Zh 使用者
ចំណាត់ថ្នាក់ក្រុម:User zh-N	Category:Zh 母语使用者
ចំណាត់ថ្នាក់ក្រុម:User en-2	Category:En-2 使用者
ទំព័រគំរូ:ប្រអប់ព័ត៌មាន	Template:Infobox
ទំព័រគំរូ:Infobox instrument	Template:Infobox instrument
ទំព័រគំរូ:TOC right	Template:TOCright
ទំព័រគំរូ:ប្រអប់ព័ត៌មាន ប្រាសាទ	Template:Infobox Mandir
ទំព័រគំរូ:Main other	Template:Main other
ទំព័រគំរូ:RankedMedalTable	Template:RankedMedalTable
ទំព័រគំរូ:User zh	Template:User zh
ទំព័រគំរូ:Lang-kk	Template:Lang-kk
ទំព័រគំរូ:Documentation/start box	Template:Documentation/start box
ទំព័រគំរូ:Documentation/end box2	Template:Documentation/end box2
ទំព័រគំរូ:Documentation/start box2	Template:Documentation/start box2
ទំព័រគំរូ:Template other	Template:Template other
ទំព័រគំរូ:Legend	Template:Legend
ទំព័រគំរូ:ប្រអប់ព័ត៌មាន បណ្ណាល័យ	Template:Infobox Library
ទំព័រគំរូ:Cite web	Template:Cite web
ទំព័រគំរូ:YouTube	Template:Youtube
ទំព័រគំរូ:ទិន្នន័យ នៃប្រទេសអ៊ីតាលី	Template:Country data Italy
ទំព័រគំរូ:Current	Template:Current
ទំព័រគំរូ:Ombox	Template:Ombox
ទំព័រគំរូ:ទិន្នន័យប្រទេស	Template:Country data
ទំព័រគំរូ:Wikipedia-screenshot	Template:Wikipedia-screenshot
ទំព័រគំរូ:Won	Template:Award-won
ទំព័រគំរូ:Tnavbar-collapsible	Template:Tnavbar-collapsible
ទំព័រគំរូ:Coor URL	Template:MapsServer
ទំព័រគំរូ:Pp-template	Template:Pp-template
ទំព័រគំរូ:Min	Template:Min
ទំព័រគំរូ:Wiktionary	Template:Wiktionary
ទំព័រគំរូ:Mbox templates	Template:Mbox templates
ទំព័រគំរូ:Multi-listen start	Template:Multi-listen start
ទំព័រគំរូ:ទិន្នន័យ នៃប្រទេសស៊ុយអែត	Template:Country data Sweden
ទំព័រគំរូ:Bar box	Template:Bar box
ទំព័រគំរូ:Chem	Template:Chem
ទំព័រគំរូ:Language icon	Template:Language icon
ទំព័រគំរូ:Lang-sr	Template:Lang-sr
ទំព័រគំរូ:Infobox settlement	Template:Infobox Settlement
ទំព័រគំរូ:User ru	Template:User ru
ទំព័រគំរូ:Admin	Template:管理员用户
ទំព័រគំរូ:IPA	Template:IPA
ទំព័រគំរូ:អត្ថន័យដទៃទៀត	Template:Otheruses
ទំព័រគំរូ:ទិន្នន័យប្រទេស សហភាពសូវៀត	Template:Country data Soviet Union
ទំព័រគំរូ:ទិន្នន័យ នៃប្រទេសឥណ្ឌា	Template:Country data India
ទំព័រគំរូ:Language with name	Template:LangWithName
ទំព័រគំរូ:Imbox	Template:Imbox
ទំព័រគំរូ:Rellink	Template:Rellink
ទំព័រគំរូ:Navbox subgroup	Template:Navbox subgroup
ទំព័រគំរូ:Non-free use rationale	Template:Non-free use rationale
ទំព័រគំរូ:Birth year and age	Template:Birth date and age
ទំព័រគំរូ:List of African capitals	Template:非洲首都
ទំព័រគំរូ:ប្រអប់ព័ត៌មាន ក្រុមជនជាតិ	Template:Infobox Ethnic group
ទំព័រគំរូ:Archive box	Template:Archive box
ទំព័រគំរូ:MONTHNAME	Template:MONTHNAME
វិគីភីឌា:Text of GNU Free Documentation License	Wikipedia:GNU自由文档许可证文本
ទំព័រគំរូ:Commons category-inline	Template:Commons category-inline
ទំព័រគំរូ:រង្វាន់ណូបែល	Template:NobelPrizes
ទំព័រគំរូ:Sisterlinks	Template:Sister project links
ទំព័រគំរូ:ទិន្នន័យប្រទេស អង់ដូរ៉ា	Template:Country data Andorra
ទំព័រគំរូ:ប្រអប់ព័ត៌មាន តំបន់ការពារ	Template:Infobox Protected area
ទំព័រគំរូ:Border	Template:Border
ទំព័រគំរូ:ទិន្នន័យប្រទេស ព័រទុយហ្គាល់	Template:Country data Portugal
ទំព័រគំរូ:Death date and age	Template:Death date and age
ទំព័រគំរូ:MONTHNUMBER	Template:MONTHNUMBER
ចំណាត់ថ្នាក់ក្រុម:People stubs	Category:人物小作品
ទំព័រគំរូ:ទិន្នន័យប្រទេស បុរីវ៉ាទីកង់	Template:Country data Vatican City
ទំព័រគំរូ:Top icon	Template:Topicon
ទំព័រគំរូ:Icon	Template:Icon
ចំណាត់ថ្នាក់ក្រុម:Template:Country data templates	Category:国家资料模板
ទំព័រគំរូ:Birth category header	Template:出生年
ទំព័រគំរូ:Namespace detect	Template:Namespace detect
ចំណាត់ថ្នាក់ក្រុម:ជ័យលាភីរង្វាន់ណូបែល ផ្នែករូបវិទ្យា	Category:诺贝尔物理学奖获得者
ចំណាត់ថ្នាក់ក្រុម:ជ័យលាភីរង្វាន់ណូបែល ផ្នែកគីមីវិទ្យា	Category:诺贝尔化学奖获得者
ទំព័រគំរូ:Fmbox	Template:Fmbox
ទំព័រគំរូ:Navbox with collapsible groups	Template:Navbox with collapsible groups
ទំព័រគំរូ:GeoGroup	Template:GeoGroup
ទំព័រគំរូ:ទិន្នន័យប្រទេស ចិន	Template:Country data China
ទំព័រគំរូ:Wikify	Template:Wikify
ទំព័រគំរូ:ទិន្នន័យ នៃ ប្រទេស អង់គ្លេស	Template:Country data England
ទំព័រគំរូ:ទិន្នន័យ នៃប្រទេសអៀរឡង់	Template:Country data Republic of Ireland
ទំព័រគំរូ:ទិន្នន័យ នៃប្រទេសទួរគី	Template:Country data Turkey
ទំព័រគំរូ:ទិន្នន័យ នៃប្រទេសស្វីស	Template:Country data Switzerland
ទំព័រគំរូ:ទិន្នន័យ នៃប្រទេសហ្វីលីពីន	Template:Country data Philippines
ទំព័រគំរូ:Hidden begin	Template:Hidden begin
ទំព័រគំរូ:ParmPart	Template:ParmPart
ទំព័រគំរូ:Army	Template:Army
ទំព័រគំរូ:ទិន្នន័យ នៃប្រទេសម៉ាឡេស៊ី	Template:Country data Malaysia
ទំព័រគំរូ:ទិន្នន័យប្រទេស អាមេនី	Template:Country data Armenia
ទំព័រគំរូ:Infobox OS	Template:Infobox OS
ទំព័រគំរូ:ទិន្នន័យ នៃប្រទេសតៃវ៉ាន់	Template:Country data Taiwan
ទំព័រគំរូ:ទិន្នន័យប្រទេស វៀតណាមខាងត្បូង	Template:Country data South Vietnam
ទំព័រគំរូ:ទិន្នន័យ នៃប្រទេសភូមា	Template:Country data Myanmar
ទំព័រគំរូ:ទិន្នន័យ នៃប្រទេសឈីលី	Template:Country data Chile
ទំព័រគំរូ:The Original Barnstar	Template:原星章
ទំព័រគំរូ:ទិន្នន័យប្រទេស លីបង់	Template:Country data Lebanon
ទំព័រគំរូ:ទិន្នន័យប្រទេស ចិនតៃប៉ិ	Template:Country data Chinese Taipei
ទំព័រគំរូ:ប្រអប់ព័ត៌មាន សៀវភៅ	Template:Infobox Book
ទំព័រគំរូ:Tlc	Template:Tlc
ទំព័រគំរូ:ប្រអប់ព័ត៌មាន ភព	Template:Infobox Planet
ទំព័រគំរូ:Compact periodic table	Template:元素週期表
ទំព័រគំរូ:Lang-fa	Template:Lang-fa
ទំព័រគំរូ:ICD10	Template:ICD10
ទំព័រគំរូ:ទិន្នន័យ​នៃប្រទេសម៉ាឡេស៊ី	Template:MYS
ទំព័រគំរូ:Infobox website	Template:Infobox Website
ទំព័រគំរូ:Globalize	Template:Globalize
ទំព័រគំរូ:Image label end	Template:Image label end
ទំព័រគំរូ:Navboxes	Template:Navboxes
ទំព័រគំរូ:Documentation subpage	Template:Documentation subpage
ទំព័រគំរូ:Uncategorized	Template:Uncategorized
ទំព័រគំរូ:ទិន្នន័យ​នៃប្រទេសឥណ្ឌូនេស៊ី	Template:IDN
ទំព័រគំរូ:Talk header for guidelines	Template:Talkheader
ទំព័រគំរូ:Quote box	Template:Quote box
ទំព័រគំរូ:Navbox years	Template:NavboxYears
ទំព័រគំរូ:CcTLD	Template:CcTLD
ទំព័រគំរូ:Cc-by-2.0	Template:CC-BY-2.0
ទំព័រគំរូ:Lang-my-fonts	Template:Lang-my-Mymr
ទំព័រគំរូ:Oldid	Template:Oldid
ទំព័រគំរូ:Rtl-lang	Template:Rtl-lang
ទំព័រគំរូ:List of Asian capitals by region	Template:亞洲首都
ទំព័រគំរូ:ប្រអប់ព័ត៌មានទីកន្លែងកេរដំណែលពិភពលោក	Template:世界遗产概要表
ទំព័រគំរូ:Str len	Template:Str len
ទំព័រគំរូ:Purge	Template:Purge
ទំព័រគំរូ:Lang-de	Template:Lang-de
ទំព័រគំរូ:Empty category	Template:Empty category
ទំព័រគំរូ:Ifempty	Template:Ifempty
ទំព័រគំរូ:Pre2	Template:Pre2
ទំព័រគំរូ:Lang-la	Template:Lang-la
ទំព័រគំរូ:ប្រអប់ព័ត៌មាន អាគារ	Template:Infobox building
ទំព័រគំរូ:'	Template:'
ទំព័រគំរូ:Location map USA	Template:Location map USA
ទំព័រគំរូ:Lang-el	Template:Lang-el
ទំព័រគំរូ:Chessgames player	Template:Chessgames player
ទំព័រគំរូ:ទិន្នន័យ​នៃប្រទេសអារ៉ាប៊ីសាអូឌីត	Template:KSA
ទំព័រគំរូ:User page	Template:Userpage
ទំព័រគំរូ:DE	Template:DEU
ទំព័រគំរូ:Lang-my	Template:Lang-my
ទំព័រគំរូ:Stack	Template:Imagestack
ទំព័រគំរូ:ប្រអប់ព័ត៌មាន ព្រះវិហារគ្រិស្ដសាសនា	Template:Infobox church
ទំព័រគំរូ:Infobox Christian leader	Template:Infobox Christian leader
ទំព័រគំរូ:User	Template:User
ទំព័រគំរូ:Spoken Wikipedia	Template:Spoken Wikipedia
ទំព័រគំរូ:University-stub	Template:Elem-stub
ទំព័រគំរូ:វិគីភីឌាភាសា	Template:Wikipedia editions
ទំព័រគំរូ:Clarify	Template:Clarify
ទំព័រគំរូ:Refimprove	Template:Unreferenced
ទំព័រគំរូ:Lorem ipsum	Template:Lorem ipsum original
ទំព័រគំរូ:ស្នើសុំប្ដូរឈ្មោះ	Template:Usurp
ទំព័រគំរូ:CIA World Factbook link	Template:CIA World Factbook link
ទំព័រគំរូ:Image label small	Template:Image label small
ទំព័រគំរូ:Nihongo	Template:Nihongo
ទំព័រគំរូ:User fr-3	Template:User fr-3
ទំព័រគំរូ:PD-because	Template:PD-because
ទំព័រគំរូ:Th icon	Template:Th icon
ទំព័រគំរូ:Cc-by	Template:CC-BY-1.0
ទំព័រគំរូ:Failed verification	Template:Failed verification
ទំព័រគំរូ:Tag	Template:Tag
ទំព័រគំរូ:Sec link auto	Template:Sec link auto
ទំព័រគំរូ:Pp-meta	Template:Pp-meta
ទំព័រគំរូ:Notelist	Template:Notelist
ទំព័រគំរូ:S-ttl	Template:S-title
ទំព័រគំរូ:Infobox former country	Template:Infobox Former Country
ទំព័រគំរូ:IPA-en	Template:IPA-en
ទំព័រគំរូ:JPN	Template:JPN
ទំព័រគំរូ:ភូមិភាគទាំង៩របស់ជប៉ុន	Template:日本一级行政区
ទំព័រគំរូ:Merge from	Template:Mergefrom
ទំព័រគំរូ:Cmbox	Template:Cmbox
ទំព័រគំរូ:ASIN	Template:ASIN
ជំនួយ:តារាង	Help:表格
ទំព័រគំរូ:Precision	Template:Precision
ទំព័រគំរូ:User wikipedia/Checkuser	Template:User wikipedia/Checkuser
ទំព័រគំរូ:ទិន្នន័យ​នៃប្រទេសប៉ាគីស្ថាន	Template:PAK
ទំព័រគំរូ:Age in days nts	Template:Age in days
ទំព័រគំរូ:S-bef	Template:S-before
ទំព័រគំរូ:Nations at the 2008 Summer Olympics	Template:NOCin2008SummerOlympics
ទំព័រគំរូ:Guideline	Template:Guideline
ទំព័រគំរូ:JULIANDAY	Template:JULIANDAY
ទំព័រគំរូ:Xpd3	Template:Xpd3
ទំព័រគំរូ:Mbox	Template:Mbox
ទំព័រគំរូ:Disagree	Template:Oppose
ទំព័រគំរូ:DNB portal	Template:DNB-Portal
ទំព័រគំរូ:Talkarchive	Template:Talkarchive
ទំព័រគំរូ:Lt	Template:Lt icon
ទំព័រគំរូ:Pagetype	Template:Pagetype
ទំព័រគំរូ:ទិន្នន័យ​នៃប្រទេសអ៊ីរ៉ង់	Template:IRN
ទំព័រគំរូ:ទិន្នន័យ​នៃប្រទេសហ្សកដង់	Template:JOR
ទំព័រគំរូ:Bibleverse	Template:Bibleverse
ទំព័រគំរូ:Infobox historical event	Template:Infobox historical event
ទំព័រគំរូ:ទិន្នន័យ​នៃប្រទេសហុងកុង	Template:HKG
ទំព័រគំរូ:ទិន្នន័យ​នៃប្រទេសកូរ៉េខាងជើង	Template:PRK
ទំព័រគំរូ:Infobox continent	Template:Infobox Continent
ទំព័រគំរូ:Date	Template:Date
ទំព័រគំរូ:BHU	Template:BTN
ទំព័រគំរូ:ទិន្នន័យ​នៃប្រទេសសិង្ហបុរី	Template:SGP
ទំព័រគំរូ:ទិន្នន័យ​នៃប្រទេសឥណ្ឌា	Template:IND
ទំព័រគំរូ:ទិន្នន័យ​នៃប្រទេសម៉ាកាវ	Template:MAC
ទំព័រគំរូ:សបា្ដហ៍	Template:星期中的日子
ទំព័រគំរូ:To do	Template:To do
ទំព័រគំរូ:CURRENTJULIANDAY	Template:CURRENTJULIANDAY
ទំព័រគំរូ:Nobold	Template:Nobold
ចំណាត់ថ្នាក់ក្រុម:User ja-N	Category:Ja 母语使用者
ទំព័រគំរូ:Largest cities	Template:Largest cities
ទំព័រគំរូ:PDFlink	Template:PDFlink
ទំព័រគំរូ:Ca icon	Template:Ca icon
ទំព័រគំរូ:ទិន្នន័យ នៃប្រទេសអាល្លឺម៉ងខាងកើត	Template:Country data West Germany
ទំព័រគំរូ:Region history	Template:Region history
ទំព័រគំរូ:Lang-ru	Template:Lang-ru
វិគីភីឌា:Welcoming committee	Wikipedia:小天使工作小組
ទំព័រគំរូ:Br separated entries	Template:Br separated entries
ទំព័រគំរូ:Infobox saint	Template:Infobox Saint
ទំព័រគំរូ:URL	Template:URL
ទំព័រគំរូ:Hidden end	Template:Hidden end
ទំព័រគំរូ:ណែនាំ	Template:Disambig
ទំព័រគំរូ:Tlsp	Template:Tlsp
ទំព័រគំរូ:ទិន្នន័យ នៃប្រទេសហុងកុង	Template:Country data Hong Kong
ទំព័រគំរូ:DEFAULTSORT	Template:DEFAULTSORT
ទំព័រគំរូ:Copy to Wiktionary	Template:移动到维基词典
ទំព័រគំរូ:No	Template:未完成
ទំព័រគំរូ:Tick	Template:Tick
ចំណាត់ថ្នាក់ក្រុម:ទំព័រគំរូ ប្រអប់ព័ត៌មាន	Category:信息框模板
ចំណាត់ថ្នាក់ក្រុម:Lists of flags	Category:旗幟列表
ទំព័រគំរូ:ទិន្នន័យប្រទេស Nazi Germany	Template:Country data Nazi Germany
ទំព័រគំរូ:Select skin	Template:Select skin
ទំព័រគំរូ:Plainlist	Template:Plainlist
ចំណាត់ថ្នាក់ក្រុម:ហិរញ្ញវត្ថុសាធារណៈ	Category:財政
ទំព័រគំរូ:Divbox	Template:Divbox
ចំណាត់ថ្នាក់ក្រុម:អ្នកថតរូប	Category:摄影
ទំព័រគំរូ:Para	Template:Para
ទំព័រគំរូ:Partial	Template:Partial
ចំណាត់ថ្នាក់ក្រុម:យន្តហោះយោធា	Category:军用飞机
ទំព័រគំរូ:Legend inline	Template:Legend inline
ទំព័រគំរូ:Death year and age	Template:Death year and age
ទំព័រគំរូ:LAO	Template:LAO
ទំព័រគំរូ:User zh-min-nan	Template:User nan
ទំព័រគំរូ:User zh-min-nan-1	Template:User nan-1
ទំព័រគំរូ:GRC	Template:GRC
ទំព័រគំរូ:PRT	Template:PRT
ទំព័រគំរូ:ទិន្នន័យ​នៃប្រទេសបង់ក្លាដែស្ស	Template:BGD
ទំព័រគំរូ:States of Austria	Template:Austrian States
ទំព័រគំរូ:Order of magnitude	Template:Order of magnitude
ទំព័រគំរូ:Category see also	Template:Category see also
ទំព័រគំរូ:Tlf	Template:Tlf
ទំព័រគំរូ:For	Template:For
ទំព័រគំរូ:Ifsubst	Template:Ifsubst
ទំព័រគំរូ:X mark-n	Template:X mark-n
ទំព័រគំរូ:Check mark-n	Template:Check mark-n
ទំព័រគំរូ:Sec link image	Template:Sec link image
ទំព័រគំរូ:Lower	Template:Lower
ទំព័រគំរូ:Voidd	Template:Voidd
ទំព័រគំរូ:Flag template documentation	Template:Flag template documentation
ទំព័រគំរូ:Backlog	Template:Backlog
ទំព័រគំរូ:Osmrelation	Template:Osmrelation-inline
ទំព័រគំរូ:Science	Template:Science
ចំណាត់ថ្នាក់ក្រុម:អង្គការមិនរកប្រាក់កំរៃ	Category:非营利组织
ទំព័រគំរូ:High-risk	Template:High-risk
ទំព័រគំរូ:Lang-uk	Template:Lang-uk
ទំព័រគំរូ:KHM	Template:KHM
ទំព័រគំរូ:ប្រអប់ព័ត៌មាន អង្គការ	Template:Infobox Organization
ទំព័រគំរូ:MNE	Template:MNE
ទំព័រគំរូ:Category TOC	Template:CategoryTOC
ទំព័រគំរូ:Resize	Template:Resize
ទំព័រគំរូ:IPA-fr	Template:IPA-fr
ទំព័រគំរូ:Fix	Template:Fix
ទំព័រគំរូ:Lang-nl	Template:Lang-nl
ទំព័រគំរូ:ទិន្នន័យ​នៃប្រទេសមីយ៉ាន់ម៉ា	Template:MMR
ទំព័រគំរូ:Lang-id	Template:Lang-id
ទំព័រគំរូ:GSE	Template:GSEn
ទំព័រគំរូ:ទិន្នន័យ​នៃប្រទេសកូរ៉េខាងត្បូង	Template:KOR
ទំព័រគំរូ:Tn	Template:Tn
ចំណាត់ថ្នាក់ក្រុម:User gsw-1	Category:Gsw-1 使用者
ទំព័រគំរូ:ទិន្នន័យប្រទេស កាតារ	Template:Country data Qatar
ទំព័រគំរូ:User it-2	Template:User it-2
ទំព័រគំរូ:Val	Template:Val
ទំព័រគំរូ:Lang-fr	Template:Lang-fr
ទំព័រគំរូ:មេកានិចក្លាស់សិច	Template:經典力學
ទំព័រគំរូ:Superimpose	Template:Superimpose
ទំព័រគំរូ:FRA	Template:FRA
ទំព័រគំរូ:Age	Template:Age
ទំព័រគំរូ:Wrap	Template:Wrap
ទំព័រគំរូ:Hang on	Template:Hangon
ទំព័រគំរូ:Flagicon image	Template:Flagicon image
ទំព័រគំរូ:Pending	Template:Pending
ទំព័រគំរូ:Infobox person	Template:Infobox person
ទំព័រគំរូ:?	Template:?
ទំព័រគំរូ:Concat	Template:Concat
ទំព័រគំរូ:ទិន្នន័យ នៃប្រទេសអ៊ីស្រាអែល	Template:Country data Israel
ទំព័រគំរូ:ទិន្នន័យ នៃប្រទេសសាធារណរដ្ឋប្រជាមានិតចិន	Template:Country data People's Republic of China
ទំព័រគំរូ:Number table sorting	Template:Nts
ទំព័រគំរូ:List of European capitals by region	Template:歐洲各國及其首都
ទំព័រគំរូ:ទិន្នន័យប្រទេស កូឡុំប៊ី	Template:Country data Colombia
ទំព័រគំរូ:ទិន្នន័យ នៃប្រទេសប៉ាគីស្ថាន	Template:Country data Pakistan
ទំព័រគំរូ:ទិន្នន័យប្រទេស Ghana	Template:Country data Ghana
ទំព័រគំរូ:ទិន្នន័យប្រទេស កូរ៉េខាងត្បូង	Template:Country data South Korea
ទំព័រគំរូ:CIA World Factbook	Template:CIA World Factbook
ចំណាត់ថ្នាក់ក្រុម:ព្រះមហាក្សត្រខ្មែរ	Category:柬埔寨君主
ទំព័រគំរូ:Election table	Template:Electiontable
ទំព័រគំរូ:World Trade Organization	Template:世界貿易組織
ទំព័រគំរូ:Coord	Template:Coord
ទំព័រគំរូ:POV	Template:POV
ទំព័រគំរូ:Citation/make link	Template:Citation/make link
ចំណាត់ថ្នាក់ក្រុម:20th-century births	Category:20世纪出生
ទំព័រគំរូ:Dmoz	Template:Dmoz
ចំណាត់ថ្នាក់ក្រុម:ពហុកោណ	Category:多邊形
ទំព័រគំរូ:Fide	Template:Fide
ទំព័រគំរូ:User lb-1	Template:User lb-1
ទំព័រគំរូ:Dated maintenance category	Template:Dated maintenance category
ទំព័រគំរូ:User fr-4	Template:User fr-4
ទំព័រគំរូ:អាស៊ីហ្គេម	Template:亞洲運動會
ទំព័រគំរូ:User la-1	Template:User la-1
ទំព័រគំរូ:ហិរញ្ញវត្ថុសាធារណៈ	Template:公共财政
ទំព័រគំរូ:ទិន្នន័យប្រទេស បារ៉ែន	Template:Country data Bahrain
ទំព័រគំរូ:ព្រះពុទ្ធសាសនា	Template:佛教
ទំព័រគំរូ:Biology-stub	Template:Biology-stub
ទំព័រគំរូ:អេឡិចត្រូម៉ាញ៉េទិច	Template:电磁学
ចំណាត់ថ្នាក់ក្រុម:ឯកសារអំពី ទំព័រគំរូ	Category:模板說明文件
ចំណាត់ថ្នាក់ក្រុម:អត្ថបទខ្លីមិនពេញលេញ អំពីកម្ពុជា	Category:柬埔寨小作品
ចំណាត់ថ្នាក់ក្រុម:User pdc	Category:Pdc 使用者
ចំណាត់ថ្នាក់ក្រុម:User et	Category:Et 使用者
ចំណាត់ថ្នាក់ក្រុម:User fr	Category:Fr 使用者
ចំណាត់ថ្នាក់ក្រុម:User id	Category:Id 使用者
ចំណាត់ថ្នាក់ក្រុម:User ja	Category:Ja 使用者
ចំណាត់ថ្នាក់ក្រុម:User km	Category:Km 使用者
ចំណាត់ថ្នាក់ក្រុម:User la	Category:La 使用者
ចំណាត់ថ្នាក់ក្រុម:User li	Category:Li 使用者
ចំណាត់ថ្នាក់ក្រុម:User sv	Category:Sv 使用者
ចំណាត់ថ្នាក់ក្រុម:User th	Category:Th 使用者
ចំណាត់ថ្នាក់ក្រុម:User fr-3	Category:Fr-3 使用者
ចំណាត់ថ្នាក់ក្រុម:User it-3	Category:It-3 使用者
ចំណាត់ថ្នាក់ក្រុម:User ja-3	Category:Ja-3 使用者
ចំណាត់ថ្នាក់ក្រុម:User tr-3	Category:Tr-3 使用者
ចំណាត់ថ្នាក់ក្រុម:User pdc-1	Category:Pdc-1 使用者
ចំណាត់ថ្នាក់ក្រុម:User et-1	Category:Et-1 使用者
ចំណាត់ថ្នាក់ក្រុម:User li-1	Category:Li-1 使用者
ចំណាត់ថ្នាក់ក្រុម:User nl-1	Category:Nl-1 使用者
ចំណាត់ថ្នាក់ក្រុម:User tr-1	Category:Tr-1 使用者
ចំណាត់ថ្នាក់ក្រុម:User ko-4	Category:Ko-4 使用者
ចំណាត់ថ្នាក់ក្រុម:User fr-4	Category:Fr-4 使用者
ចំណាត់ថ្នាក់ក្រុម:User it-4	Category:It-4 使用者
ចំណាត់ថ្នាក់ក្រុម:User fr-2	Category:Fr-2 使用者
ចំណាត់ថ្នាក់ក្រុម:User it-2	Category:It-2 使用者
ចំណាត់ថ្នាក់ក្រុម:User ja-2	Category:Ja-2 使用者
ចំណាត់ថ្នាក់ក្រុម:User la-2	Category:La-2 使用者
ចំណាត់ថ្នាក់ក្រុម:User tr-2	Category:Tr-2 使用者
ចំណាត់ថ្នាក់ក្រុម:User fr-N	Category:Fr 母語使用者
ចំណាត់ថ្នាក់ក្រុម:User it-N	Category:It 母語使用者
ចំណាត់ថ្នាក់ក្រុម:User nl-N	Category:Nl 母語使用者
ចំណាត់ថ្នាក់ក្រុម:User ru-N	Category:Ru 母語使用者
ចំណាត់ថ្នាក់ក្រុម:កំសាន្ត	Category:娱乐
ទំព័រគំរូ:Location map Asia2	Template:Location map Asia2
ទំព័រគំរូ:Sister-inline	Template:Sister-inline
ទំព័រគំរូ:User Google	Template:User Google
ចំណាត់ថ្នាក់ក្រុម:Image insertion templates	Category:圖像插入模板
ទំព័រគំរូ:IncreaseNegative	Template:IncreaseNegative
ទំព័រគំរូ:Beta	Template:Beta
ចំណាត់ថ្នាក់ក្រុម:User af	Category:Af 使用者
ចំណាត់ថ្នាក់ក្រុម:User af-1	Category:Af-1 使用者
ចំណាត់ថ្នាក់ក្រុម:User bar	Category:Bar 使用者
ចំណាត់ថ្នាក់ក្រុម:User bar-1	Category:Bar-1 使用者
ចំណាត់ថ្នាក់ក្រុម:កោះ	Category:岛屿
ចំណាត់ថ្នាក់ក្រុម:User de	Category:De 使用者
ទំព័រគំរូ:Calendar	Template:格里曆年曆
ចំណាត់ថ្នាក់ក្រុម:User de-2	Category:De-2 使用者
ចំណាត់ថ្នាក់ក្រុម:User de-3	Category:De-3 使用者
ចំណាត់ថ្នាក់ក្រុម:User de-4	Category:De-4 使用者
ចំណាត់ថ្នាក់ក្រុម:User de-N	Category:De 母語使用者
ចំណាត់ថ្នាក់ក្រុម:User el	Category:El 使用者
ចំណាត់ថ្នាក់ក្រុម:User en-3	Category:En-3 使用者
ចំណាត់ថ្នាក់ក្រុម:User en-N	Category:En 母语使用者
ចំណាត់ថ្នាក់ក្រុម:User es	Category:Es 使用者
ចំណាត់ថ្នាក់ក្រុម:User es-1	Category:Es-1 使用者
ចំណាត់ថ្នាក់ក្រុម:User es-2	Category:Es-2 使用者
ចំណាត់ថ្នាក់ក្រុម:User es-4	Category:Es-4 使用者
ចំណាត់ថ្នាក់ក្រុម:User es-N	Category:Es 母语使用者
ចំណាត់ថ្នាក់ក្រុម:User fi	Category:Fi 使用者
ចំណាត់ថ្នាក់ក្រុម:User fi-N	Category:Fi 母語使用者
ចំណាត់ថ្នាក់ក្រុម:User gsw	Category:Gsw 使用者
ទំព័រគំរូ:N/a	Template:N/A
ចំណាត់ថ្នាក់ក្រុម:User id-1	Category:Id-1 使用者
ចំណាត់ថ្នាក់ក្រុម:User id-2	Category:Id-2 使用者
ចំណាត់ថ្នាក់ក្រុម:User id-3	Category:Id-3 使用者
ទំព័រគំរូ:Beijing	Template:北京行政区划
ទំព័រគំរូ:ទិន្នន័យ នៃប្រទេសអាល្លឺម៉ង់	Template:Country data Germany
ទំព័រគំរូ:Multiple image	Template:并列图像
ទំព័រគំរូ:ទិន្នន័យប្រទេស ចក្រភពអង់គ្លេស	Template:Country data United Kingdom
ចំណាត់ថ្នាក់ក្រុម:ធរណីមាត្រ	Category:几何学
ទំព័រគំរូ:អង្គការសហប្រជាជាតិ	Template:UN
ទំព័រគំរូ:ប្រអប់ព័ត៌មាន រោគ-ជំងឺ	Template:Infobox Disease
ទំព័រគំរូ:User wikipedia/Administrator	Template:User wikipedia/Administrator
ទំព័រគំរូ:Weather box	Template:Infobox weather
វិគីភីឌា:អត្ថបទ​ប្រចាំ​ថ្ងៃ	Wikipedia:特色条目/存档
ចំណាត់ថ្នាក់ក្រុម:User it	Category:It 使用者
ចំណាត់ថ្នាក់ក្រុម:User it-1	Category:It-1 使用者
ចំណាត់ថ្នាក់ក្រុម:User ja-1	Category:Ja-1 使用者
ចំណាត់ថ្នាក់ក្រុម:User km-1	Category:Km-1 使用者
ចំណាត់ថ្នាក់ក្រុម:User km-2	Category:Km-2 使用者
ចំណាត់ថ្នាក់ក្រុម:User km-3	Category:Km-3 使用者
ចំណាត់ថ្នាក់ក្រុម:User km-4	Category:Km-4 使用者
ចំណាត់ថ្នាក់ក្រុម:User ko	Category:Ko 使用者
ចំណាត់ថ្នាក់ក្រុម:User ko-1	Category:Ko-1 使用者
ចំណាត់ថ្នាក់ក្រុម:User ko-2	Category:Ko-2 使用者
ចំណាត់ថ្នាក់ក្រុម:User ko-3	Category:Ko-3 使用者
ចំណាត់ថ្នាក់ក្រុម:User ksh	Category:Ksh 使用者
ចំណាត់ថ្នាក់ក្រុម:User ksh-N	Category:Ksh 母語使用者
ចំណាត់ថ្នាក់ក្រុម:User la-1	Category:La-1 使用者
ចំណាត់ថ្នាក់ក្រុម:User lb	Category:Lb 使用者
ចំណាត់ថ្នាក់ក្រុម:User lb-1	Category:Lb-1 使用者
ទំព័រគំរូ:Multiple issues	Template:问题条目
ទំព័រគំរូ:Economics sidebar	Template:Economics sidebar
ទំព័រគំរូ:Cite doi	Template:Cite doi
ទំព័រគំរូ:ប្រអប់ព័ត៌មាន រូបិយវត្ថុ	Template:Infobox Currency
ទំព័រគំរូ:Sup	Template:Sup
ទំព័រគំរូ:Current U.S. Senators	Template:Current U.S. Senators
ទំព័រគំរូ:Lang-vi	Template:Lang-vi
ទំព័រគំរូ:Translation	Template:Translating
ទំព័រគំរូ:Protection templates	Wikipedia:模板消息/保護模板
ទំព័រគំរូ:Distinguish	Template:Distinguish
ទំព័រគំរូ:Infobox programming language	Template:Infobox programming language
ទំព័រគំរូ:He icon	Template:He icon
បញ្ជីរាយនាម ជ័យលាភីរង្វាន់ណូបែល ផ្នែកអក្សរសាស្ត្រ	諾貝爾文學獎得主列表
វិគីភីឌា:Maintenance	Wikipedia:維基百科維護
ទំព័រគំរូ:Information	Template:Information
ទំព័រគំរូ:Pp-protected	Template:Pp-protected
ទំព័រគំរូ:Comics infobox sec	Template:Comics infobox sec
ចំណាត់ថ្នាក់ក្រុម:អត្ថបទវិគីភីឌាដែលត្រូវការការបកប្រែ	Category:需要翻译的文章
ចំណាត់ថ្នាក់ក្រុម:User ru-1	Category:Ru-1 使用者
ទំព័រគំរូ:TOC limit	Template:TOClimit
វិគីភីឌា:បាបេល	Wikipedia:巴別
ទំព័រគំរូ:Hilite	Template:Hilite
ទំព័រគំរូ:ភាសាជាផ្លូវការប្រើនៅអសប	Template:聯合國官方語言
ទំព័រគំរូ:High-use	Template:High-use
ទំព័រគំរូ:Expand list	Template:Expand list
ទំព័រគំរូ:Crystalball	Template:Crystalball
ទំព័រគំរូ:Tdeprecated	Template:不再使用的模板
ទំព័រគំរូ:Help pages header	Template:维基百科帮助页 (页眉栏)
ទំព័រគំរូ:Infobox particle	Template:Infobox Particle
ចំណាត់ថ្នាក់ក្រុម:1900s births	Category:1900年代出生
ទំព័រគំរូ:Wikipedia how to	Template:Wikipedia how to
ទំព័រគំរូ:UN Security Council	Template:UNSC
ទំព័រគំរូ:Sidebar with collapsible lists	Template:Sidebar with collapsible lists
ទំព័រគំរូ:Talk other	Template:Talk other
ចំណាត់ថ្នាក់ក្រុម:User ms-2	Category:Ms-2 使用者
ទំព័រគំរូ:Redirect2	Template:Redirect2
ចំណាត់ថ្នាក់ក្រុម:សមុទ្រ	Category:海洋
ទំព័រគំរូ:ISO standards	Template:ISO
ទំព័រគំរូ:FishBase genus	Template:FishBase genus
ទំព័រគំរូ:User2	Template:User2
ទំព័រគំរូ:Other people	Template:同名人物
ទំព័រគំរូ:CSS3 multiple column layout	Template:CSS3 multiple column layout
ទំព័រគំរូ:User OS:Microsoft Windows	Template:User windows
ទំព័រគំរូ:IPA-all	Template:IPA-all
ទំព័រគំរូ:Chess diagram 8x10	Template:Chess diagram 8x10
ទំព័រគំរូ:Lang-ko	Template:Lang-ko
ទំព័រគំរូ:Lang-it	Template:Lang-it
ចំណាត់ថ្នាក់ក្រុម:User nds	Category:Nds 使用者
ទំព័រគំរូ:Sect1911	Template:大英百科十一版
ចំណាត់ថ្នាក់ក្រុម:User nds-1	Category:Nds-1 使用者
ទំព័រគំរូ:Coord/dms2dec	Template:Coord/dms2dec
ជំនួយ:Archiving a talk page	Wikipedia:如何將討論頁存檔
ទំព័រគំរូ:ទិន្នន័យ នៃប្រទេសប្រេស៊ីល	Template:Country data Brazil
វិគីភីឌា:WikiProject Computing	Wikipedia:电脑和信息技术专题
ចំណាត់ថ្នាក់ក្រុម:អង្គការអន្តរជាតិ	Category:国际组织
ទំព័រគំរូ:មេកានិចកង់ទិច	Template:量子力學
ទំព័រគំរូ:Sfn	Template:Sfn
ជំនួយ:សៀវភៅ	Help:圖書
ទំព័រគំរូ:Infobox settlement/lengthdisp	Template:Infobox settlement/lengthdisp
ចំណាត់ថ្នាក់ក្រុម:សមីការឌីផេរ៉ង់ស្យែល	Category:微分方程
ទំព័រគំរូ:Lang-lo	Template:Lang-lo
ចំណាត់ថ្នាក់ក្រុម:User zh-min-nan	Category:Nan 使用者
ទំព័រគំរូ:Release date and age	Template:Start date and age
ចំណាត់ថ្នាក់ក្រុម:User zh-min-nan-3	Category:Nan-3 使用者
ទំព័រគំរូ:Ms icon	Template:Ms icon
ចំណាត់ថ្នាក់ក្រុម:ឧទ្ធម្ភាគចក្រ	Category:直升机
ចំណាត់ថ្នាក់ក្រុម:នាយករដ្ឋមន្ត្រី	Category:总理
ចំណាត់ថ្នាក់ក្រុម:វិទ្យាសាស្ត្រសង្គម	Category:社会科学
ឈាន	禅
ទំព័រគំរូ:ទិន្នន័យ នៃប្រទេសហុងគ្រី	Template:Country data Hungary
ទំព័រគំរូ:Non-free game cover	Template:Non-free video game cover
ទំព័រគំរូ:User zh-0	Template:User zh-0
ទំព័រគំរូ:Template reference list	Template:Template reference list
ចំណាត់ថ្នាក់ក្រុម:ឆ្នាំកំណើត ១៩៥១	Category:1951年出生
ទំព័រគំរូ:Zh icon	Template:Zh icon
ទំព័រគំរូ:Advert	Template:Advert
ទំព័រគំរូ:Infobox government agency	Template:Infobox Govt Agency
ទំព័រគំរូ:Babel-N	Template:Babel-N
វិគីភីឌា:Tools	Wikipedia:维基百科工具
ទំព័រគំរូ:User ru-2	Template:User ru-2
ចំណាត់ថ្នាក់ក្រុម:User ru	Category:Ru 使用者
ចំណាត់ថ្នាក់ក្រុម:User ru-2	Category:Ru-2 使用者
ចំណាត់ថ្នាក់ក្រុម:User ru-3	Category:Ru-3 使用者
ចំណាត់ថ្នាក់ក្រុម:វត្តអារាមព្រះពុទ្ធសាសនា	Category:佛寺
ទំព័រគំរូ:S-reg	Template:S-reg
ចំណាត់ថ្នាក់ក្រុម:User sxu	Category:Sxu 使用者
ចំណាត់ថ្នាក់ក្រុម:User sxu-1	Category:Sxu-1 使用者
ទំព័រគំរូ:Apollo program	Template:阿波罗计划
ចំណាត់ថ្នាក់ក្រុម:User th-1	Category:Th-1 使用者
ចំណាត់ថ្នាក់ក្រុម:User th-N	Category:Th 母語使用者
ចំណាត់ថ្នាក់ក្រុម:User tr	Category:Tr 使用者
ចំណាត់ថ្នាក់ក្រុម:User tr-0	Category:Tr-0 使用者
ចំណាត់ថ្នាក់ក្រុម:User tr-4	Category:Tr-4 使用者
ចំណាត់ថ្នាក់ក្រុម:User tr-N	Category:Tr 母語使用者
ចំណាត់ថ្នាក់ក្រុម:User vls	Category:Vls 使用者
ចំណាត់ថ្នាក់ក្រុម:User vls-1	Category:Vls-1 使用者
បញ្ជីរាយនាម នាយករដ្ឋមន្ត្រីកម្ពុជា	柬埔寨政府首脑列表
ទំព័រគំរូ:En icon	Template:En icon
ទំព័រគំរូ:Nay	Template:Nay
ទំព័រគំរូ:Spaces	Template:Spaces
ទំព័រគំរូ:ប្រអប់ភាសា	Template:Lang
ទំព័រគំរូ:FishBase species alt	Template:FishBase species alt
ទំព័រគំរូ:Country flag IOC alias GBR	Template:Country flag IOC alias GBR
ទំព័រគំរូ:ទិន្នន័យប្រទេស Russian SFSR	Template:Country data Russian SFSR
ទំព័រគំរូ:In-universe	Template:In-universe
ជំនួយ:Files	Wikipedia:图像
ទំព័រគំរូ:ទិន្នន័យប្រទេស តួកម៉េនីស្ថាន	Template:Country data Turkmenistan
ទំព័រគំរូ:2008-Olympic-stub	Template:2008-Olympic-stub
ទំព័រគំរូ:Str index	Template:Str index
ទំព័រគំរូ:TakeNote	Template:TakeNote
ទំព័រគំរូ:Self	Template:Self
ទំព័រគំរូ:Age in years, months, weeks and days	Template:Age in years, months, weeks and days
ទំព័រគំរូ:Alabama	Template:Alabama
ទំព័រគំរូ:ខេត្តអានយ៉ាង	Template:安江省行政区划
ទំព័រគំរូ:Angkorian sites	Template:吴哥古迹
ទំព័រគំរូ:Archive list long	Template:Archive list long
ទំព័រគំរូ:Humanities-footer	Template:人类
ទំព័រគំរូ:កាលពី	Template:As of
ទំព័រគំរូ:ប្រធានបទអាស៊ី	Template:亚洲题目
ទំព័រគំរូ:Copyright by Wikimedia	Template:Non-free Wikimedia logo
ទំព័រគំរូ:IPAkeys	Template:IPA Keys
ទំព័រគំរូ:Aye	Template:Aye
ចំណាត់ថ្នាក់ក្រុម:ធរណីមាត្រត្រីកោណ	Category:三角形几何
ទំព័រគំរូ:BDYearsInDecade	Template:BDYearsInDecade
ទំព័រគំរូ:BLP	Template:Blp
ទំព័រគំរូ:BLACK	Template:BLACK
ទំព័រគំរូ:Bar percent	Template:Bar percent
ទំព័រគំរូ:Begin flag gallery	Template:Begin flag gallery
ទំព័រគំរូ:Str find	Template:Str find
ទំព័រគំរូ:CENTURY	Template:CENTURY
ចំណាត់ថ្នាក់ក្រុម:គ្រឹះស្ថានឧត្តមសិក្សាសាធារណៈនៅប្រទេសជប៉ុន	Category:日本的國立大學
ទំព័រគំរូ:CURRENTISOYEAR	Template:CURRENTISOYEAR
ទំព័រគំរូ:Fr icon	Template:Fr icon
ទំព័រគំរូ:Twitter	Template:Twitter
ទំព័រគំរូ:Ko icon	Template:Ko icon
ទំព័រគំរូ:សារ ទំព័រគំរូ វិគីភីឌា	Template:維基百科模板訊息
ទំព័រគំរូ:Lang-hi	Template:Lang-hi
ទំព័រគំរូ:Chembox header	Template:Chembox header
ទំព័រគំរូ:Convert/-/AoffSoff	Template:Convert/-/AoffSoff
ទំព័រគំរូ:Convert/And0	Template:Convert/And0
ទំព័រគំរូ:Convert/LoutAonDbSoff	Template:Convert/LoutAonDbSoff
ទំព័រគំរូ:Convert/mm2	Template:Convert/mm2
ទំព័រគំរូ:Convert/sqin	Template:Convert/sqin
ទំព័រគំរូ:Convert/sqnmi	Template:Convert/sqnmi
ទំព័រគំរូ:Convert/sqyd	Template:Convert/sqyd
ទំព័រគំរូ:Convert/tsubo	Template:Convert/tsubo
ទំព័រគំរូ:Convert/x/AoffSoff	Template:Convert/x/AoffSoff
ទំព័រគំរូ:Convert/±/AoffSoff	Template:Convert/±/AoffSoff
ទំព័រគំរូ:Coord/dec2dms/dm	Template:Coord/dec2dms/dm
ចំណាត់ថ្នាក់ក្រុម:Image with comment templates	Category:訊息圖示模板
ទំព័រគំរូ:Country flag IOC alias ZZX	Template:Country data ZZX
ទំព័រគំរូ:EST	Template:EST
ទំព័រគំរូ:Elementbox isotopes stable	Template:Infobox element/isotopes stable
ទំព័រគំរូ:Football squad end	Template:Football squad end
ទំព័រគំរូ:IUCNlink	Template:IUCNlink
ទំព័រគំរូ:IAFD name	Template:Iafd name
ទំព័រគំរូ:Weather box/cold	Template:Infobox weather/cold
ទំព័រគំរូ:Event	Template:Event
ទំព័រគំរូ:ទិន្នន័យ​នៃប្រទេសរុស្ស៊ី	Template:RUS
ទំព័រគំរូ:Importance/colour	Template:Importance-col
ទំព័រគំរូ:Fossil range/marker	Template:Fossil range/marker
ទំព័រគំរូ:Compu-domain-stub	Template:Compu-domain-stub
ទំព័រគំរូ:ICD9	Template:ICD9
ទំព័រគំរូ:ប្រវត្តិសាស្ត្របារាំង	Template:法國歷史
ទំព័រគំរូ:MONTH	Template:MONTH
ទំព័រគំរូ:CHL	Template:CHL
ទំព័រគំរូ:ASEAN	Template:东南亚国家联盟
ទំព័រគំរូ:User information templates	Template:User information templates
ទំព័រគំរូ:Campaign	Template:Campaign
ទំព័រគំរូ:Category handler/blacklist	Template:Category handler/blacklist
ទំព័រគំរូ:Category handler/numbered	Template:Category handler/numbered
ទំព័រគំរូ:Cc-by-sa-3.0,2.5,2.0,1.0	Template:CC-BY-SA-3.0,2.5,2.0,1.0
ទំព័រគំរូ:Centralized discussion	Template:Bulletin
ទំព័រគំរូ:Central banks	Template:Central banks
ទំព័រគំរូ:ទិន្នន័យ​នៃប្រទេសស៊ីរី	Template:SYR
ទំព័រគំរូ:Check date	Template:Checkdate
ទំព័រគំរូ:Check talk	Template:Check talk
ទំព័រគំរូ:Check mark templates	Template:Check mark templates
ទំព័រគំរូ:Toolbar	Template:Toolbar
ទំព័រគំរូ:Yesno	Template:Yesno
ទំព័រគំរូ:For2	Template:For2
ទំព័រគំរូ:China-bio-stub	Template:中國人物小作品
ទំព័រគំរូ:Side box	Template:Side box
ទំព័រគំរូ:ENG	Template:ENG
ទំព័រគំរូ:Ffd	Template:Ifd
ទំព័រគំរូ:Tfd	Template:Tfd
ទំព័រគំរូ:Copy to Wikibooks	Template:移动到维基教科书
ទំព័រគំរូ:Citation	Template:Citation
ទំព័រគំរូ:Citation/core	Template:Citation/core
ទំព័រគំរូ:Cat improve	Template:Catimprove
ទំព័រគំរូ:Expert-subject	Template:需要专家关注
ចំណាត់ថ្នាក់ក្រុម:ប្រទេសជាកោះ	Category:岛国
ទំព័រគំរូ:ប្រអប់ព័ត៌មាន ភាសា/family-color	Template:Infobox Language/family-color
ទំព័រគំរូ:Wontfix	Template:Won't fix
ចំណាត់ថ្នាក់ក្រុម:Tracking categories	Category:追蹤分類
ទំព័រគំរូ:Grey	Template:灰
ទំព័រគំរូ:User la-2	Template:User la-2
ទំព័រគំរូ:User ru-1	Template:User ru-1
ចំណាត់ថ្នាក់ក្រុម:អាំងតេក្រាល	Category:积分表
ទំព័រគំរូ:User tr-1	Template:User tr-1
ទំព័រគំរូ:User zh-1	Template:User zh-1
ទំព័រគំរូ:User zh-2	Template:User zh-2
ទំព័រគំរូ:User zh-3	Template:User zh-3
ចំណាត់ថ្នាក់ក្រុម:រូបវិទូ	Category:各國物理學家
ទំព័រគំរូ:User zh-4	Template:User zh-4
ចំណាត់ថ្នាក់ក្រុម:គមនាគមន៍នៅប្រទេសជប៉ុន	Category:日本交通
ចំណាត់ថ្នាក់ក្រុម:ប្រទេសហ្សំប៊ី	Category:赞比亚
ទំព័រគំរូ:ទិន្នន័យប្រទេស យូហ៊្គោស្លាវី	Template:Country data SFR Yugoslavia
ទំព័រគំរូ:Calm talk	Template:Calm talk
ទំព័រគំរូ:Multi-listen end	Template:Multi-listen end
ចំណាត់ថ្នាក់ក្រុម:ការអប់រំនៅប្រទេសជប៉ុន	Category:日本教育
ចំណាត់ថ្នាក់ក្រុម:Disambiguation and redirection templates	Category:消歧義模板
ការពិភាក្សារបស់អ្នកប្រើប្រាស់:វ័ណថារិទ្ធ/រូបភាពប្រចាំថ្ងៃ	Wikipedia:每日图片
ទំព័រគំរូ:Tlrow	Template:Tlrow
ចំណាត់ថ្នាក់ក្រុម:User ja-0	Category:Ja-0 使用者
ចំណាត់ថ្នាក់ក្រុម:User nl	Category:Nl 使用者
ទំព័រគំរូ:Unbulleted list	Template:Unbulleted list
ចំណាត់ថ្នាក់ក្រុម:User zh-1	Category:Zh-1 使用者
ចំណាត់ថ្នាក់ក្រុម:User zh-4	Category:Zh-4 使用者
ចំណាត់ថ្នាក់ក្រុម:User zh-3	Category:Zh-3 使用者
ចំណាត់ថ្នាក់ក្រុម:User zh-2	Category:Zh-2 使用者
ចំណាត់ថ្នាក់ក្រុម:មេកានិច	Category:力學
ចំណាត់ថ្នាក់ក្រុម:រូបវិទូអាល្លឺម៉ង់	Category:德国物理学家
ចំណាត់ថ្នាក់ក្រុម:រូបវិទូអ៊ីតាលី	Category:意大利物理学家
ចំណាត់ថ្នាក់ក្រុម:រូបវិទូបារាំង	Category:法國物理學家
ចំណាត់ថ្នាក់ក្រុម:សេវាសាធារណៈ	Category:公共服務
ចំណាត់ថ្នាក់ក្រុម:អិចស្ប៉ូណង់ស្យែល	Category:指数
ទំព័រគំរូ:Tnavbar-header	Template:Tnavbar-header
ចំណាត់ថ្នាក់ក្រុម:ព្រឹត្តិការណ៍កីឡាចំរុះ	Category:运动会
ចំណាត់ថ្នាក់ក្រុម:គណិតវិទូអាល្លឺម៉ង់	Category:德国数学家
ទំព័រគំរូ:User wikipedia/autopatrolled	Template:User wikipedia/Autoreviewer
ទំព័រគំរូ:ទិន្នន័យប្រទេស វៀតណាមខាងជើង	Template:Country data North Vietnam
ចំណាត់ថ្នាក់ក្រុម:ចំនួនគត់រឺឡាទីប	Category:整数
ទំព័រគំរូ:V	Template:V
ចំណាត់ថ្នាក់ក្រុម:ស៊ីហ្គេម	Category:东南亚运动会
ចំណាត់ថ្នាក់ក្រុម:ត្រីកោណមាត្រ	Category:三角学
ចំណាត់ថ្នាក់ក្រុម:ទ្រឹស្តីបទ	Category:定理
ចំណាត់ថ្នាក់ក្រុម:ទ្រឹស្តីបទគណិតវិទ្យា	Category:数学定理
ចំណាត់ថ្នាក់ក្រុម:អាកាសយានដ្ឋាន	Category:機場
ចំណាត់ថ្នាក់ក្រុម:រូបវិទូអាមេរិក	Category:美国物理学家
ចំណាត់ថ្នាក់ក្រុម:រូបវិទូអង់គ្លេស	Category:英格蘭物理學家
ចំណាត់ថ្នាក់ក្រុម:នាយករដ្ឋមន្ត្រីសិង្ហបុរី	Category:新加坡總理
ចំណាត់ថ្នាក់ក្រុម:រង្វាន់ណូបែល	Category:诺贝尔奖
ទំព័រគំរូ:User pfl-1	Template:User pfl-1
ចំណាត់ថ្នាក់ក្រុម:Wikipedia shortcut box first parameter needs fixing	Category:需要修正維基百科捷徑框參數的頁面
ចំណាត់ថ្នាក់ក្រុម:ប្រទេសកម្ពុជា	Category:柬埔寨
ចំណាត់ថ្នាក់ក្រុម:អ្នកនយោបាយប៉ាគីស្ថាន	Category:巴基斯坦政治人物
ទំព័រគំរូ:Lang-hy	Template:Lang-hy
ចំណាត់ថ្នាក់ក្រុម:អ្នកនយោបាយខ្មែរ	Category:柬埔寨政治人物
ចំណាត់ថ្នាក់ក្រុម:អ្នករុករកជនជាតិបារាំង	Category:法国探险家
ចំណាត់ថ្នាក់ក្រុម:ស្រីលង្កា	Category:斯里蘭卡
ចំណាត់ថ្នាក់ក្រុម:ទំព័រគំរូ រង្វាន់ណូបែល	Category:诺贝尔奖模板
ចំណាត់ថ្នាក់ក្រុម:ទំព័រគំរូឈ្មោះភាសា	Category:多语言支援模板
ចំណាត់ថ្នាក់ក្រុម:ទំព័រគំរូក្នុងរូបវិទ្យា	Category:物理学模板
ទំព័រគំរូ:ISO 639 name	Template:ISO 639 name
ទំព័រគំរូ:FeaturedPicture	Template:Featured picture
ទំព័រគំរូ:Ed	Template:Ed
ទំព័រគំរូ:ទិន្នន័យប្រទេស Wales	Template:Country data Wales
ចំណាត់ថ្នាក់ក្រុម:អុនសេន	Category:溫泉
ចំណាត់ថ្នាក់ក្រុម:ពហុធា	Category:多項式
ចំណាត់ថ្នាក់ក្រុម:ពិជគណិតថ្នាក់ដំបូង	Category:初等代数
ចំណាត់ថ្នាក់ក្រុម:អនុគមន៍	Category:函数
ចំណាត់ថ្នាក់ក្រុម:ភាសាជប៉ុន	Category:日语
ចំណាត់ថ្នាក់ក្រុម:មធ្យម	Category:平均数
ចំណាត់ថ្នាក់ក្រុម:ចតុកោណ	Category:四邊形
ចំណាត់ថ្នាក់ក្រុម:ត្រីកោណ	Category:三角形
ចំណាត់ថ្នាក់ក្រុម:សំភារៈ​សំណង់	Category:建筑材料
ទំព័រគំរូ:S-off	Template:S-off
ចំណាត់ថ្នាក់ក្រុម:សមីការ	Category:方程
ចំណាត់ថ្នាក់ក្រុម:ស្ពាននៅប្រទេសជប៉ុន	Category:日本橋樑
ចំណាត់ថ្នាក់ក្រុម:សិទ្ធិ	Category:權利
ចំណាត់ថ្នាក់ក្រុម:User pfl-1	Category:Pfl-1 使用者
ទំព័រគំរូ:Hexadecimal	Template:Hexadecimal
ទំព័រគំរូ:Raise	Template:Raise
ទំព័រគំរូ:S-end	Template:Rail end
ចំណាត់ថ្នាក់ក្រុម:វិភាគគណិតវិទ្យា	Category:数学分析
ទំព័រគំរូ:Stub documentation	Template:Stub documentation
ចំណាត់ថ្នាក់ក្រុម:វិសមភាព	Category:不等式
ចំណាត់ថ្នាក់ក្រុម:ឧទ្យានជាតិ	Category:國家公園
ចំណាត់ថ្នាក់ក្រុម:កោះស៊ូម៉ាត្រា	Category:蘇門答臘
ចំណាត់ថ្នាក់ក្រុម:មីក្រូសេដ្ឋកិច្ច	Category:微观经济学
ចំណាត់ថ្នាក់ក្រុម:HTML	Category:HTML
ចំណាត់ថ្នាក់ក្រុម:អាស៊ីហ្គេម	Category:亚洲运动会
ចំណាត់ថ្នាក់ក្រុម:អេឡិចត្រូស្តាទិច	Category:静电学
ចំណាត់ថ្នាក់ក្រុម:អ៊ីសាក់ ញូតុន	Category:艾萨克·牛顿
ចំណាត់ថ្នាក់ក្រុម:អាកាសចរណ៍	Category:交通
ចំណាត់ថ្នាក់ក្រុម:គណិតវិទ្យាថ្នាក់ដំបូង	Category:初等数学
ចំណាត់ថ្នាក់ក្រុម:ទ្រឹស្តីបទលេខ	Category:数论
ទំព័រគំរូ:ប្រអប់ព័ត៌មាន ភាសា	Template:Infobox Language
ទំព័រគំរូ:អត្ថបទខ្លី អំពីកូរ៉េខាងត្បូង	Template:South Korea-stub
ទំព័រគំរូ:Wikiversity	Template:Wikiversity
ទំព័រគំរូ:Statistics	Template:統計學
ចំណាត់ថ្នាក់ក្រុម:ភាសាអ៊ីតាលី	Category:意大利语
ចំណាត់ថ្នាក់ក្រុម:ភាសាអេស្ប៉ាញ	Category:西班牙语
ចំណាត់ថ្នាក់ក្រុម:រថក្រោះ	Category:坦克
ទំព័រគំរូ:Usbktop	Template:Usbktop
ទំព័រគំរូ:Usbk	Template:Usbk
ទំព័រគំរូ:Lists by country	Template:各国列表
ទំព័រគំរូ:Infobox polygon	Template:Infobox polygon
ចំណាត់ថ្នាក់ក្រុម:កោះរបស់ឥណ្ឌូនេស៊ី	Category:印尼岛屿
ទំព័រគំរូ:Update after	Template:Update after
ទំព័រគំរូ:WPBannerMeta	Template:WPBannerMeta
ទំព័រគំរូ:Cross	Template:Cross
ខេត្តលង់ហោរ	永隆省
ទំព័រគំរូ:Navbox hatnote templates	Template:Hatnote templates
ចំណាត់ថ្នាក់ក្រុម:ភ្នំពេញ	Category:金邊
ទំព័រគំរូ:CountryAbbr	Template:CountryAbbr
ទំព័រគំរូ:Split	Template:Split
ទំព័រគំរូ:រូបវិទ្យា	Template:Physics-footer
ចំណាត់ថ្នាក់ក្រុម:ធរណីមាត្រអ៊ីពែបូលីក	Category:雙曲幾何
វិគីភីឌា:ឯកសារកម្មទំព័រគំរូ	Wikipedia:模板文件頁模式
ទំព័រគំរូ:CompactTOC8	Template:CompactTOC
ទំព័រគំរូ:Template sandbox notice	Template:Template sandbox notice
ទំព័រគំរូ:Dmbox	Template:Dmbox
ទំព័រគំរូ:Hydrogen compounds	Template:氢化合物
ទំព័រគំរូ:Tnavbar-navframe	Template:Tnavbar-navframe
ទំព័រគំរូ:Image frame	Template:Image frame
ទំព័រគំរូ:Ti	Template:Ti
ទំព័រគំរូ:Latin Union	Template:拉丁语联盟
ទំព័រគំរូ:Information page	Template:Infopage
ទំព័រគំរូ:Sec link	Template:Sec link
តូក្យូ	东京
ចំណាត់ថ្នាក់ក្រុម:ម៉ាញ៉េតូស្តាទិច	Category:靜磁學
ចំណាត់ថ្នាក់ក្រុម:ក្រលាផ្ទៃ	Category:面积
ទំព័រគំរូ:Pp-move	Template:Pp-move
ទំព័រគំរូ:WPFCevent	Template:WPFCevent
ទំព័រគំរូ:Infobox broadcasting network	Template:電視網資訊
ចំណាត់ថ្នាក់ក្រុម:លោការីត	Category:对数
ទំព័រគំរូ:JD	Template:JD
ទំព័រគំរូ:CURRENTMINUTE	Template:CURRENTMINUTE
ទំព័រគំរូ:Substituted	Template:Substituted
ទំព័រគំរូ:ទិន្នន័យ​នៃប្រទេសអ៊ូបេគីស្ថាន	Template:UZB
ទំព័រគំរូ:OnHold	Template:OnHold
ទំព័រគំរូ:Question	Template:疑問
បញ្ជីរាយនាម ជ័យលាភីរង្វាន់ណូបែល ផ្នែកគីមីវិទ្យា	诺贝尔化学奖得主列表
ទំព័រគំរូ:ខេត្ត-រាជធានីកម្ពុជា	Template:Cambodia
ទំព័រគំរូ:ទិន្នន័យ នៃប្រទេសអេស្ប៉ាញ	Template:Country data Spain
ទំព័រគំរូ:Usage of IPA templates	Template:Usage of IPA templates
ទំព័រគំរូ:Pad	Template:Pad
ទំព័រគំរូ:If pagename	Template:If pagename
ទំព័រគំរូ:ទិន្នន័យប្រទេស កាណាដា	Template:Country data Canada
ទំព័រគំរូ:Class	Template:Class
ទំព័រគំរូ:Class mask	Template:Class mask
ទំព័រគំរូ:Collapsible sections option	Template:Collapsible sections option
ទំព័រគំរូ:Column-rule	Template:Column-rule
ទំព័រគំរូ:Connected contributor	Template:Notable Wikipedian
ទំព័រគំរូ:Consensus	Template:Consensus
ទំព័រគំរូ:Conservation status	Template:保护现状
ទំព័រគំរូ:Convert/BTU	Template:Convert/BTU
ទំព័រគំរូ:Convert/C-change	Template:Convert/C-change
ទំព័រគំរូ:Convert/Dual/LoffAoffDxSoffT	Template:Convert/Dual/LoffAoffDxSoffT
ទំព័រគំរូ:Convert/LoffAoffDorSoff	Template:Convert/LoffAoffDorSoff
ទំព័រគំរូ:Convert/list of units	Template:Convert/list of units
ទំព័រគំរូ:Convert/list of units/item2	Template:Convert/list of units/item2
ទំព័រគំរូ:Convert/list of units/foot note	Template:Convert/list of units/foot note
ទំព័រគំរូ:Convert/list of units/facdisp	Template:Convert/list of units/facdisp
ទំព័រគំរូ:Convert/list of units/itemnontable2	Template:Convert/list of units/itemnontable2
ទំព័រគំរូ:Convert/list of units/length/SI	Template:Convert/list of units/length/SI
ទំព័រគំរូ:Convert/list of units/length/metric	Template:Convert/list of units/length/metric
ទំព័រគំរូ:Convert/list of units/rowNa	Template:Convert/list of units/rowNa
ទំព័រគំរូ:Convert/list of units/row	Template:Convert/list of units/row
ទំព័រគំរូ:Convert/list of units/rowbraltab	Template:Convert/list of units/rowbraltab
ទំព័រគំរូ:Convert/list of units/rowbr	Template:Convert/list of units/rowbr
ទំព័រគំរូ:Convert/nm	Template:Convert/nm
ទំព័រគំរូ:Convert/numdisp/frac1	Template:Convert/numdisp/frac1
ទំព័រគំរូ:Cookbook	Template:Cookbook
ទំព័រគំរូ:CopyrightedFreeUseProvided	Template:CopyrightedFreeUseProvided
ទំព័រគំរូ:Flag	Template:Flag
ទំព័រគំរូ:Intellectual property	Template:知识产权
ទំព័រគំរូ:ទិន្នន័យប្រទេស ម៉ាល់ឌីវ	Template:Country data Maldives
ទំព័រគំរូ:ទិន្នន័យ នៃប្រទេសសិង្ហបុរី	Template:Country data Singapore
ទំព័រគំរូ:ទិន្នន័យប្រទេស យេម៉ែន	Template:Country data Yemen
ទំព័រគំរូ:Lang-pl	Template:Lang-pl
ទំព័រគំរូ:Country flag IOC alias USA	Template:Country flag IOC alias USA
ទំព័រគំរូ:DANFS	Template:DANFS
ទំព័រគំរូ:Unreliable sources	Template:Unreliable sources
ទំព័រគំរូ:Diff	Template:Diff
ទំព័រគំរូ:ប្រវត្តិសាស្ត្រវៀតណាម	Template:越南歷史
ចំណាត់ថ្នាក់ក្រុម:Protection templates	Category:保護模板
ចំណាត់ថ្នាក់ក្រុម:ភាសាអង់គ្លេស	Category:英语
ទំព័រគំរូ:FOSS	Template:FOSS
ទំព័រគំរូ:Scientists whose names are used as SI units	Template:以人名命名的国际单位制单位
ទំព័រគំរូ:OCA	Template:OCA
ទំព័រគំរូ:G8	Template:G8
ទំព័រគំរូ:WikiProject Biography	Template:WikiProject Biography
ទំព័រគំរូ:សំលៀកបំពាក់	Template:服裝
ទំព័រគំរូ:Fapages	Template:Fapages
ទំព័រគំរូ:Countries and regions of the Caucasus	Template:高加索国家和地区
ទំព័រគំរូ:Guideline list	Template:指引列表
ទំព័រគំរូ:Technology	Template:技术
ទំព័រគំរូ:Diatomicelements	Template:Diatomicelements
ទំព័រគំរូ:Nature nav	Template:自然的组成
ទំព័រគំរូ:Style	Template:Style
ទំព័រគំរូ:Time Persons of the Year 2001–2025	Template:Time Persons of the Year 2001–2025
ទំព័រគំរូ:Natural sciences-footer	Template:Natural sciences-footer
ទំព័រគំរូ:Help navigation	Template:维基帮助导航
ទំព័រគំរូ:ឋានន្តរសក្ដិរាជវង្សនិងអភិជន	Template:貴族等級
ទំព័រគំរូ:BranchesofChemistry	Template:化学分支
ទំព័រគំរូ:Burmese script	Template:Burmese characters
ទំព័រគំរូ:User Alternate Acct	Template:User alternate acct
ទំព័រគំរូ:Infobox country Olympics	Template:Infobox Country Olympics
ទំព័រគំរូ:ប្រអប់យុទ្ធនាការ សង្គ្រាមវៀតណាម	Template:Campaignbox 越南戰爭
ទំព័រគំរូ:ជ័យលាភីរង្វាន់ណូបែល ផ្នែកគីមីវិទ្យា ឆ្នាំ ១៩០១-១៩២៥	Template:诺贝尔化学奖获得者 (1901年－1925年)
ទំព័រគំរូ:Microeconomics	Template:微觀經濟學
ទំព័រគំរូ:User vi-2	Template:User vi-2
ទំព័រគំរូ:User vi-1	Template:User vi-1
ទំព័រគំរូ:User zh-min-nan-4	Template:User nan-4
ទំព័រគំរូ:User zh-min-nan-2	Template:User nan-2
ទំព័រគំរូ:User id-2	Template:User id-2
ទំព័រគំរូ:UF-hcard-geo	Template:UF-hcard-geo
ទំព័រគំរូ:Template shortcut	Template:Template shortcut
ទំព័រគំរូ:OMIM2	Template:OMIM2
ទំព័រគំរូ:Location map Scotland relief 2	Template:Location map Scotland relief 2
ទំព័រគំរូ:Likely	Template:Likely
ទំព័រគំរូ:Lang-th	Template:Lang-th
ទំព័រគំរូ:Lang-sq	Template:Lang-sq
ទំព័រគំរូ:Lang-pi	Template:Lang-pi
ទំព័រគំរូ:Lang-pa	Template:Lang-pa
ទំព័រគំរូ:Lang-es	Template:Lang-es
ទំព័រគំរូ:Lang-ca	Template:Lang-ca
ទំព័រគំរូ:Lang-bo	Template:Lang-bo
ទំព័រគំរូ:Lang-az	Template:Lang-az
ទំព័រគំរូ:Km icon	Template:Km icon
ទំព័រគំរូ:ISO 639 name eo	Template:ISO 639 name eo
ទំព័រគំរូ:ISO 3166	Template:ISO 3166
ទំព័រគំរូ:DiseasesDB2	Template:DiseasesDB2
ទំព័រគំរូ:Country flag IOC alias CAM	Template:Country flag IOC alias CAM
ទំព័រគំរូ:Mammal-stub	Template:Mammal-stub
ចំណាត់ថ្នាក់ក្រុម:នាមត្រូលជនជាតិជប៉ុន	Category:日本姓氏
ចំណាត់ថ្នាក់ក្រុម:ពិជគណិត	Category:代数
ចំណាត់ថ្នាក់ក្រុម:មុំ	Category:角
ចំណាត់ថ្នាក់ក្រុម:នព្វន្ធ	Category:算术
ចំណាត់ថ្នាក់ក្រុម:User ko-0	Category:Ko-0 使用者
Module:Citation	模块:Citation
ចំណាត់ថ្នាក់ក្រុម:ស្ពាននៅអាស៊ី	Category:亚洲桥梁
ចំណាត់ថ្នាក់ក្រុម:អត្ថបទខ្លីមិនពេញលេញ អំពីព្រះពុទ្ធសាសនា	Category:佛教小作品
ទំព័រគំរូ:Multicol	Template:Multicol
ចំណាត់ថ្នាក់ក្រុម:អាស៊ីខាងកើត	Category:東亞
ចំណាត់ថ្នាក់ក្រុម:អេឡិចត្រូម៉ាញ៉េទិច	Category:电磁学
ទំព័រគំរូ:Lang-mn	Template:Lang-mn
ទំព័រគំរូ:Lang-sa	Template:Lang-sa
ទំព័រគំរូ:Lang-sv	Template:Lang-sv
វិគីភីឌា:វិគីគម្រោងប្រវត្តិសាស្ត្រ	Wikipedia:历史专题
វិគីភីឌា:វិគីគម្រោង សាកលវិទ្យាល័យ	Wikipedia:大学专题
ទំព័រគំរូ:Precision/tz	Template:Precision/tz
ទំព័រគំរូ:Precision/tz/1	Template:Precision/tz/1
ទំព័រគំរូ:Lts	Template:Lts
ចំណាត់ថ្នាក់ក្រុម:បណ្ណាល័យ	Category:圖書館
ចំណាត់ថ្នាក់ក្រុម:មេរថក្រោះសមរភូមិ	Category:主戰坦克
ជំនួយ:មាតិកា/សេចក្តីផ្តើម	Help:目录/从这里开始
វិគីភីឌា:IPA for Thai and Lao	Wikipedia:泰语与老挝语国际音标
វិគីភីឌា:Link color	Help:链接颜色
ចំណាត់ថ្នាក់ក្រុម:យន្តហោះយោធាគ្រូបណ្តុះបណ្តាល	Category:軍用教練機
ចំណាត់ថ្នាក់ក្រុម:ទំព័រគំរូ សិទ្ធិ	Category:權利模板
ទំព័រគំរូ:Tech-stub	Template:Tech-stub
ចំណាត់ថ្នាក់ក្រុម:Navigational boxes without horizontal lists	Category:没有使用水平列表的导航框
ទំព័រគំរូ:ទិន្នន័យ​នៃប្រទេសម៉ុងហ្គោល	Template:MNG
ទំព័រគំរូ:Pronunciation	Template:Pronunciation
ទំព័រគំរូ:Non-free newspaper image	Template:Non-free newspaper image
ចំណាត់ថ្នាក់ក្រុម:ចំនួនកុំផ្លិច	Category:複數
ចំណាត់ថ្នាក់ក្រុម:Subtemplates of Template Convert	Category:Convert子模板
ចំណាត់ថ្នាក់ក្រុម:User pfl	Category:Pfl 使用者
ចំណាត់ថ្នាក់ក្រុម:ទំព័រគំរូTOC	Category:目錄模板
ទំព័រគំរូ:Image label begin	Template:Image label begin
ចំណាត់ថ្នាក់ក្រុម:រង្វង់និងស៊្វែរ	Category:圆
ទំព័រគំរូ:Bg icon	Template:Bg icon
វិគីភីឌា:Requests	Wikipedia:請求
ចំណាត់ថ្នាក់ក្រុម:កងកម្លាំងអាកាស	Category:空軍
ចំណាត់ថ្នាក់ក្រុម:សាកលវិទ្យាល័យនៅប្រទេសជប៉ុន	Category:日本的大學
វិគីភីឌា:សារ ទំព័រគំរូ/បោសសំអាត	Wikipedia:模板消息/清理
ទំព័រគំរូ:Resources for collaboration	Template:用于维护与合作的资源
វិគីភីឌា:Community portal/Opentask	Wikipedia:社群首页/活跃任务
វិគីភីឌា:សារ ទំព័រគំរូ/Redirect pages	Wikipedia:模板消息/重定向頁面
ចំណាត់ថ្នាក់ក្រុម:User es-0	Category:Es-0 使用者
ចំណាត់ថ្នាក់ក្រុម:User km-0	Category:Km-0 使用者
ចំណាត់ថ្នាក់ក្រុម:វប្បធម៌ខ្មែរ	Category:柬埔寨文化
ទំព័រគំរូ:Infobox language/IPA notice	Template:Infobox Language/IPA notice
ទំព័រគំរូ:Ombox/core	Template:Ombox/core
ទំព័រគំរូ:US$	Template:US$
ទំព័រគំរូ:Geodis	Template:Geodis
ចំណាត់ថ្នាក់ក្រុម:User en-1	Category:En-1 使用者
ចំណាត់ថ្នាក់ក្រុម:Calendar templates	Category:日历模板
ចំណាត់ថ្នាក់ក្រុម:User de-1	Category:De-1 使用者
ចំណាត់ថ្នាក់ក្រុម:Wikipedia protected templates	Category:被保護的模板
ទំព័រគំរូ:Asbox	Template:Asbox
ទំព័រគំរូ:Nowrap begin	Template:Nowrap begin
ទំព័រគំរូ:Marriage	Template:Marriage
ទំព័រគំរូ:Pre	Template:Pre
ទំព័រគំរូ:ខ្មែរក្រហម	Template:红色高棉
ទំព័រគំរូ:ខ្លីមិនពេញលេញ ព្រះពុទ្ធសាសនា	Template:Buddhism-stub
ទំព័រគំរូ:Chaturanga diagram	Template:Chaturanga diagram
ទំព័រគំរូ:សេរីភាព	Template:Freedom
ទំព័រគំរូ:ែដលកំពុងរឺកចំេរីន	Template:Underconstruction
ទំព័រគំរូ:Not English	Template:NotMandarin
ទំព័រគំរូ:Thank you	Template:Thank you
ទំព័រគំរូ:រដ្ឋ និងទឹកដីក្នុងមណ្ឌលឥទ្ធិពលជប៉ុនចក្រពត្តិកំឡុងសង្គ្រាមលោកលើកទី២	Template:大东亚共荣圈
ទំព័រគំរូ:Isdoing	Template:Isdoing
ទំព័រគំរូ:Convert/AU	Template:Convert/AU
ទំព័រគំរូ:សង្គ្រាមត្រជាក់	Template:Cold War
ទំព័រគំរូ:Infobox laboratory	Template:Infobox Laboratory
ទំព័រគំរូ:ព្រះត្រៃបិដក	Template:PaliCanon
ទំព័រគំរូ:Pipe	Template:Pipe
វិគីភីឌា:WikiProject Council/Guide	Wikipedia:专题委员会/专题指引
វិគីភីឌា:WikiProject Council/Directory	Wikipedia:专题委员会/专题名录
វិគីភីឌា:Tutorial/Keep in mind	Wikipedia:新手入門/方針指引
ទំព័រគំរូ:Very large	Template:Very large
ទំព័រគំរូ:Organisation of Islamic Cooperation	Template:伊斯蘭會議組織
ចំណាត់ថ្នាក់ក្រុម:កោះជ្វា	Category:爪哇島
ទំព័រគំរូ:Wiktionarylang	Template:Wiktionarylang
ទំព័រគំរូ:Frac	Template:Frac
ទំព័រគំរូ:Ntsh	Template:Ntsh
វិគីភីឌា:គម្រោងវិគីជាបងប្អូន	Wikipedia:姊妹计划
សាកលវិទ្យាល័យ​ត្រាវិញ	茶荣大学
ទំព័រគំរូ:Start date	Template:Start date
ទំព័រគំរូ:MediaWiki	Template:MediaWiki
វិគីភីឌា:Contributing to Wikipedia	Wikipedia:參與貢獻
ទំព័រគំរូ:Law	Template:法律
ចំណាត់ថ្នាក់ក្រុម:ការធ្វើសេចក្ដីរាយការណ៏ពត៌មាន	報告
ទំព័រគំរូ:International organizations	Template:國際組織
ទំព័រគំរូ:Mbox templates see also	Template:Mbox templates see also
ទំព័រគំរូ:WW2InfoBox	Template:WW2InfoBox
ទំព័រគំរូ:SMS	Template:Sms
ទំព័រគំរូ:Religious text primary	Template:Religious text primary
ទំព័រគំរូ:Tablabonita	Template:Tablabonita
ទំព័រគំរូ:Unknown	Template:Unk
ទំព័រគំរូ:User zh-min-nan-3	Template:User nan-3
ទំព័រគំរូ:Free	Template:Free
ទំព័រគំរូ:Bio-stub	Template:Bio-stub
ទំព័រគំរូ:សហភាពឥណ្ឌូចិន	Template:法属印度支那
ទំព័រគំរូ:ចលនាឯករាជ្យវៀតណាម	Template:越南獨立運動
វិគីភីឌា:Ribbons	Wikipedia:维基绶带
ទំព័រគំរូ:Begin flag row	Template:Begin flag row
ទំព័រគំរូ:ប្រវត្តិសាស្ត្រភូមា	Template:緬甸歷史
ទំព័រគំរូ:Lang-my-name-MLCTS	Template:My
ទំព័រគំរូ:Table-experimental	Template:Table-experimental
ទំព័រគំរូ:User km-1	Template:User km-1
ទំព័រគំរូ:Psychoanalysis	Template:精神分析学
ទំព័រគំរូ:Tim	Template:Tim
ទំព័រគំរូ:Other category header templates	Template:Other category-header templates
ទំព័រគំរូ:Elementbox isotopes decay	Template:Infobox element/isotopes decay
ទំព័រគំរូ:End flag row	Template:End flag row
ទំព័រគំរូ:End flag gallery	Template:End flag gallery
ទំព័រគំរូ:ប្រវត្តិសាស្ត្រលាវ	Template:老撾歷史
ទំព័រគំរូ:Incorrect	Template:Incorrect
ទំព័រគំរូ:Last edited by	Template:LastEditedBy
ទំព័រគំរូ:ប្រវត្តិសាស្ត្រខ្មែរ	Template:柬埔寨历史
ទំព័រគំរូ:WikiProject Footer	Template:WikiProject Footer
ទំព័រគំរូ:Tetl	Template:Tetl
វិគីភីឌា:អំពី ប្រអប់ខ្សាច់	Wikipedia:关于沙盒
វិគីភីឌា:Tutorial/Wrap-up and more info	Wikipedia:新手入門/總結
វិគីភីឌា:សារ ទំព័រគំរូ/Disputes	Wikipedia:模板消息/爭議與警告
វិគីភីឌា:Service awards	Wikipedia:維基榮譽與獎勵
វិគីភីឌា:Kindness Campaign	Wikipedia:友善計畫
ទំព័រគំរូ:ព្រះពុទ្ធសាសនាថេរវាទ	Template:TheravadaBuddhism
វិគីភីឌា:ពានរង្វាន់	Wikipedia:維基獎勵
ទំព័រគំរូ:Possible	Template:Possible
ទំព័រគំរូ:Normalwraplink	Template:Normalwraplink
ទំព័រគំរូ:Magnify icon	Template:Magnify icon
ទំព័រគំរូ:Specialpageslist	Template:Specialpageslist
វិគីភីឌា:Hatnotes	Wikipedia:頂註
ទំព័រគំរូ:National flags	Template:Nationalflags
ទំព័រគំរូ:Loc	Template:Loc
ទំព័រគំរូ:Overlinked	Template:Overlinked
ទំព័រគំរូ:Gov-stub	Template:Government-stub
ទំព័រគំរូ:Subject bar	Template:Subject bar
ទំព័រគំរូ:N.b.	Template:N.b.
ទំព័រគំរូ:Big	Template:Larger
ទំព័រគំរូ:Month3	Template:Month3
ទំព័រគំរូ:Infobox file format	Template:Infobox file format
ទំព័រគំរូ:អត្ថបទខ្លី អំពីកម្ពុជា	Template:Cambodia-stub
ទំព័រគំរូ:ក្រុមជនជាតិនៅវៀតណាម	Template:越南民族
វិគីភីឌា:WikiProject Military history/Military navigation	Template:Military navigation
ទំព័រគំរូ:Declined	Template:Declined
ទំព័រគំរូ:Permanently protected	Template:Permprot
ទំព័រគំរូ:IPA-th	Template:IPA-th
ទំព័រគំរូ:EC number	Template:EC编号
ទំព័រគំរូ:R from incomplete name	Template:短名重定向
ទំព័រគំរូ:Articles of the Universal Declaration of Human Rights	Template:世界人权宣言文件
ទំព័រគំរូ:Unrelated	Template:Unrelated
ទំព័រគំរូ:នយោបាយកម្ពុជា	Template:柬埔寨政治
ទំព័រគំរូ:ប្រធានបទរាជវង្សចូវ	Template:周代姬姓诸侯
ទំព័រគំរូ:User id-1	Template:User id-1
ទំព័រគំរូ:Location map Malaysia peninsula	Template:Location map Malaysia peninsula
ទំព័រគំរូ:Infobox Buddhist term	Template:Infobox Buddhist term
ការប្រាស្រ័យទាក់ទងអន្តរបុគ្គល	人際溝通
ទំព័រគំរូ:Scientists whose names are used as non SI units	Template:以人名命名的非国际单位制单位
ទំព័រគំរូ:Campaignbox World War II	Template:Campaignbox World War II
ទំព័រគំរូ:Polynomials	Template:多項式
ទំព័រគំរូ:Subpages	Template:子页面
ទំព័រគំរូ:IPAlink	Template:IPAlink
ទំព័រគំរូ:Geolinks-US-streetscale	Template:Geolinks-US-streetscale
ទំព័រគំរូ:UN document	Template:UN document
ទូរទស្សន៍បាយ័ន	巴仁電視台
វិគីភីឌា:WikiProject Council	Wikipedia:专题委员会
ទំព័រគំរូ:Unresolved	Template:Unresolved
ទំព័រគំរូ:Payoff matrix	Template:收益矩阵
ទំព័រគំរូ:PhylomapB	Template:生命系统发生树
ទំព័រគំរូ:S-hou	Template:S-hou
ទំព័រគំរូ:The Sun	Template:太阳
ទំព័រគំរូ:Mammals	Template:Mammals
វិគីភីឌា:Infobox colours	Wikipedia:信息框颜色
ទំព័រគំរូ:Importance	Template:Importance
ទំព័រគំរូ:Dynamic list	Template:动态列表
ទំព័រគំរូ:Working	Template:Working
វិគីភីឌា:Manual of Style (ប្រអប់ព័ត៌មាន)	Wikipedia:格式手册/信息框
ទំព័រគំរូ:Lead missing	Template:Lead missing
ទំព័រគំរូ:Politics sidebar	Template:Politics
ទំព័រគំរូ:Infobox Chinese	Template:Infobox Chinese
ទំព័រគំរូ:Infobox Monarchy	Template:Infobox Monarchy
ទំព័រគំរូ:Location map many	Template:Location map many
ទំព័រគំរូ:Worldcat id	Template:Worldcat id
ទំព័រគំរូ:Map caption	Template:Map caption
ទំព័រគំរូ:Tltts	Template:Tltts
ទំព័រគំរូ:Weekday in month	Template:Weekday in month
វិគីភីឌា:សារ ទំព័រគំរូ/ប្រភពនៃអត្ថបទ	Wikipedia:模板消息/条目来源
ទំព័រគំរូ:Further2	Template:Further2
ទំព័រគំរូ:Efn	Template:Efn
ទំព័រគំរូ:FullURL Diff	Template:FullURL Diff
វិគីភីឌា:Babel/km-0	Wikipedia:巴別/zh-0
ចំណាត់ថ្នាក់ក្រុម:យន្តហោះប្រដេញ	Category:战斗机
ទំព័រគំរូ:Element color/Actinoids	Template:Element color/Actinides
ទំព័រគំរូ:Element color/Alkaline earth metals	Template:Element color/Alkaline earth metals
ទំព័រគំរូ:Ombox/shortcut	Template:Ombox/shortcut
ទំព័រគំរូ:Table cell templates	Template:Table cell templates
ទំព័រគំរូ:Tlxs	Template:Tlxs
ទំព័រគំរូ:Convert/to(-)	Template:Convert/to(-)
ទំព័រគំរូ:Convert/list of units/item	Template:Convert/list of units/item
ទំព័រគំរូ:Convert/list of units/rowtop	Template:Convert/list of units/rowtop
ទំព័រគំរូ:Convert/list of units/area/short list	Template:Convert/list of units/area/short list
ទំព័រគំរូ:Respell	Template:Respell
ទំព័រគំរូ:Native name	Template:Native name
ទំព័រគំរូ:Noitalic	Template:Noitalic
ទំព័រគំរូ:Organization infoboxes	Template:Organization infoboxes
ទំព័រគំរូ:Infobox coord	Template:Infobox coord
ទំព័រគំរូ:Harvard citation/core	Template:Harvard citation/core
ទំព័រគំរូ:Lists of flags	Template:旗幟列表
ទំព័រគំរូ:\	Template:\
ទំព័រគំរូ:Google+	Template:Google+
ទំព័រគំរូ:MSW3 Groves	Template:MSW3 Groves
ទំព័រគំរូ:Office-table	Template:官員表
ទំព័រគំរូ:Discreet abbreviation	Template:Dabbr
ទំព័រគំរូ:Wikiquote-inline	Template:Wikiquote-inline
ទំព័រគំរូ:Multi-listen item	Template:Multi-listen item
ទំព័រគំរូ:Element color/Alkali metals	Template:Element color/Alkali metals
ទំព័រគំរូ:Element color/Lanthanoids	Template:Element color/Lanthanides
ទំព័រគំរូ:Element color/Other nonmetals	Template:Element color/Nonmetals
ទំព័រគំរូ:Infobox settlement/link	Template:Infobox settlement/link
ទំព័រគំរូ:Hidden sort key	Template:Hs
ទំព័រគំរូ:Twinkle standard installation	Template:Twinkle standard installation
ទំព័រគំរូ:តំណភ្ជាប់ខាងក្រៅ	Template:External links
ទំព័រគំរូ:Testcases side by side	Template:Testcases side by side
រូបភាពដែលបាត់បង់	消失的影像
ទំព័រគំរូ:Infobox high court	Template:Infobox High Court
ទំព័រគំរូ:សិទ្ធិ	Template:權利
ទំព័រគំរូ:ប្រអប់ព័ត៌មាន វត្តអារាមព្រះពុទ្ធសាសនា	Template:日本寺院
ទំព័រគំរូ:Warchivenav	Template:存檔模板
ទំព័រគំរូ:Numrec/Kosovo	Template:Numrec/Kosovo
ទំព័រគំរូ:Collapsible lists option	Template:Collapsible lists option
ទំព័រគំរូ:Spoken Wikipedia-2	Template:Spoken Wikipedia-2
ទំព័រគំរូ:IUCN2011.2	Template:IUCN2011.2
ទំព័រគំរូ:Editnotice pagename	Template:Editnotice pagename
ទំព័រគំរូ:Cite comic	Template:Cite comic
ទំព័រគំរូ:ISO 639-3 navigation	Template:ISO 639-3 navigation
ទំព័រគំរូ:Infobox National Olympic Committee	Template:Infobox National Olympic Committee
ទំព័រគំរូ:Howto	Template:Howto
ទំព័រគំរូ:Infobox អាកាសធាតុ/line	Template:Infobox Weather/line
ទំព័រគំរូ:Weather box/colp	Template:Infobox weather/colp
ទំព័រគំរូ:Weather box/colt	Template:Infobox weather/colt
ទំព័រគំរូ:Refimprove section	Template:Refimprovesect
ទំព័រគំរូ:RFPP	Template:RFPP
ទំព័រគំរូ:សិទ្ធិមនុស្ស	Template:人權
ជំនួយ:ការប្តូរទីតាំងទំព័រ	Help:重定向
ទំព័រគំរូ:Markup	Template:Markup
ទំព័រគំរូ:ប្រអប់ព័ត៌មាន ភាសា/genetic2	Template:Infobox language/genetic
ទំព័រគំរូ:Convert/list of units/extra	Template:Convert/list of units/extra
ទំព័រគំរូ:Convert/list of units/itemnontable	Template:Convert/list of units/itemnontable
ទំព័រគំរូ:Convert/list of units/length	Template:Convert/list of units/length
ទំព័រគំរូ:Convert/list of units/length/impus	Template:Convert/list of units/length/impus
ទំព័រគំរូ:Convert/list of units/length/maritime	Template:Convert/list of units/length/maritime
ទំព័រគំរូ:Convert/list of units/length/other	Template:Convert/list of units/length/other
ទំព័រគំរូ:Convert/list of units/length/short list	Template:Convert/list of units/length/short list
ទំព័រគំរូ:Convert/list of units/rowaltab	Template:Convert/list of units/rowaltab
ទំព័រគំរូ:Convert/list of units/rowaltabNa	Template:Convert/list of units/rowaltabNa
ទំព័រគំរូ:Convert/list of units/rowaltname	Template:Convert/list of units/rowaltname
ទំព័រគំរូ:Convert/list of units/rowaltnameNa	Template:Convert/list of units/rowaltnameNa
ទំព័រគំរូ:Convert/list of units/rowbrtop	Template:Convert/list of units/rowbrtop
ទំព័រគំរូ:Convert/list of units/rowImp	Template:Convert/list of units/rowImp
ទំព័រគំរូ:Convert/list of units/rowkelvinT	Template:Convert/list of units/rowkelvinT
ទំព័រគំរូ:Convert/list of units/rowtopNa	Template:Convert/list of units/rowtopNa
ទំព័រគំរូ:Convert/list of units/rowuninotetopwaltab	Template:Convert/list of units/rowuninotetopwaltab
ទំព័រគំរូ:Convert/list of units/speed/short list	Template:Convert/list of units/speed/short list
ទំព័រគំរូ:Convert/list of units/temperature/short list	Template:Convert/list of units/temperature/short list
ទំព័រគំរូ:Convert/list of units/triple	Template:Convert/list of units/triple
ទំព័រគំរូ:Convert/list of units/volume/short list	Template:Convert/list of units/volume/short list
ទំព័រគំរូ:Convert/U.S.galatm	Template:Convert/USgalatm
ទំព័រគំរូ:Class/colour	Template:Classcol
ទំព័រគំរូ:Pp-office	Template:Pp-office
ទំព័រគំរូ:MoreInfo	Template:MoreInfo
ទំព័រគំរូ:Style/IPA	Template:Style/IPA
ទំព័រគំរូ:Style/yid	Template:Style/yid
ទំព័រគំរូ:Page tabs	Template:PageTabs
Module:Convert	模块:Convert
ទំព័រគំរូ:Infobox comics location	Template:Infobox comics location
ទំព័រគំរូ:Project header	Template:专题
ទំព័រគំរូ:Weather box/cols	Template:Infobox weather/cols
វិគីភីឌា:សារ ទំព័រគំរូ/General	Wikipedia:模板消息/一般
វិគីភីឌា:សារ ទំព័រគំរូ/តំណភ្ជាប់	Wikipedia:模板消息/鏈結
វិគីភីឌា:សារ ទំព័រគំរូ/Deletion	Wikipedia:模板消息/刪除
ទំព័រគំរូ:Unichar	Template:Unichar
ទំព័រគំរូ:Ambox/core	Template:Ambox/core
ទំព័រគំរូ:Fishing	Template:Fishing
ទំព័រគំរូ:Do list	Template:Do list
ទំព័រគំរូ:Fix bunching	Template:Fix bunching
ទំព័រគំរូ:ប្រអប់ព័ត៌មាន ភាសា/Indic	Template:Infobox Language/Indic
ទំព័រគំរូ:Policy shortcut	Template:Policy shortcut
ទំព័រគំរូ:Unlikely	Template:Unlikely
ទំព័រគំរូ:Subatomic particle/list	Template:次原子粒子/列表
ទំព័រគំរូ:Inconclusive	Template:Inconclusive
ទំព័រគំរូ:Tltt	Template:Tltt
ទំព័រគំរូ:Dts/fmtdmy	Template:Dts/fmtdmy
ទំព័រគំរូ:Element color/Unknown (white)	Template:Element color/X
ទំព័រគំរូ:Off-topic	Template:Off-topic
ទំព័រគំរូ:Scinote/e	Template:Scinote/e
ទំព័រគំរូ:Tltt/tip	Template:Tltt/tip
ទំព័រគំរូ:User oops	Template:User Oops
ទំព័រគំរូ:Userpage bar	Template:Userpage bar
ទំព័រគំរូ:WPSS-cat	Template:WPSS-cat
ទំព័រគំរូ:Temporarily protected	Template:Temprot
ទំព័រគំរូ:Element color/Post-transition metals	Template:Element color/Poor metals
ទំព័រគំរូ:Element color/Noble gases	Template:Element color/Noble gases
ទំព័រគំរូ:Element color/Halogens	Template:Element color/Halogens
ទំព័រគំរូ:Element color/Metalloids	Template:Element color/Metalloids
ទំព័រគំរូ:Element color/Transition metals	Template:Element color/Transition metals
វិគីភីឌា:Userboxes/Userboxes	Wikipedia:用户框/用户框
ទំព័រគំរូ:សេដ្ឋកិច្ច	Template:Economics
Portal:Current events/Sidebar	Portal:新聞動態/Sidebar
ទំព័រគំរូ:ទិន្នន័យប្រទេស អូម៉ង់	Template:Country data Oman
ទំព័រគំរូ:ទិន្នន័យប្រទេស កាមេរូន	Template:Country data Cameroon
អាកាសចរណ៍ឡាវ ជើងហោះហើរ លេខ៣០១	寮國航空301號班機空難
ព្យុះហៃយ៉ាន	颱風海燕 (2013年)
ពិសេស:បំលាស់ប្ដូរថ្មីៗ	Special:最近更改
កម្ពុជា នៅស៊ីហ្គេម ២០១៣	2013年东南亚运动会柬埔寨代表团
Module:Citation/CS1	模块:Citation/CS1
ខេត្តត្បូងឃ្មុំ	特本克蒙省
Module:HtmlBuilder	模块:HtmlBuilder
Module:Coordinates	模块:Coordinates
Module:Navbox	模块:Navbox
វិគីភីឌា:សារ ទំព័រគំរូ/លំហឈ្មោះ អ្នកប្រើប្រាស់	Wikipedia:模板消息/用戶名字空間
ស ខេង	蘇慶
វិគីភីឌា:សារ ទំព័រគំរូ/លំហឈ្មោះ ឯកសារ	Wikipedia:模板消息/文件名字空间
Call of Duty: Advanced Warfare	使命召唤：高级战争
បញ្ជីនៃទង់ជាតិអង្គភាពរដ្ឋបាលរាជវង្សង្វៀនរបស់	阮朝行政單位旗幟
