ທະວີບອາຟະລິກ	非洲
ປະເທດຍີ່ປຸ່ນ	日本
ທະວີບອາເມລິກາໃຕ້	南美洲
ປະເທດນອກແວດ	挪威
ປະເທດອັງກິດ	英格兰
ປະເທດເອກົດ	蘇格蘭
ປະເທດການ	威爾士
ປະເທດອຽກລັງ	爱尔兰共和国
ປະເທດຮົງກະລີ	匈牙利
ປະເທດແອສະປາຍ	西班牙
ສະຫະລັດອາເມລິກາ	美国
ປະເທດແບນຊິກ	比利时
ປະເທດລູກຊຳບວກ	卢森堡
ໂລກ	地球
ປະເທດແຟງລັງ	芬兰
ປະເທດຊູແອດ	瑞典
ປະເທດດານມາກ	丹麦
ປະເທດໂປໂລຍ	波兰
ປະເທດລີຕົວນີ	立陶宛
ປະເທດອິຕາລີ	意大利
ປະເທດສະວິດ	瑞士
ປະເທດໂອຕະລິດ	奥地利
ປະເທດກະແລັດ	希腊
ປະເທດຕວກກີ	土耳其
ເບຍ	啤酒
ປະເທດປອກຕຸຍການ	葡萄牙
ທະວີບເອີລົບ	欧洲
ອາຊີ	亚洲
ທະວີບອາເມລິກາເໜືອ	北美洲
ທະວີບອັງຕາກຕິກ	南极洲
ວິກິພີເດຍ	维基百科
ປະເທດໂຮນລັງ	荷兰
ຄອມພິວເຕີ	電子計算機
ອິນເຕີເນັດ	互联网
ບາຣັກ ໂອບາມາ	贝拉克·奥巴马
ປະເທດອູຣູກວາຍ	乌拉圭
ຈັກພິມ	打印机
ລອນດອນ	伦敦
ປາລີ	巴黎
ແອນດຣອຍດ໌	Android
ກູໂກລ	Google
ປະເທດເມັກຊິກ	墨西哥
ມະຫາສະໝຸດອັດລັງຕິກ	大西洋
ມະຫາສະໝຸດປາຊີຟິກ	太平洋
ວັນຈັນ	星期一
ເດືອນມັງກອນ	1月
ກຸມພາ	2月
ມີນາ	3月
ເມສາ	4月
ພຶດສະພາ	5月
ມິຖຸນາ	6月
ກໍລະກົດ	7月
ສິງຫາ	8月
ກັນຍາ	9月
ຕຸລາ	10月
ພະຈິກ	11月
ທັນວາ	12月
ວັນອັງຄານ	星期二
ວັນພຸດ	星期三
ວັນພະຫັດ	星期四
ວັນສຸກ	星期五
ວັນເສົາ	星期六
ວັນອາທິດ	星期日
ປະເທດຝະລັ່ງ	法国
ໝາ	犬
ສະຫະລາຊະອານາຈັກ	英国
ແມວ	猫
ປະເທດຈີນ	中华人民共和国
ພາສາຝະລັ່ງ	法语
ປະເທດບະເຣຊິນ	巴西
ປະເທດລັດເຊຍ	俄罗斯
ຮູບຈັດຕຸລັດ	正方形
ທະເລ	海
ແຂວງເກແບັກ	魁北克
ປະເທດເຢຍລະມັນ	德国
ປະເທດບີເອໂລລຸດ	白俄罗斯
ປະເທດອີສະລັງ	冰岛
ປະເທດແອສະໂຕນີ	爱沙尼亚
ຍົນ	固定翼飛機
ຮູບສີ່ແຈສາກ	矩形
ມຸມສາກ	直角
ປະເທດແລດໂຕນີ	拉脫維亞
ປະເທດອູກະແລນ	乌克兰
ສາທາລະນະລັດແຊັກ	捷克
ປະເທດສະໂລວາກີ	斯洛伐克
ປະເທດສະໂລເວນີ	斯洛文尼亚
ປະເທດລູມານີ	羅馬尼亞
ປະເທດບູນກາລີ	保加利亚
ປະເທດມາເຊດວນ	馬其頓共和國
ປະເທດກະໂລອາຊີ	克罗地亚
ປະເທດບົດສະນີແຮກເຊໂກວີນ	波斯尼亚和黑塞哥维那
ປະເທດອາແຊກບາຍຊັງ	阿塞拜疆
ປະເທດອັງດອກ	安道尔
ປະເທດຊີບ	賽普勒斯
ປະເທດເຊອັອກຊີ	格鲁吉亚
ປະເທດມານ	马耳他
ປະເທດໂມນາໂກ	摩纳哥
ປະເທດແຊັງມາແລງ	圣马力诺
ຫໍແອບແຟນ	艾菲爾鐵塔
ຄີບອດ	电脑键盘
ປະເທດອິນໂດເນເຊຍ	印度尼西亚
ໂທລະພາບ	电视
ປະເທດຈີເລ	智利
ພຣະເຢຊູ	耶稣
ປະຫວັດສາດ	历史
ພາສາ	語言
ລະບອບຜະເດັດການ	獨裁政體
ບິກແບງ	大爆炸
ດາຣາສາດ	天文學
ປະເທດສິງກະໂປ	新加坡
ວິທະຍາສາດ	科学
ມົງເລອານ	蒙特利尔
ປະເທດລິກເຕນສະຕາຍ	列支敦斯登
ກິລາ	体育运动
ອາໂດນ ຮິດແລ	阿道夫·希特勒
ເຟດບຸກ	Facebook
ສົງຄາມໂລກຄັ້ງທີສອງ	第二次世界大战
ໂມງ	時鐘
ອຸບຸນຕູ	Ubuntu
ລິນຸກຊ໌	Linux
ຄະນິດສາດ	数学
ພາສາລາແຕັງ	拉丁语
ປະເທດອາກເມນີ	亞美尼亞
ປະເທດແຊກບີ	塞尔维亚
ດວງຈັນ	月球
ປະເທດອົດສະຕະຣາລີ	澳大利亚
ວັດຖຸວິທະຍາ	物理学
ປະເທດອາກຊັງຕິນ	阿根廷
ໂທລະຄົມມະນາຄົມ	电信
ປະເທດເປຣູ	秘鲁
ຊີວະສາດ	生物学
ປະເທດກຳປູເຈຍ	柬埔寨
ໄດໂນເສົາ	恐龙
ສາສະໜາອິສະລາມ	伊斯兰教
ຈິດ	心灵
ສັນຕິພາບ	和平
ກາບກອນ	诗歌
ຈັກກະພັດນາໂປເລອົງທີ 1	拿破仑一世
ປີແສງ	光年
ໂອເຊອານີ	大洋洲
ລະບົບສຸລິຍະ	太阳系
ປຶ້ມ	图书
ມື້	日
ປີ	年
ອົກຊີແຊນ	氧
ດົນຕີ	音乐
ພາສາອິຕາລີ	意大利语
ອາລູມິນຽມ	铝
ປະເທດນູແວນເຊລັງ	新西兰
ປະເທດປາປົວຊີນູແວນກີເນ	巴布亚新几内亚
ປະເທດເວເນຊູເອລາ	委內瑞拉
ສັດ	动物
ປະເທດຊູຣີນາມ	蘇利南
ປະເທດປາຣາກວາຍ	巴拉圭
ປະເທດກຸຍຢານ	圭亚那
ສິລະປະ	艺术
ປະເທດເອກົວເຕີ	厄瓜多尔
ປະເທດໂກລົມບີ	哥伦比亚
ພຸດທະສາສະໜາ	佛教
ປະເທດໂບລີວີ	玻利維亞
ປະເທດກົວເຕມາລາ	危地马拉
ປະເທດອີຣານ	伊朗
ປະເທດກົດສະຕາລິກາ	哥斯达黎加
ປະເທດລາວ	老挝
ທະວີບອາເມລິກາ	美洲
ງົວ	家牛
ປະເທດມາເລເຊຍ	马来西亚
ປະເທດມຽນມາ	缅甸
ປະລາຕົງ	柏拉图
ຢູທູບ	YouTube
ປະເທດໄທ	泰国
ລົດໄຟ	鐵路列車
ປະເທດຫວຽດນາມ	越南
ປະເທດເກົາຫຼີໃຕ້	大韩民国
ປະເທດບັງກະລາເທດ	孟加拉国
ປະເທດອັງໂກລາ	安哥拉
ທະວິດເຕີ	Twitter
ປະເທດບູໄນ	文莱
ປະເທດຟີລິບປິນ	菲律宾
ປັກກິ່ງ	北京市
ວິວັດທະນາການ	演化
ສະຫະປະຊາຊາດ	联合国
ທໍລະນີສາດ	地质学
ພູມສາດ	地理学
ສີ	颜色
ຄຳນາມ	名詞
ປະເທດໂກໂຊໂວ	科索沃
ໝວດ:ມູນຖານ	Category:頁面分類
ລະດູໜາວ	冬季
ລະດູບານໃໝ່	春季
ລະດູຮ້ອນ	夏季
ລະດູໃບໄມ້ຫຼົ່ນ	秋季
ພາສາແອສະປາໂຍນ	西班牙语
ໝາກໄມ້	果实
ເງິນ	貨幣
ລັດນີວຢອກ	纽约州
Uetersen	于特森
Microsoft Windows	Microsoft Windows
ໄທບີຣຽສ	提贝里乌斯
ລົດ	汽车
ບອກໂດ	波尔多
ໂຕກຽວ	東京都
ບາກເຊໂລນ	巴塞罗那
ໝາກນັດ	菠蘿
ກາໂຕລິກ	天主教
ພະຄຳພີ	聖經
ພະນົມເປັນ	金边
ນິກາຍໂບດທູຈີຊັດ	真耶稣教会
ພາສາອັງກິດ	英语
ບາງກອກ	曼谷
ດົງເຮີຍ	同海市
ໂກຣິສໂກໂວລາ	孔斯科沃拉
ປີ 2009	2009年
ປີ 2008	2008年
ອາຫານ	食物
XML	XML
ການປະຕິວັດອຸດສາຫະກຳ	工业革命
ໄມໂຄຼຊອຟທ໌	微软
ຄູໂຣ	库鲁夫
ເຄມີສາດ	化學
14 ກຸມພາ	2月14日
22 ມີນາ	3月22日
16 ເມສາ	4月16日
ອາໂນນ ຊວາເຊເນກເກີ	阿诺·施瓦辛格
19 ກໍລະກົດ	7月19日
ເຕະບານ	足球
ໄອໂຟນ	IPhone
ເຮືອດຳນ້ຳ	潛艇
ໄມເຄິ້ນ ແຈັກຊັ້ນ	迈克尔·杰克逊
ພະລາຊະວັງແວກໄຊ	凡尔赛宫
ມະຫາວິຫານນົດ-ດາມ	巴黎聖母院
ໝວດ:ແມ່ແບບ	Category:維基百科模板
ແມ່ນ້ຳອາມາຊົນ	亚马逊河
ໂຮງຮຽນ	学校
ມະຫາວິທະຍາໄລ	大學
ວິກິພີເດຍ:Sandbox	Wikipedia:沙盒
ວິກິພີເດຍ:ເລີ່ມຕົ້ນ	Wikipedia:新手入門/主頁
ເຮືອນ	住宅
ທະວີບອົດສະຕະຣາລີ	澳大利亞洲
ຮາດແວ	硬件
ພຶດຊະຄະນິດ	代数
ສະໜາມບິນດົງເຮີຍ	同海機場
ອາວະກາດ	外层空间
ປ່າໄມ້	森林
ຂົງຈື້	孔子
ມາຣິລິນ ມອນໂຣ	玛丽莲·梦露
ໝວດ:ຄະນິດສາດ	Category:数学
ເອີໂລ	欧元
ທະເລເມດີແຕກລາເນ	地中海
ຄິດຕະສາສະໜາ	基督教
Windows 8	Windows 8
ເຂົ້າຈ້າວ	稻
ທະວີບ	洲
ສັດປີກ	鸟
ນະຄອນຫຼວງ	首都
ພາສາປອກຕຸຍການ	葡萄牙語
ເດືອນ	月
1949	1949年
ຕາກດີກະລາດາ	缓步动物门
ພາສາຍີ່ປຸ່ນ	日语
ສາລານຸກົມ	百科全书
ໜ້າຫຼັກ	Wikipedia:首页
ຊີພີຢູ	中央处理器
ເຣົາເຕີຣ໌	路由器
ໂຕຕ້ານໄຟຟ້າ	電阻器
ທຣານຊິສເຕີ	晶体管
ເບດບອນ	棒球
ບານບ້ວງ	篮球
ກິລາໂອແລມປິກ	奥林匹克运动会
ລົດເມ	公共汽車
ແຄວ້ນກາຕາໂລຍ	加泰罗尼亚
ການຮ່ວມເພດ	性交
ປັດຊະຍາ	哲学
ຈິມິ ເຮນດຣິກຊ໌	吉米·亨德里克斯
ໝວດ:Candidates for speedy deletion	Category:快速删除候选
ອະນາທິປະໄຕ	无政府主义
ລັດທິທຶນນິຍົມ	资本主义
ປະເທດ	国家
ເວັບເບຣົາວ໌ເຊີຣ໌	网页浏览器
Boeing 737	波音737
ໝວດ:ດາຣາສາດ	Category:天文学
ການປະຕິວັດຝະລັ່ງ	法国大革命
ຮັກຮ່ວມເພດ	同性戀
ອາຫານຝະລັ່ງ	法國飲食文化
ໂຮແມ	荷马
ພາສາກາຕາລັງ	加泰罗尼亚语
ພຣະພຸດທະເຈົ້າ	佛
ອະເທວະນິຍົມ	无神论
ຫໍສະໝຸດ	图书馆
ນິເວດສາດ	生态学
ການເມືອງ	政治
ລະບອບປະຊາທິປະໄຕ	民主
ໂລກາພິວັດ	全球化
ແຊນ	基因
ລັດຖະບານ	政府
ຄວາມສວຍງາມ	美
ລາຊາທິປະໄຕ	君主制
ລັດ	國 (政治)
ດັງ	鼻
ເພງ	歌曲
ເດິນຟິນ	海豚
ສັດລ້ຽງລູກດ້ວຍນ້ຳນົມ	哺乳动物
ໂລຊີຊີແອນ	软件
ອາເດແອັນ	脱氧核糖核酸
ແອສະແປດ	物种
ພາສາລັດເຊຍ	俄语
ກົດໝາຍ	法律
ລັດຖະທຳມະນູນ	宪法
ສະມາຄົມປະຊາຊາດແຫ່ງອາຊີຕາເວັນອອກສຽງໃຕ້	东南亚国家联盟
ກອງທືນການເງີນລະຫວ່າງປະເທດ	國際貨幣基金組織
ພາສາສະວາຮີລີ	斯瓦希里语
ພາສາຈີນ	汉语
ທຳມະຊາດ	自然
ນ້ຳດື່ມ	饮用水
ພາສາລູມານີ	羅馬尼亞語
ສຶກສາສາດ	教育学
ແຮ່ທາດ	礦物
ເຊັນ	禅宗
ເມົາສ໌	鼠标
ປະໂລເຕອິນ	蛋白质
ພະຍຸໂທຣນາໂດ	龍捲風
ໄຕມຸມ	三角学
ເລຂາຄະນິດ	几何学
ໄວຍະກອນ	语法
ນິນເທັນໂດ	任天堂
ເສດຖະສາດ	经济学
ທຶນ	资本
ເງິນຕາ	通貨
ເຢນ	日圓
ອຸດສາຫະກຳ	产业
ພາສີ	稅
ພາສາສາດ	语言学
ຄຳ (ພາສາສາດ)	單詞
ໂຕໜັງສືເກຣັກ	希腊字母
ວັນນະຄະດີ	文學
ໝວດ:ປະເທດຝະລັ່ງ	Category:法国
ໝວດ:ດົນຕີ	Category:音乐
ໝວດ:ວັນນະຄະດີ	Category:文学
ຂັ້ນຕອນວິທີ	算法
ການສຶກສາ	教育
ຄອບຄົວ	家庭
ກາເຟ	咖啡
ນົມ	乳
ສົງຄາມເຢັນ	冷战
ຊຽງໄຮ້	上海市
ອິນເຕີຣ໌ເນັຕ ໂປຣໂຕໂຄລ	网际协议
ໄບຕ໌	字节
ບິຕ	位元
ຄວາມຮູ້	知识
ສາສະໜາພາມ	印度教
ປະລະມະນູ	原子
ພາສາກະເລັກ	希腊语
ລະບົບປະຕິບັດການ	操作系统
ອີແມລ	电子邮件
ສາສະໜາ	宗教
ພາສາເກົາຫຼີ	朝鮮語
ຕຶກແອັມພາຍສະເຕດ	帝国大厦
ອະນຸສາວະລີເທພີເສລີພາບ	自由女神像
ພາສາລາວ	老挝语
ພາສາໄທ	泰语
ສາສະໜາຊູດາ	犹太教
ພາສາການ	威尔士语
ສາສະໜາຊິກ	锡克教
ຈອນ ເມນາດ ເຄນ	约翰·梅纳德·凯恩斯
ວຽງຈັນ	永珍
ພຶຕິກຳ	行為
ອາລົມ	情绪
ຈິຕະວິທະຍາ	心理学
ຄວາມຄຶດ	思想
ມະຫາສະໝຸດ	洋
ຈະລິຍະທຳ	伦理学
ຍານວິທະຍາ	知识论
ເຈດຈຳນົງເສລີ	自由意志
ແກນກາງ	内核
ສົມເດັດພະລາຊິນີນາດເອລີຊາແບັດທີ 2 ແຫ່ງສະຫະລາຊະອານາຈັກ	伊丽莎白二世
ຄວາມທຸກຍາກ	貧窮
ຕາລາງທາດ	元素周期表
ເດິນຟິນໜູ	鼠海豚科
ກົກໄມ້	树
ເນີຍແຂງ	乾酪
ຜັກ	蔬菜
ໂຣບົດ	机器人
ເຕັກໂນໂລຊີ	技术
ກົນຈັກ	机械
ວິສະວະກຳ	工程学
ສານສົນເທດ	信息
ໜັງສືພິມ	報紙
ໂທລະສັບ	电话
ວັດທະນະທຳ	文化
ຫມາຍເລກໄອພີ	IP地址
ແພດສາດ	医学
ອົງກອນນິຕິບັນຍັດ	立法机构
ຫ້ຽນ	白目
ສົມຜົນ	方程
ຕຳລາ (ຄະນິດສາດ)	函数
ກະລູຊິດ	糖类
ຮອກມົນ	激素
ເກມ	游戏
ຂອງຫຼິ້ນ	玩具
ຮູບເງົາ	电影
ລົດຖີບ	自行車
ກຳປັ່ນ	船
ກະສິກຳ	农业
ລາຍຊື່ໜ່ວຍນັບເວລາ	时间
ເຈ້ຍ	纸
ປະລາສະຕິກ	塑料
ເນື້ອທີ່	面积
ຈຳນວນ	数
ຈຳນວນສົນ	复数 (数学)
ແມັດ	米 (单位)
ຈິຕະກຳ	绘画
ນັກອາວະກາດ	宇航员
ການຖ່າຍຮູບ	摄影
ການຟ້ອນລຳ	舞蹈
ເອເລັກໂຕຣນິກ	电子学
ສ່ວນປະກອບເອເລັກໂຕຣນິກ	電子元件
ດີອົດ	二極管
ເຕັກໂນໂລຊີຂໍ້ມູນຂ່າວສານ	信息技术
ຕະຫລາດຫລັກຊັບ	证券交易所
ຮ້ານອາຫານ	餐馆
ອາຊີຕາເວັນອອກສຽງໃຕ້	东南亚
ບະລັງແນດ	白雪公主
ຊັງດີຢົງ	灰姑娘
ປະຕິທິນ	历法
ເຂດເວລາ	时区
ສຸຂະພາບ	健康
ເອດສ໌	艾滋病
ສະຖາປັດຕະຍະກຳ	建筑
ຂົວ	橋
ເຂົ້າໜົມມາກາຣົງ	馬卡龍
ສະຖິຕິສາດ	统计学
ຈຳນວນຖ້ວນ	整数
ເຂື່ອນສາມຜາ	长江三峡水利枢纽工程
ຍຸກແສງສະຫວ່າງ	啟蒙時代
ສະໄໝກາງ	中世纪
ລວມຍອດຜະລິດຕະພັນພາຍໃນ	国内生产总值
ແຟຊັ້ນ	時裝
ລູກຄິດ	算盘
ຄາບສະໝຸດອີເບລີ	伊比利亚半岛
ຈຳນວນຈິງ	实数
ໝາກຟະແລດ	草莓
ໝາກກ້ຽງ	橙
ພາສາຈ້ວງ	壮语
ພາສານາວາເທິນ	納瓦特爾語
ສິ່ງແວດລ້ອມສໍາລັບການພັດທະນາແບບຮວບຮວມ	集成开发环境
ພາສາອາຣັບ	阿拉伯语
ພາສາອົກຊີຕັງ	奥克语
ນາຍົກລັດຖະມົນຕີ	总理
ສໍດຳ	铅笔
ໂຕະ	桌子
ແທັງເກີ	液貨船
ກວາງຄໍຍາວ	长颈鹿
ພາສາເຊ	C语言
ວິກິພີເດຍ:ບົດຄວາມດີເດັ່ນ	Wikipedia:特色条目
ແມ່ແບບ:Link FA	Template:Link FA
ວິກິພີເດຍ:Village pump	Wikipedia:互助客栈
ກວ່າງໂຈວ	广州市
ໂຮງໜໍ	醫院
ການສົມລົດເພດດຽວກັນ	同性婚姻
ໂທລະສັບມືຖື	移动电话
ລົດສະນິຍົມທາງເພດ	性取向
ງົວປ່າອາເມລິກາ	美洲野牛属
ບານເຕະໂລກ	世界盃足球賽
ຍາຈາງ	芽莊市
ສາທາລະນະສົມບັດ	公有领域
ກຸ່ມພາສາໂລມັງ	罗曼语族
ຮູບສາມແຈ	三角形
ຈຳນວນທຳມະຊາດ	自然数
ສັດທະອັກສອນສາກົນ	國際音標
ສະມາດໂຟນ	智能手机
ພິກັດພູມສາດ	经纬度
ເກີບ	鞋
ເສລີພາບໃນການເວົ້າ	言論自由
ສວນສາທາລະນະ	公园
ສັບປະດາ	星期
ຜັກທຽມ	蒜
ມະນຸດສາດ	人类学
ເອແດມບວກ	爱丁堡
កោះ	島嶼
ພາສາລັດຖະການ	官方语言
ບູຮານວິທະຍາ	考古学
ອຸດທະຍານແຫ່ງຊາດຟົງ ງາ-ເຄ ບັງ	峰牙－己榜國家公園
ແຂວງກວາງບິນ	廣平省
ເສັ້ນສູນສູດ	赤道
ປະໂລແຕສະຕັງ	新教
ວັດຈະນານຸກົມ	詞典
ເພງຊາດ	国歌
ຄຳກຳມະ	动词
ພາສາແຟໂລ	法罗语
ສັດກິນຊີ້ນ	食肉目
ເກາະຊີແລນ	西兰岛
ເຮືອຂ້າມຟາກ	渡船
ປະດິດໃຊ້ເອງ	DIY
Józef Gosławski	约瑟夫·高斯瓦夫斯基
ການຂັບລຳ	歌唱
ເສັ້ນຜົມ	頭髮
ວິຊາຊີບ	專業
ສິນຄ້າ	商品
ຜົນຕຳລາ	导数
ບລອກ	網誌
ນົກແກ້ວ	鹦形目
ຊື່ໂດເມນ	域名
ມ້າລາຍ	斑馬
ເລກມາຕະຖານສາກົນປະຈຳປຶ້ມ	国际标准书号
ພາສາຈາໂມໂລ	查莫罗语
ພາສາເຈໂລກີ	切羅基語
ຈິຕະນິຍົມ	唯心主義
ຫົວສີໄຄ	柠檬草
ເສັ້ນຂະໜານ	纬度
ໝວດ:ພາສາໂປແກມ	Category:程序设计语言
ຈັດສະຕິນ ບີເບີ	贾斯汀·比伯
ກຸ່ມພາສາໄທ-ກະໄດ	壯侗語族
ເນີຍ	黄油
ເທວະວິທະຍາ	神學
ນ້ຳຕົກຕາດນີອາກາລາ	尼亚加拉瀑布
ໂຫລາສາດ	占星学
ຫົງ	天鹅
ຫົນທາງ	道路
ເຮລີກົບແຕ	直升機
ລົດຈັກ	摩托車
ມ້າແມ່ນ້ຳ	河马
ສັງຄົມສາດ	社会科学
ແຫຼມ	半岛
ລະຫັດໂທລະສັບລະຫວ່າງປະເທດ	国际电话区号列表
ຟົວກາ	鵝肝
ມົນທົນ	省 (行政區劃)
ໝາກຫຸ່ງ	番木瓜
ວິຕາມິນ	维生素
ເວັບໄຊຕ໌	網站
ກວາງອູດ	駝鹿
ເສືອອາເມລິກາ	美洲豹
ສະພາ	议会
ສະພາວະເງິນເຟີ້	通货膨胀
ເຮືອ	艇
ໂປລີເນຊີ	玻里尼西亞
ດຽນບຽນຟູ	奠邊府
ໝີໄຮ້ຫາງ	無尾熊
ເສັ້ນແວງ	经度
ສະຫັດສະວັດ	千纪
ຊ້າງຂົນຍາວ	猛犸象
ອອງ ຊານ ຊຸຈີ	翁山蘇姬
ໄຂ້ຫວັດຫມູ	豬流感
ພາສາໄທລື້	傣仂語
ເສິນຫຼົງ	成龍
ເອກະລາດ	独立
ມະຣິວຸລ	马里乌波尔
ມະຫາປີລະມິດ ແຫ່ງ ກິຊາ	胡夫金字塔
ISO 4217	ISO 4217
ຕະຫຼາດ	市场
ກະໂລໂມຊົມ	染色体
ມັນດ້າງ	番薯
ພະຍັນຊະນະ	辅音
ນ້ຳຕົກຕາດຄອນພະເພັງ	孔恩瀑布
ຟີລຳ	门 (生物)
ພະເຈົ້າຮົງລີທີ 8 ແຫ່ງອັງກິດ	亨利八世
ຂ່າວ	新闻
ດັດສະນີການພັດທະນາມະນຸດ	人类发展指数
ເສດຖະສາດຈຸນລະພາກ	微观经济学
ສັດລ້ຽງ	宠物
ເລເຈບ ໄຕຢິບ ແອໂດກັນ	雷杰普·塔伊普·埃尔多安
ນໍ້າມັນເຊື້ອໄຟ	汽油
ເສດຖະສາດມະຫາພາກ	宏观经济学
ສະໜວນກາຊາ	加沙地带
ເຄື່ອງດື່ມ	饮料
ປະໂລກະລຳ ແອງຟອກມາຕິກ	计算机程序
ຍານອາວະກາດ	航天器
ເຈັນນິເຟີຣ໌ ໂລເປສ	珍妮弗·洛佩兹
ມີດຕັດ	剪刀
ຊ້າງທະເລ	海象
ຕຶກ	建筑物
ແມ່ນ້ຳຂອງ	湄公河
ວາລະສານ	杂志
ສານ	法院
Rupiah ອິນໂດເນເຊຍ	印尼盾
ປະໂຫຍກ	句子
.la	.la
ສວນລອຍຟ້າບາບິລອນ	空中花园
ໝາແຜງ	鬣狗科
ພິ່ນອິ່ນ	汉语拼音
ເຊື້ອໄຟ	燃料
ອູດແກະໃຫຍ່	大羊駝
ຄວາຍ	水牛
Long Thanh International Airport	隆城國際機場
ຍານພາຫະນະ	载具
ນ້ຳມັນ	油
ວິນຍານນິຍົມ	泛靈論
ບໍລິການຂໍ້ຄວາມສັ້ນ	簡訊
ເຮືອນຄົວ	廚房
ຮັກຮ່ວມສອງເພດ	双性恋
ເອສົບ	伊索
ສິ່ງແວດລ້ອມ	自然环境
ໂກແລສະເຕໂລນ	膽固醇
ສະຫະພັນທະລັດ	联邦制
ໄຂ້ຫວັດນົກ	禽流感
ມາຕຣິກ	矩阵
ຕຳນານ	传说
ເທວາທິປະໄຕ	神權政治
ຂົວໂກນເດນເກດ	金门大桥
ໝາກສຸກ ໝາກໃສ	水痘
ທ່າເຮືອ	港口
Vaishnavism	毘濕奴派
ໝາກມີ້	波罗蜜
ທຸງຊາດລາວ	寮國國旗
ໃບສະຫຼຸບຊັບສົມບັດ	資產負債表
ສາຍການບິນ	航空公司
ເສດຖະສາດສາກົນ	国际经济学
ວັນກຳມະກອນສາກົນ	国际劳动节
ລາດາ	雷达
ແມ່ແບບ:Commonscat	Template:Commons category
ຈັກກະວັດແອສະປາຍ	帝国
ມະຫາຍານ	大乘佛教
ກະສວຍອາວະກາດ	航天飞机
ການທ່ອງທ່ຽວ	旅游
ຕູ້ໄປສະນີ	郵箱
Visual Basic .NET	Visual Basic .NET
ແຂວງ	老挝行政区划
ຕຳລາຂັ້ນສອງ	二次函数
ອີໂບລາ	埃博拉出血热
ໝວດ:ລັດຖະບານ	Category:政府
ໝວດ:ຄວາມຮັກ	Category:愛
ສະຖານີລົດໄຟ	鐵路車站
ພາສາມາລິໂຄປາ	馬里科帕語
ພາສາໄທດຳ	傣擔語
ພາສາເຮົາຊາ	豪萨语
ພາສາໄທເໜືອ	掸语
ຈູມມະລີ ໄຊຍະສອນ	朱馬利·賽雅貢
ຫງວຽນເຕິນຢຸງ	阮晉勇
ຍິ່ງລັກ ຊິນນະວັດ	英樂·欽那瓦
ທອງສິງ ທຳມະວົງ	通邢·塔马冯
ກ້ອງດິຈິຕອນ	数码相机
ອັດຕາແລກປ່ຽນ	汇率
ທະນາຄານກາງ	中央银行
ການຜັງເມືອງ	城市规划
ຮອບບິດ (ປຶ້ມ)	哈比人歷險記
ຄະນາທິປະໄຕ	寡头政治
Current events	Wikipedia:宣告
ບານເຕະໂລກ 2014	2014年世界盃足球賽
ການແຍກໃຊ້ອຳນາດ	權力分立
ໝາກກ້ຽງໃຫຍ່	柚子
ວົງຈອນພອນ	獴科
ໄຟຟ້າພະລັງນໍ້າ	水力發電
ວິສະວະກຳໂລຊີຊີແອນ	软件工程
ອູດແກະ	羊驼
ຄວາມກົດອາກາດ	气压
ບ່ວງ	匙
VoIP	網際協議通話技術
ໄມ້ຖູ່	筷子
ກຳລັງຊື້ທຽບຖານ	购买力平价
ເຄື່ອງໝາຍວັກ	标点符号
ຕັກຊີ	出租車
ຄຳອຸທານ	感叹词
ພຽງພອນເໝັນ	臭鼬科
ເຊລີນ້າ ໂກເມຊ	賽琳娜·戈梅茲
ໂຮງງານ	工廠
ບານເຕະທີມຊາດບະເລຊິນ	巴西國家足球隊
ບານໂປໂລຍ	波兰球
ຕຳລາໄຕມຸມ	三角函数
ຄຣິສຕະຈັກເຊເວັນເດ ແອັດເວັນຕິສ	基督復臨安息日會
PAL	PAL制式
ອຳນາດຕຸລາການ	司法機構
ຄວາມສະເໝີພາກທາງເພດ	性別平等
ເຂົ້າຫນຽວ	糯稻
ກະລັງກັງຢົງ	科羅拉多大峽谷
ແມ່ນ້ຳເຈົ້າພະຍາ	昭拍耶河
ຊຸບເປີຄອມພິວເຕີ	超级计算机
ໂຄງສ້າງພື້ນຖານ	基础设施
ໜູລ້າງນ້ຳ	浣熊
ຕົ້ນໂຣສ ເມຣີ	迷迭香
ປະເທດທີ່ບໍ່ມີທາງອອກສູ່ທະເລ	內陸國家
ເວັກເຕີ	向量空间
ປຶ້ມເອເລັກໂຕຣນິກ	電子書
ພາສີມູນຄ່າເພີ່ມ	增值税
ພະເຈົ້າເອດູອາກທີ 3 ແຫ່ງອັງກິດ	爱德华三世 (英格兰)
Mikoyan MiG-29	米格-29戰鬥機
ການພັດທະນາແບບຍືນຍົງ	可持续发展
ອ່າວໄທ	泰國灣
ການວາງແຜນຊັບພະຍາກອນຂອງອົງກອນ	企业资源计划
ນິກາຍເຖຣະວາດ	上座部佛教
ໂທລະພາບຄວາມລະອຽດສູງ	高清电视
ທຸງຊາດໄທ	泰国国旗
ພະຍຸໄຕ້ຝຸ່ນ	颱風
ດຸນການຊຳລະ	国际收支
ການຊອກຄ່າເໝາະສົມ (ຄະນິດສາດ)	最优化
ລະດູແລ້ງ	旱季
Phu Quoc	富國島 (越南)
ປະເທດລາວໃນໂອລິມປິກລະດູຮ້ອນ 2008	2008年夏季奥林匹克运动会老挝代表团
ວິກິພີເດຍ:ຂໍໃຫ້ຂະຫຍາຍ	Help:编辑页面
Leopard 2	豹2型坦克
ວົງຜື	莎草科
ເດຈາວູ	既視感
ເຄື່ອງຮັບວິທະຍຸ	无线电接收机
Eurocopter Tiger	虎式直升机
ເສດຖະກິດ	经济
ເອໂຄໂນເມທຣິກ	计量经济学
ລາຄາ	价格
ມະຫາວິທະຍາໄລເອແດມບວກ	爱丁堡大学
ທາງລົດໄຟ	鐵路軌道
ສຳປະສິດຈິນີ	基尼系数
ກາຕະລີນແຫ່ງອາລາກົງ	阿拉貢的凱瑟琳
ບິກ	筆
ໝາກກ້າຍ	大蕉
ທືນສັບພະຍາກອນມະນຸດ	人力资本
ການສະໜອງ ແລະ ຄວາມຕ້ອງການ	供给和需求
ຊອດໄຂ່ແດງ	蛋黃醬
ENIAC	電子數值積分計算機
ຊຸດຈຳນວນ	级数
ພັດທະຍາ	芭達亞
ດອກເບ້ຍ	利息
ຫຸ່ນຍົນສາດ	机器人学
Boeing AH-64 Apache	AH-64阿帕契直升机
ອຸປະຕິເຫດ	意外事故
ຢາງລຶບ	橡皮擦
ເຂື່ອນຮູເວີ	胡佛水壩
ນູເມລິກ	數碼
ລະບົບມາດຕະຖານຄຳ	金本位
Sukhoi Su-27	苏-27战斗机
ການບັນເທີງ	娛樂
កាំ	半径
ມະຫາວິຫານແຊັງໂປນ	圣保罗座堂
ຍິວວິທະຍາໄລຂອງເຢຣູຊາເລັມ	耶路撒冷希伯來大學
ມະຫາວິທະຍາໄລແຄລິຟໍເນຍ ລອດແອນເຈລິດ	加州大学洛杉矶分校
ຊັງຕີແມັດ	厘米
ມິລີແມັດ	毫米
ມິໂກຣແມັດ	微米
ລາຍຊື່ປະເທດຮຽງຕາມຄວາມໜ້າແໜ້ນຂອງປະຊາກອນ	国家人口密度列表
ເສດຖະກິດຕົກຕໍ່າ	经济衰退
ເມນເຟຣມ	大型计算机
ບໍ່ນ້ຳຮ້ອນ	溫泉
ເນັຕບຸກ	上网本
ນະໂຍບາຍເງິນຕາ	货币政策
ນາໂນແມັດ	纳米
ການຄ້າສາກົນ	国际贸易
ຈອຍສະຕິກ	控制杆
ເທວະດາ	神
ອັດຕາດອກເບ້ຍ	利率
ລົດໂຮງໝໍ	救護車
ຈັງຫວັດພູເກັດ	普吉府
ເສັ້ນສະແດງ	函数图形
ສູດເຮລົງ	海伦公式
ບັນທັດຖານວັດແທກ ລາຍໄດ້ ແລະ ຜົນຜະລິດ ແຫ່ງຊາດ	国民生产总值
ຕົ້ນທຶນໂອກາດ	机会成本
ວົງເຫງັນ	灵猫科
ນະໂຍບາຍການເງິນ	财政政策
ເຄື່ອງໝາຍຊາດຂອງໄທ	泰国国徽
ຕຳລາເສັ້ນຊື່	線性函數
ປະຊາທິປະໄຕແບບມີຜູ້ແທນ	代議民主制
ທະນາຄານພັດທະນາອາຊີ	亞洲開發銀行
ເນີຍແຂງລົກຟອກ	罗克福干酪
ການຂະຫຍາຍໂຕທາງເສດຖະກິດ	经济增长
ເມືອງຫຼວງພະບາງ	琅勃拉邦
ສົມເດັດພະລາຊາທິບະດີເຟລີເປທີ 6 ແຫ່ງແອສະປາຍ	費利佩六世
ວັນນະຍຸດ	聲調
ນ້ຳເຕົ້າຮູ້	豆浆
ການຊົມໃຊ້	消费
ປິໂກແມັດ	皮米
ເພດສຶກສາ	性教育
ກະຊວງ	部
ວັດຖຸດິບ	原材料
ຄອມພິວເຕີຣ໌ຈໍາລອງ	虛擬機器
ລົດພະລັງງານໄຟຟ້າ	电动汽车
ຫີນະຍານ	小乘佛教
Kang Dae Sung	姜大聲
Dassault Mirage 2000	幻影2000战斗机
ເງີນກີບລາວ	寮國基普
ເດຊີແມັດ	分米
ຄວາມຮັ່ງມີ	财富
ເຄື່ອງໝາຍຊາດລາວ	老挝国徽
ພະຍາດໄລມ	莱姆病
ທໍ	Tor
ໂທລະພາບແບບດິຈິຕໍລ໌	数字电视
ຕານ ສ່ວຍ	丹瑞
ປະໂລແວງ	普罗万
ຕຳລາຂັ້ນສາມ	三次方程
Sukhoi Su-30	苏-30战斗机
ໂວນຟຣາມອານຟາ	Wolfram Alpha
ຈັງຫວັດຊົນບຸລີ	春武里府
ສິລະປະປະຍຸກ	应用艺术
ແວງກາແບກເນໂຊວີຍົງ	赤霞珠
‍ໃບອະນຸຍາດຂອງຊອຟຕ໌ແວຣ໌	软件许可证
ເພງຊາດໄທ	泰國國歌
ອາຊີອາຕິກ	蒙古人種
กงสุล	领事
ລົດອັກຄີໄຟ	消防車
ເຟັມໂຕແມັດ	飛米
ການທົດສອບສົມມຸດຕິຖານສະຖິຕິ	假設檢定
ປັດໃຈການຜະລິດ	生产要素
ສຸລິຍະຄະຕິ	阳历
ລັດຖະບານເອເລັກໂຕຣນິກ	电子政务
ວາຈົກ	语态
ຜູ້ຊົມ	閱聽人
ພຶດຊະຄະນິດພື້ນຖານ	初等代數
ແບບຈຳລອງ IS/LM	IS-LM模型
ຟຣີແລນເຊີຣ	自由職業
ຄວາມໄດ້ປຽບທຽບຖານ	比较优势
ພຣະໄຕຣປິດົກ	巴利文大藏經
ຄະລາວາດນິຍົມ	世俗主义
ນັກໂທດການເມືອງ	政治犯
ດອກຈຳປາ	緬梔花
ສະໜາມບິນສາກົນວັດໄຕ	瓦岱國際機場
າເປັນ	安谷
ຄວາມຍືດຍຸ່ນ	弹性 (经济学)
ຂະບວນການຄືນສູ່ເຢລູຊາເລມ	传回耶路撒冷运动
ຈັງຫວັດຊຽງໃໝ່	清邁府
ໂດລາເອມອນ	哆啦A夢
ຈັງຫວັດສົງຂາ	宋卡府
ຊາຍບອກ	賽博格
ຈັງຫວັດສະຕູນ	沙敦府
ອັກສອນໄທ	泰文字
ຈັງຫວັດຊຽງຮາຍ	清萊府
ຈັງຫວັດກະບີ່	甲米府
ຈັງຫວັດປັດຕານີ	北大年府
ຈັງຫວັດລະນອງ	拉廊府
T-80	T-80主戰坦克
ຈັງຫວັດພິຈິດ	披集府
ຈັງຫວັດນະຄອນສະຫວັນ	北攬坡府
ຈັງຫວັດສຸລາດທານີ	素叻府
ຈັງຫວັດລຳປາງ	南邦府
ຈັງຫວັດເພັດຊະບູນ	碧差汶府
ຈັງຫວັດລຳພູນ	南奔府
ຈັງຫວັດຕາດ	桐艾府
ຈັງຫວັດນົນທະບຸລີ	暖武里府
ຈັງຫວັດຍະລາ	惹拉府
ປະທານປະເທດ ແຫ່ງ ສປປ ລາວ	日本內閣總理大臣列表
ໃບລາຍງານຜົນໄດ້ຮັບ	利潤表
ຈັງຫວັດອຳນາດຈະເລີນ	安納乍能府
ຈັງຫວັດອ່າງທອງ	紅統府
ຈັງຫວັດຕັງ	董里府
ຈັງຫວັດພັດທະລຸງ	博他侖府
ຈັງຫວັດພະເຍົາ	帕夭府
ຈັງຫວັດປະຈວບຄີລີຂັນ	班武里府
ຈັງຫວັດອຸໄທທານີ	烏泰他尼府
ຈັງຫວັດແພ່	帕府
ຈັງຫວັດນະຄອນສີທຳມະລາດ	洛坤府
ຈັງຫວັດຊຸມພອນ	春蓬府
ຈັງຫວັດນ່ານ	楠府
ຈັງຫວັດເພັດຊະບຸລີ	佛丕府
ຄຳນາມປະສົມ	合成词
ອູລັດສະຢາ ສະເປີບັນ	乌拉萨雅·斯帕邦德
ອ໋າວຢາຍ	越式旗袍
ທາທາ ຢັງ	塔塔杨
ໂທລະພາບແບບອະນາລ໊ອກ	類比電視
ລາຍຊື່ປະເທດລຽງຕາມພື້ນທີ່	国家面积列表
ຈັງຫວັດໜອງບົວລຳພູ	廊磨喃蒲府
ການເກີນທາງດ້ານເສດຖະກິດ	經濟剩餘
ຈັງຫວັດແມ່ຮ່ອງສອນ	湄宏順府
ລັດວິສາຫະກິດ	国有企业
ຈັງຫວັດນະລາທິວາດ	陶公府
ຈັງຫວັດສະໝຸດປາການ	北欖府
ຈັງຫວັດນະຄອນລາຊະສີມາ	呵叻府
ຈັງຫວັດສຸພັນບຸລີ	素攀武里府
ຈັງຫວັດພັງງາ	攀牙府
ປາຂ່າ(ໂລມາອີຣະວະດີ)	短吻海豚
ແລປົງ	長髮姑娘
ຈັງຫວັດອຸຕະລະດິດ	程逸府
ຈັງຫວັດກຳແພງເພັດ	甘烹碧府
Externality	外部性
ຈັງຫວັດໄຊຍະພູມ	猜也奔府
ຈັງຫວັດເລີຍ	黎府
ຈັງຫວັດການຈະນະບຸລີ	北碧府
ຈັງຫວັດຕາກ	來興府
ຈັງຫວັດພິສະນຸໂລກ	彭世洛府
ດຸນຍະພາບທົ່ວໄປ	一般均衡理论
ບໍລິການລົດເຊົ່າ	汽車租賃
AIDC F-CK-1 Ching-kuo	F-CK-1經國號戰鬥機
ເກໂກລີ ເລີມາກຊານ	格雷戈里·勒马夏尔
ແຂວງສາລະວັນ	沙拉湾省
ຄັງສຳຮອງເງິນຕາຕ່າງປະເທດ	外汇储备
ຜູ້ໂດຍສານ	乘客
ສົມເດັດພະເຈົ້າກຸງທົນບຸລີ	郑信
ໄກສອນ ພົມວິຫານ	凯山·丰威汉
ສຸພານຸວົງ	苏发努冯亲王
ຈັງຫວັດປາຈີນບຸລີ	巴真府
ຈັງຫວັດບຸລີລຳ	武里南府
ຈັງຫວັດຂອນແກ່ນ	坤敬府
ຈັງຫວັດຈັນທະບຸລີ	尖竹汶府
ຈັງຫວັດໜອງຄາຍ	廊開府
ຄົມມະນາຄົມ	运输方式
ຈັງຫວັດສະໝຸດສາຄອນ	龍仔厝府
ຈັງຫວັດສິງບຸລີ	信武里府
ຈັງຫວັດນະຄອນປະຖົມ	佛統府
ແຂວງຜົ້ງສາລີ	丰沙里省
ແຂວງບໍ່ແກ້ວ	博胶省
ແຂວງຈໍາປາສັກ	占巴塞省
ຈັງຫວັດສະເຊີງເຊົາ	北柳府
ຈັງຫວັດມຸກດາຫານ	莫拉限府
ຈັງຫວັດລະຍອງ	羅勇府
ຈັງຫວັດລາຊະບຸລີ	叻丕府
ຈັງຫວັດລົບບຸລີ	華富里府
ຈັງຫວັດສະລະບຸລີ	北標府
ບັນຊີແຫ່ງຊາດ	国民经济核算
ອາຍແກັສແຫຼວ	液化石油气
ສະຫະພາບໂທລະຄົມມະນາຄົມ	国际电信联盟
ເຈົ້າມະຫາຊີວິດສີສະຫວ່າງວົງ	西萨旺·冯
ເຈົ້າສີສະຫວ່າງວັດທະນາ	西萨旺·瓦达纳
ໜູຮັກ ພູມສະຫວັນ	诺哈·冯沙万
ຈັງຫວັດອຸດອນທານີ	烏隆府
ຈັງຫວັດສຸລິນ	素輦府
ຈັງຫວັດສີສະເກດ	四色菊府
ຈັງຫວັດສຸໂຂໄທ	素可泰府
ຈັງຫວັດສະແກ້ວ	沙繳府
ຈັງຫວັດສະກົນນະຄອນ	色軍府
ຈັງຫວັດກາລະສິນ	加拉信府
ເມືອງປາກເຊ	巴色
ລາວ (ຊົນເຜົ່າ)	佬族
ການກໍ່ສ້າງ	建築工地
Henri Mouhot	亨利·穆奥
ຂ່າ (ພືດ)	大高良薑
ແອຣ໌ເອເຊຍ	亞洲航空
ກາລາມະສູດ	卡拉玛经
Seung Ri	勝利 (歌手)
ສົມເດັດພະສັນຕະປາປາຟຣັງຊົວ	方濟各 (教宗)
ຈັງຫວັດສະໝຸດສົງຄາມ	夜功府
ຈັງຫວັດປະທຸມທານີ	巴吞他尼府
ຈັງຫວັດໄຊນາດ	猜納府
ໜີ້ຕ່າງປະເທດ	外债
ແຂວງໄຊຍະບູລີ	沙耶武里省
ໝາກຂີ້ຫູດ	箭叶橙
ແຂວງສະຫວັນນະເຂດ	沙湾拿吉省
ແຂວງຊຽງຂວາງ	川圹省
ແຂວງອຸດົມໄຊ	乌多姆塞省
ຈັງຫວັດນະຄອນນາຍົກ	坤西育府
ເສັ້ນໂຄ້ງບໍ່ຈຳແນກ	无差异曲线
ຈັງຫວັດນະຄອນພະນົມ	那空拍儂府
ຈັງຫວັດມະຫາສາລະຄາມ	瑪哈沙拉堪府
ທ່ານ ບຸນຍັງ ວໍລະຈິດ	本扬·沃拉吉
ພະເຈົ້າບຸເຣງນອງ	莽應龍
ອຳເພີ	泰國次級行政區劃
ຈັງຫວັດພະນະຄອນສີອະຍຸທະຍາ	大城府
ຕຳລາຂັ້ນສີ່	四次方程
ສະໜາມບິນສາກົນເຕິນເຊິນເຍິດ	新山一國際機場
KAI T-50 Golden Eagle	T-50金鷹式高級教練機
ປ່ອງຢ້ຽມປີ 2000	Windows 2000
ການຈັດການລູກຄ້າສໍາພັນ	客户关系管理
Sukhoi Superjet 100	苏霍伊超级喷气机-100
7 ສິ່ງມະຫັດສະຈັນ	古代世界七大奇迹
ໂສມງາມກັບເຈົ້າຊາຍອະສູນ	美女与野兽
Choi Seung Hyun	T.O.P.
Kwon Ji Yong	G-Dragon
ແຂວງຫົວພັນ	华潘省
ແຂວງອັດຕະປື	阿速坡省
ອົງການ ຄວບຄຸມໄພສຸກເສີນລັດຖະບານກາງ	聯邦緊急事務管理署
ຈັງຫວັດຍະໂສທອນ	益梭通府
ແຂວງຄຳມ່ວນ	甘蒙省
ຕຳລາການຜະລິດ	生产函数
ມາລິໂອ້ ເມົາເລີ້	马里奥·毛瑞尔
ແຂວງເຊກອງ	塞公省
ການຄ້າ	贸易
ຈຳນວນອະປົກກະຕິ	無理數
ຈຳປາສັກ	占巴塞 (城鎮)
ຄວາມລົ້ມເຫຼວຂອງຕະຫຼາດ	市场失灵
ກາເຟອຽກລັງ	爱尔兰咖啡
ເພງຊາດລາວ	老挝人民歌
ຈັງຫວັດຮ້ອຍເອັດ	黎逸府
ໝັງກາຕູນ	卡通
ຈັກຂັ້ນ	差分機
ຈັງຫວັດອຸບົນລາຊະທານີ	烏汶府
ເມືອງຫຼວງນໍ້າທາ	琅南塔
ເອັນຣິໂຄ ເລັດຕາ	恩里科·莱塔
ລິງລົມ	懒猴
ລາຍຊື່ປະເທດຮຽງຕາມຈຳນວນປະຊາກອນ	国家人口列表
7 ສິ່່ງມະຫັດສະຈັນຂອງໂລກ	世界新七大奇迹
ຄຳຂວັນປະຈຳຊາດ	国家格言列表
ເສັ້ນເຂົ້າປຸ້ນ	米粉
ຫ້ວຍຊາຍ	會晒
ແຂວງວຽງຈັນ	万象省
ໄຮ້ເພດ	無性戀
ກອງປະຊຸມອາເຊັມ	亚欧会议
ໂຈດຊິງລາງວັນມິເລນຽມ	千禧年大獎難題
ການຜະລິດ, ຕົ້ນທຶນ ແລະ ລາຄາ	生产
ໂຜນ ກິ່ງເພດ	蓬金鐵
ວັນ ລະຫວ່ງປະເທດ ຜູ້ໄຊ້ ມືຂ້າຍ	國際左撇子日
ໄທໃຫຍ່	掸族
ກະເທີຍ	泰國變性女性
ເນີຍແຂງຟ້າແກ່	藍乾酪
ເສດຖະຄະນິດສາດ	数理经济学
ແຂວງຫຼວງພະບາງ	琅勃拉邦省
ເມືອງໄກສອນ ພົມວິຫານ	凯山丰威汉市
ການບິນອະວະກາດ	载人航天
ການບິນລາວ	老撾航空
ພັກປະຊາຊົນປະຕິວັດລາວ	老挝人民革命党
ອາຊີໃຕ້	南亚
ສະໜາມບິນສາກົນເຫຼ້າສຸດ	峴港國際機場
Harvard Mark I	馬克一號
ນາຍົກລັດຖະມົນຕີ ແຫ່ງ ສປປ ລາວ	老挝总理
BM-30 Smerch	BM-30火箭炮
ສະຖານນີທ່ານາແລ້ງ	塔納楞火車站
ສາມຫຼ່ຽມຄຳ	金三角
ຄວາມຈຳກັດ	稀缺性
ກິໂລແມັດ	千米
ທິດສະດີຜູ້ຊົມໃຊ້	消费者理论
ດຸນຍະພາບເສດຖະກິດ	經濟均衡
Halo effect	晕轮效应
ອານາຈັກອະຍຸທະຍາ	大城王国
ຄອມພິວເຕີຣ໌ນ້ອຍຕໍ່ເດັກນ້ອຍຫນຶ່ງຄົນ	OLPC
ປະລິມານເງິນ	货币供给
ຜົນປະໂຫຍດຂອບເຂດ (ເສດຖະສາດ)	边际效用
ເຮັກໂຕແມັດ	粨
McDonnell Douglas F-15E Strike Eagle	F-15E打擊鷹式戰鬥轟炸機
ເຂດພິເສດໄຊສົມບູນ	賽宋奔省
ຄອບ-ດັກລາສ	柯布-道格拉斯生产函数
ເດກາແມັດ	公丈
ເສດຖະສາດສະຫວັດດີການ	福利经济学
ອານາຈັກລ້ານຊ້າງ	南掌
VietJet Air	越捷航空
ກິກາແມັດ	京米
ຮູບສອງແຈ	二角形
ຈຸລາລົງກອນມະຫາວິທະຍາໄລ	朱拉隆功大学
ອານາຈັກສຸໂຂໄທ	素可泰王国
ມະຫາວິທະຍາໄລລັດ	公立大學
ຊີເກມສ໌	东南亚运动会
ພູພຽງບໍລະເວນ	布拉万高原
ຊ່ວຍເຫຼືອ:ເນື້ອໃນ	Help:目录
List of ISO 639-1 codes	ISO 639-1代码表
AgustaWestland Apache	阿帕契AH MK1直昇機
ຊຸດໂຣບົດ	動力服
ແຂວງຫຼວງນໍ້າທາ	琅南塔省
ບ່ອນຈອດລົດເມ	巴士站
ດູ່	紫檀
ເຄື່ອງເຮັດເຂົ້າຈີ່	麵包機
ຈັງຫວັດບຶງການ	汶干府
ທ່າແຂກ	他曲
ຊຽງຕຸງ	景棟
ຮັກຕ່າງເພດ	异性恋
ສີລ	尸羅
ຕົ້ມຍຳ	冬蔭
ເມກາແມັດ	百万米
ក	高棉文
ອານາຈັກລ້ານນາ	蘭納
ພະລັງງານຂັ້ນຕົ້ນ	一次能源
ພະທາດຫຼວງ	塔鑾
ຮູບໜຶ່ງແຈ	一角形
ຊີເກມສ໌ ‍2009	2009年東南亞運動會
ກິເລດ	煩惱 (佛教)
ສະໜາມບິນສາກົນຫຼວງພະບາງ	琅勃拉邦國際機場
ເສືອແຂ້ວດາບ	劍齒虎
ອານາຈັກທົນບຸລີ	吞武里王朝
ການວິໄຈການຕະຫລາດ	市場調查
ຫຼັກເກນ ເຮັກເຊີ=ໂອລີນ	HO定理
ການນັ່ງ	坐
ມະຫາວິທະຍາໄລພາສາຕ່າງປະເທດປັກກິ່ງ	北京外国语大学
ການຄາດຫວັງແບບດັດສົມ	适应性预期
ໂດລາເອມອນ (ໂຕລະຄອນ)	哆啦A夢 (角色)
ເຕເລຊາກ	上載和下載
ສະພາແຫ່ງຊາດ	国民议会 (老挝)
ພິດຕີ້ຄຽວ	光之美少女系列
ອັດຕາດອກເບ້ຍທະນາຄານກາງ	央行貼放利率
ເໝ້ນ	豪豬
ໂຣບົດທະຫານ	軍用機器人
ຈຳນວນປົກກະຕິ	有理数
ເດີ່ນຍົນ	機場
ລະບອບການປົກຄອງ	政体
ອັກສອນທໍາລ້ານນາ	老傣文
ເມືອງ	勐
ພຣະໄຕປິດົກ	三藏
ຄວາມຂາດແຄນທາງເສດຖະກິດ	經濟短缺
ເນື້ອທີ່ໜ້າພຽງ	表面積
ໝວດ:ປະເທດເຢັຽລະມັນ	Category:德国
ໝວດ:ສະຫະລັດອາເມລິກາ	Category:美国
ໝວດ:ປະເທດການາດາ	Category:加拿大
ໝວດ:ສະຫະລາຊະອານາຈັກ	Category:英国
ໝວດ:ປະເທດແອສະປາຍ	Category:西班牙
ໝວດ:ປະເທດຍີ່ປຸ່ນ	Category:日本
ສະໜາມບິນບໍ່ແກ້ວ	會曬機場
ເສດຖະປະຫວັດສາດ	计量经济史
ປະຕູໄຊ	凱旋門 (老撾)
ໝວດ:ປະເທດເກົາຫຼີໃຕ້	Category:大韓民國
ໝວດ:ປະເທດໄທ	Category:泰國
ໝວດ:ປະເທດຫວຽດນາມ	Category:越南
ໝວດ:ສັດລ້ຽງລູກດ້ວຍນ້ຳນົມ	Category:哺乳類
ໝວດ:ພືດ	Category:植物
ໝວດ:ວັດຖຸວິທະຍາ	Category:物理学
ໝວດ:ຊີວະສາດ	Category:生物学
ໝວດ:ປະຫວັດສາດ	Category:历史
ໝວດ:ພູມສາດ	Category:地理
ໝວດ:ສັງຄົມ	Category:社会
ໝວດ:ສາສະໜາ	Category:宗教
ໝວດ:ກິລາ	Category:体育
ໝວດ:ສາດ	Category:科学
ໝວດ:ສະຫະປະຊາຊາດ	Category:联合国
ໝວດ:ຮູບເງົາ	Category:电影
ໝວດ:ມໍລະດົກໂລກ	Category:世界遗产
ໝວດ:ໂລກ	Category:地球
ໝວດ:ຂໍ້ມູນຂ່າວສານ	Category:資訊
ລາຍໄດ້	收入
ໂມເດລຄວາມດຶງດູດການຄ້າ	地心引力模型
ຍອດຄວາມຕ້ອງການ	總需求
ອັກສອນລາວ	寮文字
ໝວດ:ນິເວດສາດ	Category:生態學
ໝວດ:ພຸດທະສາສະໜາ	Category:佛教
ໝວດ:ຄຣິສຕະສາດສະໜາ	Category:基督教
ໝວດ:ສາສະໜາອິສະລາມ	Category:伊斯兰教
ລວມຕຳລາຄະນິດສາດ	函数列表
ການຂາຍເມຍໃນປະເທດອັງກິດ	販妻
ໂພຊະນາການ	营养学
ມະຫາວິທະຍາໄລເສສວນ	四川大学
ແຂວງບໍລິຄຳໄຊ	博利坎赛省
ສິນຄ້າ (ທຸລະກິດ)	产品
ລັດອິດສະລາມອີຣັກແລະເຣເວນທ໌	伊斯兰国
ລື້	傣仂
ການທ່ອງທ່ຽວໃນປະເທດລາວ	寮國觀光
ວັດຊຽງທອງ	香通寺
ຄ່າສະເຫຼ່ຍ	平均数
ປຸຖຸຊົນ	結 (佛教)
ການຈັດການ	管理学
ໝວດ:ວັດທະນະທຳ	Category:文化
ໝວດ:ຄວາມຮູ້	Category:知識
ໝວດ:ທະວີບ	Category:大洲
ໝວດ:ທໍລະນີສາດ	Category:地质学
ໝວດ:ພາສາ: ເຮືອບິນ	Category:航空器
ຮູດີສ	胡塞武装组织
ລະດູຝົນ	雨季
ນະເດດ ຄູກິມິຢະ	纳得克·库吉米亚
ເບຍລາວ	Beerlao
ບັນຫາການເຮັດໃຫ້ເກີດຜົນປະໂຫຍດສູງສຸດ	效用最大化
ຕົ້ມດອກໄຂ່	蛋花湯
ເລຂາທິການໃຫຍ່ຄະນະບໍລິຫານງານສູນກາງພັກປະຊາຊົນປະຕິວັດລາວ	老挝人民革命党中央委员会总书记
ວົງຍ່ອຍສິງທະເລ	海獅
ໝວດ:ນັກສະແດງ	Category:演员
ແມ່ແບບ:Tl	Template:Tl
ແມ່ແບບ:Wikipedialang	Template:Wikipedialang
ໝວດ:ປະເທດ	Category:国家
ໝວດ:ເສດຖະສາດ	Category:经济学
ວິກິພີເດຍ:ຜູ້ບໍລິຫານ	Wikipedia:管理员
ໝວດ:ອາຊີບ	Category:職業
ໝວດ:ເວລາ	Category:时间
ໝວດ:ທຳມະຊາດ	Category:自然
ໝວດ:ອິນເຕີເນັດ	Category:互联网
ໝວດ:ວັດສະດຸ	Category:材料
ໝວດ:ແພດສາດ	Category:医学
ໝວດ:ການເມືອງ	Category:政治
ໝວດ:ການສຶກສາ	Category:教育
ໝວດ:ສິລະປະ	Category:艺术
ໝວດ:ຊອຟແວ	Category:软件
ແມ່ແບບ:Bot	Template:Bot
ປະເທດການາດາ	加拿大
ໝວດ:ບົດຄວາມດີເດັ່ນ	Category:特色条目
ເກມຄອມພິວເຕີ	电脑游戏
ແມ່ແບບ:Flagicon	Template:Flagicon
ໝວດ:ເອີລົບ	Category:欧洲
ແມ່ແບບ:ຄູ່ມືການໃຊ້ງານ	Template:Documentation
ໝວດ:ຜູ້ໃຊ້ແບ່ງຕາມພາສາ	Category:用户语言
ວິກິພີເດຍ:ຫ້າຫຼັກການ	Wikipedia:五大支柱
ໝວດ:ແນວປະຕິບັດວິກິພີເດຍ	Category:维基百科指导方针
ວິກິພີເດຍ:ກ່ອງຜູ້ໃຊ້	Wikipedia:用戶框
ຊໂງ ໃຈ-ກກິ	成在基
ທຸລະກິດ	企业
ແມ່ແບບ:Softredirect	Template:軟重定向
ແມ່ແບບ:ລຶບ	Template:Delete
ໝວດ:ພາສາ: ເຕັກໂນໂລຊີ	Category:技术
ສວນເສືອສີລາຊາ	是拉差龍虎園
ໝວດ:ພັນທຸສາດ	Category:遗传学
ໝວດ:ພາສາ	Category:语言
ໝວດ:ໄວຍາກອນ	Category:语法
ໝວດ:ປະຕິທິນ	Category:曆法
ໝວດ:ວິກິພີເດຍ	Category:维基百科
ວິກິພີເດຍ:ຂໍ້ປະຕິເສດຄວາມຮັບຜິດຊອບ	Wikipedia:免责声明
ໝວດ:Pages with broken file links	Category:缺少文件的页面
ແມ່ແບບ:Navbox	Template:Navbox
ໜູຖົງ	袋鼠
ໝວດ:ພາສາໝາຍ	Category:标记语言
ບັນຫາການຈຳກັດລາຍຈ່າຍໃຫ້ຕໍ່າສຸດ	支出最小化
ການບໍລິຫານ	工商管理
ໝວດ:ການບຳລຸງຮັກສາວິກິພີເດຍ	Category:维基百科维护
ໝວດ:ຄອມພິວເຕີ	Category:计算
ໝວດ:ແມ່ແບບທຸງ	Category:旗帜模板
ແມ່ແບບ:!-	Template:!-
ແມ່ແບບ:Tnavbar	Template:Navbar
ແມ່ແບບ:Fontie	Template:Unicode
ແມ່ແບບ:Clear	Template:Clear
ແມ່ແບບ:Col-begin	Template:Col-begin
ແມ່ແບບ:Col-end	Template:Col-end
ໝວດ:ອາຟຣິກກາ	Category:非洲
ໝວດ:ປຶ້ມ	Category:書籍
ແມ່ແບບ:ບາເບລ	Template:Babel
ແມ່ແບບ:Commons	Template:Commons
ແມ່ແບບ:Reflist	Template:Reflist
ວິກິພີເດຍ:ການອ້າງອີງແຫຼ່ງທີ່ມາ	Wikipedia:列明来源
ວິກິພີເດຍ:ຊອກຫາ	Help:搜索
ແມ່ແບບ:Stub	Template:Stub
ແມ່ແບບ:User eo-1	Template:User eo-1
ແມ່ແບບ:User de	Template:User de
ແມ່ແບບ:User de-1	Template:User de-1
ແມ່ແບບ:User es	Template:User es
ແມ່ແບບ:User de-3	Template:User de-3
ແມ່ແບບ:User en-3	Template:User en-3
ແມ່ແບບ:User en-1	Template:User en-1
ແມ່ແບບ:User en-2	Template:User en-2
ແມ່ແບບ:User en-4	Template:User en-4
ແມ່ແບບ:User en	Template:User en
ແມ່ແບບ:User de-2	Template:User de-2
ແມ່ແບບ:User fr-1	Template:User fr-1
ແມ່ແບບ:User ja-4	Template:User ja-4
ແມ່ແບບ:User ja	Template:User ja
ແມ່ແບບ:User ja-1	Template:User ja-1
ແມ່ແບບ:User fr	Template:User fr
ໝວດ:ອາຊີ	Category:亚洲
ແມ່ແບບ:Esoteric	Template:Esoteric
ໝວດ:ປະເທດມາເລເຊຍ	Category:马来西亚
ແມ່ແບບ:Lang-ja	Template:Lang-ja
ແມ່ແບບ:Mod	Template:Mod
ແມ່ແບບ:User es-2	Template:User es-2
ແມ່ແບບ:ຍິນດີຕ້ອນຮັບ	Template:Welcome
ແມ່ແບບ:Sisterprojects	Template:Wikipediasister
ໝວດ:ດວງຈັນ	Category:月球
ແມ່ແບບ:USA	Template:USA
ແມ່ແບບ:Country data Thailand	Template:Country data Thailand
ແມ່ແບບ:Country data Indonesia	Template:Country data Indonesia
ແມ່ແບບ:Country data Cambodia	Template:Country data Cambodia
ໝວດ:ພາສາສາດ	Category:语言学
ແມ່ແບບ:ດັດແກ້	Template:Edit
ແມ່ແບບ:Click	Template:Click
ໝວດ:User fr-1	Category:Fr-1 使用者
ແມ່ແບບ:Country showdata	Template:Country showdata
ແມ່ແບບ:Image label	Template:Image label
ແມ່ແບບ:Country data Brunei	Template:Country data Brunei
ໝວດ:ແມວ	Category:貓
ໝວດ:ນາຊີ	Category:納粹黨
ແມ່ແບບ:Sidebar	Template:Sidebar
ແມ່ແບບ:Country data France	Template:Country data France
ແມ່ແບບ:ປັບປຸງການອ້າງອີງ	Template:Refimprove
ແມ່ແບບ:ກ່ອງຜູ້ໃຊ້ລຸ່ມ	Template:Userboxbottom
ແມ່ແບບ:ຂໍ້ມູນປະເທດ	Template:國家基礎資訊
ແມ່ແບບ:Country data Laos	Template:Country data Laos
ແມ່ແບບ:Px	Template:Px
ແມ່ແບບ:Documentation/docname	Template:Documentation/docname
ແມ່ແບບ:ກ່ອງຜູ້ໃຊ້ເທິງ	Template:Userboxtop
ແມ່ແບບ:Infobox Political party	Template:Infobox Political Party
ແມ່ແບບ:ກ່ອງຂ້ໍມູນ ປະຊາຄົມອາຊຽນ	Template:Navbox with columns
ແມ່ແບບ:ກ່ອງຂໍ້ມູນ ນັກມວຢ	Template:Infobox Boxer
ແມ່ແບບ:Infobox ບໍລິສັດ	Template:Infobox Company
ແມ່ແບບ:Country data Vietnam	Template:Country data Vietnam
ແມ່ແບບ:ປ້າຍບົດຄວາມດີເດັ່ນ	Template:Featured article
ແມ່ແບບ:Infobox ຈັກກະພັດໂຣມັນ	Template:Infobox Monarch
ໝວດ:ປາລີ	Category:巴黎
ໝວດ:User en	Category:En 使用者
ໝວດ:User zh	Category:Zh 使用者
ໝວດ:User en-2	Category:En-2 使用者
ແມ່ແບບ:Infobox	Template:Infobox
ແມ່ແບບ:User zh	Template:User zh
ໝວດ:ອັກສອນ	Category:字母文字
ແມ່ແບບ:Template other	Template:Template other
ໝວດ:ພາສາ: ບິນ	Category:航空
ແມ່ແບບ:Country data	Template:Country data
ໝວດ:ອາຫານແລະເຄື່ອງດື່ມ	Category:飲食
ແມ່ແບບ:Pp-template	Template:Pp-template
ແມ່ແບບ:Infobox City Poland	Template:Infobox Polska
ແມ່ແບບ:ວິກິວັດຈະນານຸກົມ	Template:Wiktionary
ແມ່ແບບ:Languageicon	Template:Language icon
ແມ່ແບບ:User ru	Template:User ru
ໝວດ:ອະເມລິກາ	Category:美洲
ໝວດ:ເຂົ້າຈີ່	Category:麵包
ແມ່ແບບ:ກັບສາງ	Template:Archive box
ວິກິພີເດຍ:ຂ້ອຄວາມຂວງ GNU Free Documentation License	Wikipedia:GNU自由文档许可证文本
ແມ່ແບບ:Sisterlinks	Template:Sister project links
ແມ່ແບບ:Border	Template:Border
ແມ່ແບບ:Fmbox	Template:Fmbox
ໝວດ:ພາສາທະຫານ	Category:军事
ແມ່ແບບ:Country data Philippines	Template:Country data Philippines
ແມ່ແບບ:Country data Malaysia	Template:Country data Malaysia
ແມ່ແບບ:Country data Myanmar	Template:Country data Myanmar
ແມ່ແບບ:Increase	Template:Increase
ແມ່ແບບ:Image label end	Template:Image label end
ແມ່ແບບ:Tlx	Template:Tlx
ແມ່ແບບ:CAN	Template:CAN
ໝວດ:ຄຳສັບ	Category:詞彙
ແມ່ແບບ:Lang-my	Template:Lang-my
ໝວດ:ຄຳ	Category:词语
ແມ່ແບບ:Country flag2	Template:Flag/core
ແມ່ແບບ:ກ່ອງຜູ້ໃຊ້ຄັ່ນ	Template:Userboxbreak
ໝວດ:ແຫຼ່ງນ້ຳ	Category:水體
ແມ່ແບບ:ຕ້ອງການອ້າງອີງ	Template:Unreferenced
ໝວດ:ສະໜາມບິນໃນຫວຽດນາມ	Category:越南機場
ແມ່ແບບ:Image label small	Template:Image label small
ໝວດ:ພະມະຫາກະສັດອັງກິດ	Category:英格蘭君主
ແມ່ແບບ:Infobox Language/pronunciation	Template:Infobox Language/pronunciation
ໝວດ:ສານອາຫານ	Category:营养物质
ແມ່ແບບ:SUL Box	Template:SUL Box
ໝວດ:ພາຫະນະການທະຫານ	Category:军用车辆
ໝວດ:ວິທະຍາສາດສຸຂະພາບ	Category:健康科學
ໝວດ:ໂທລະສັບມືຖື	Category:行動電話
ໝວດ:ພາສາ: ເຮືອບິນທະຫານ	Category:军用飞机
ແມ່ແບບ:Lang-en	Template:Lang-en
ໝວດ:ເນີຍແຂງ	Category:乾酪
ແມ່ແບບ:Lower	Template:Lower
ແມ່ແບບ:Politicsboxend	Template:Politicsboxend
ແມ່ແບບ:UK	Template:GBR
ໝວດ:ສະຖາປັດຕະຍະກຳ	Category:建筑
ໝວດ:ລົດໄຟ	Category:鐵路
ແມ່ແບບ:Interwiki	Template:InterWiki
ແມ່ແບບ:MainPageInterwikis	Template:Mainpage-iw
ໝວດ:ໂພຊະນາການ	Category:营养学
ແມ່ແບບ:ບໍ່ເປັນກາງ	Template:POV
ແມ່ແບບ:Dmoz	Template:Dmoz
ໝວດ:ເມືອງໃນແຂວງເກແບັກ	Category:魁北克省城市
ໝວດ:User eo	Category:Eo 使用者
ໝວດ:User fr	Category:Fr 使用者
ໝວດ:User ja	Category:Ja 使用者
ໝວດ:User th	Category:Th 使用者
ໝວດ:User ja-2	Category:Ja-2 使用者
ໝວດ:User fr-N	Category:Fr 母語使用者
ໝວດ:ແມ່ນ້ຳອາມາຊົນ	Category:亞馬遜河
ໝວດ:ແຂວງກວາງບິນ	Category:廣平省
ໝວດ:User en-3	Category:En-3 使用者
ໝວດ:User en-N	Category:En 母语使用者
ໝວດ:User eo-1	Category:Eo-1 使用者
ໝວດ:User es	Category:Es 使用者
ແມ່ແບບ:EU	Template:欧盟
ໝວດ:User es-2	Category:Es-2 使用者
ໝວດ:User es-3	Category:Es-3 使用者
ນິກາຍອັງກະລິກັງ	聖公宗
ແມ່ແບບ:Country data United Kingdom	Template:Country data United Kingdom
ແມ່ແບບ:Cite encyclopedia	Template:Cite encyclopedia
ໝວດ:ສິລະປິນ	Category:艺术家
ໝວດ:ເວັບໄຊຕ໌	Category:網站
ໝວດ:User ko	Category:Ko 使用者
ໝວດ:User ko-1	Category:Ko-1 使用者
ແມ່ແບບ:ແປ	Template:Translating
ໝວດ:ຫົວໜ່ວຍການປົກຄອງ	Category:行政区划
ໝວດ:ພາສາວັນນະຍຸດ	Category:聲調語言
ໝວດ:ວັນນະຍຸດ	Category:聲調
ໝວດ:ເມືອງໃນປະເທດຝະລັ່ງ	Category:法國城市
ແມ່ແບບ:Wikivoyage	Template:Wikivoyage-inline
ໝວດ:ວັນນະຄະດີເດັກນ້ອຍ	Category:儿童文学
ແມ່ແບບ:ພາສາທາງການຂອງສະຫະປະຊາຊາດ	Template:聯合國官方語言
ໝວດ:ອຸບປະກອນເຂົ້າອອກ	Category:電腦輸入裝置
ແມ່ແບບ:ຮູບຫຼາຍແຈ	Template:多邊形
ໝວດ:User lo	Category:Lo 使用者
ໝວດ:User lo-1	Category:Lo-1 使用者
ໝວດ:ທະເລ	Category:海洋
ໝວດ:ປະເທດອັງກິດ	Category:英格蘭
ໝວດ:ນັກສະແດງແບ່ງຕາມສັນຊາດ	Category:各國演員
ໝວດ:ລະບົບສຸລິຍະ	Category:太阳系
ຊ່ວຍເຫຼືອ:ຫ້ອງສາງ	Wikipedia:如何將討論頁存檔
ແມ່ແບບ:ຮູບແບບແຫ່ງລັດ	Template:Forms of government
ໝວດ:ອຸດສາຫະກຳ	Category:工业
ໝວດ:ນ້ຳ	Category:水
ໝວດ:ສັດກິນຊີ້ນ	Category:食肉目
ໝວດ:ແຂວງ	Category:老挝省份
ແມ່ແບບ:ແຂວງຂອງລາວ	Template:Laos
ໝວດ:ເຮລີກົບແຕ	Category:直升机
ໝວດ:ນາຍົກລັດຖະມົນຕີ	Category:总理
ໝວດ:ນັກຮ້ອງການາດາ	Category:加拿大歌手
ແມ່ແບບ:User cs	Template:User cs
ແມ່ແບບ:User es-3	Template:User es-3
ໝວດ:User ru	Category:Ru 使用者
ໝວດ:User ru-3	Category:Ru-3 使用者
ໝວດ:User th-3	Category:Th-3 使用者
ໝວດ:User th-N	Category:Th 母語使用者
ແມ່ແບບ:Lang	Template:Lang
ໝວດ:ສາຂາວິຊາວິທະຍາສາດ	Category:科學學科
ໝວດ:ຊາວພະມ້າ	Category:缅甸人
ໝວດ:ມະນຸດ	Category:人类
ແມ່ແບບ:ບົດຄວາມຫຼັກ	Template:Main
ໝວດ:ວັນນະຄະດີແບ່ງຕາມປະເພດ	Category:各類型文學
ແມ່ແບບ:ໃຜກ່າວ	Template:Who
ໝວດ:ວົງເສືອແລະແມວ	Category:貓科
ໝວດ:ແມ່ນ້ຳແບ່ງຕາມປະເທດ	Category:各国河流
ໝວດ:ສະກຸນເງິນ	Category:通貨
ແມ່ແບບ:Infobox Language/family-color	Template:Infobox Language/family-color
ໝວດ:ແມ່ນ້ຳ	Category:河流
ໝວດ:ແມ່ນ້ຳໃນປະເທດບະເລຊິນ	Category:巴西河流
ໝວດ:ນັກຮ້ອງແບ່ງຕາມສັນຊາດ	Category:各國歌手
ໝວດ:ນ້ຳມັນ	Category:油
ໝວດ:ນັກຮ້ອງໄທ	Category:泰國歌手
ໝວດ:User zh-1	Category:Zh-1 使用者
ໝວດ:User zh-3	Category:Zh-3 使用者
ໝວດ:ພະມະຫາກະສັດໄທ	Category:泰国国王
ໝວດ:ຊັບສິນທາງປັນຍາ	Category:知识产权
ໝວດ:ນັກສະແດງຈີນ	Category:中国演员
ໝວດ:ນັກສະແດງໄທ	Category:泰国演员
ໝວດ:ປະທານປະເທດລາວ	Category:老挝国家主席
ໝວດ:ຂໍ້ມູນວິກິພີເດຍເບື້ອງຕົ້ນ	Category:维基百科基本信息
ໝວດ:ຈັງຫວັດໃນປະເທດໄທ	Category:泰國府級行政區
ໝວດ:ຊາວໄທ	Category:泰國人
ໝວດ:ນັກຮ້ອງຈີນ	Category:中国歌手
ໝວດ:ນິກາຍໃນສາສະໜາຄິດ	Category:基督教教會與教派
ໝວດ:ແມ່ນ້ຳໃນປະເທດໂກລົມບີ	Category:哥伦比亚河流
ໝວດ:ນາຍົກລັດຖະມົນຕີແບ່ງຕາມປະເທດ	Category:各国总理
ໝວດ:ປະເທດລາວ	Category:寮國
ໝວດ:ແມ່ແບບການລຶບ	Category:刪除模板
ໝວດ:ຜັກ	Category:蔬菜
ໝວດ:ໝາກໄມ້	Category:水果
ໝວດ:ພາສາຄອມພິວເຕີ	Category:计算机语言
ໝວດ:ພາສາລາແຕັງ	Category:拉丁语
ໝວດ:ມໍລະດົກໂລກໃນປະເທດຝະລັ່ງ	Category:法国世界遗产
ໝວດ:ມະຫາສະໝຸດ	Category:远洋
ໝວດ:ມະນຸດສາດ	Category:人类学
ໝວດ:ລົດສະນິຍົມທາງເພດ	Category:性取向
ໝວດ:ລະບົບປະຕິບັດການ	Category:操作系统
ໝວດ:ລະດູ	Category:季節
ໝວດ:ແຮ່ທາດສາດ	Category:礦物學
ໝວດ:ວິວັດທະນາການ	Category:演化
ໝວດ:ວິທີໃຊ້ວິກິພີເດຍ	Category:维基百科指南
ໝວດ:ສັດ	Category:动物
ໝວດ:ສັດທະສາດ	Category:語音學
ໝວດ:ສະເຕໂລອິດ	Category:甾族化合物
ໝວດ:ອົງການລະຫວ່າງລັດຖະບານ	Category:政府間組織
ໝວດ:ປະໂລເຕອິນ	Category:蛋白质
ໝວດ:ເຄື່ອງໝາຍວັກ	Category:標點符號
ໝວດ:ເພງ	Category:歌曲
ໝວດ:ເພດສຶກສາ	Category:性教育
ໝວດ:ນະຄອນຫຼວງ	Category:首都
ໝວດ:ເມືອງໃນລາວ	Category:老挝城市
ໝວດ:ວຽງຈັນ	Category:永珍
ໝວດ:ເອດສ໌	Category:HIV/AIDS
ໝວດ:ອາຊີຕາເວັນອອກສຽງໃຕ້	Category:东南亚
ໝວດ:ໄດໂນເສົາ	Category:恐龙
ໝວດ:User th-4	Category:Th-4 使用者
ໝວດ:ກຸ່ມພາສາໂລມັງ	Category:罗曼语族
ໝວດ:ພາສາ: ການຂົນສົ່ງ	Category:交通
ໝວດ:ການຟ້ອນລຳ	Category:舞蹈
ໝວດ:ກະລູຊິດ	Category:糖类
ໝວດ:ປະເພດຄຳເວົ້າ	Category:詞性
ໝວດ:ນັກເສດຖະສາດ	Category:经济学家
ແມ່ແບບ:Flagcountry	Template:Flagcountry
ແມ່ແບບ:ກ່ອງຂໍ້ມູນ ພາສາ	Template:Infobox Language
ໝວດ:ພືດທີ່ກິນໄດ້	Category:可以食用的植物
ໝວດ:ກາເຟ	Category:咖啡
ໝວດ:ພາສາອິຕາລີ	Category:意大利语
ໝວດ:ພາສາແອສະປາໂຍນ	Category:西班牙语
ໝວດ:ພາສາໃນປະເທດໄທ	Category:泰國語言
ໝວດ:ແຊນ	Category:基因
ໝວດ:ຍານພາຫະນະ	Category:交通工具
ໝວດ:ລົດ	Category:汽车
ໝວດ:Tanks	Category:坦克
ແມ່ແບບ:ລາຍການຫ້ອງສາງ	Template:Archive list
ໝວດ:ພາສາໃນປະເທດຫວຽດນາມ	Category:越南語言
ໝວດ:ອາຫານຝະລັ່ງ	Category:法國飲食
ການບໍລິການ	服务
ໝວດ:ສະໄໝກາງ	Category:中世紀
ແມ່ແບບ:Wikia	Template:Wikia
ໝວດ:ສຸຂະພາບ	Category:健康
ແມ່ແບບ:ທຸງຊາດ	Template:Flag
ແມ່ແບບ:Country data Quebec	Template:Country data Quebec
ແມ່ແບບ:Country data Singapore	Template:Country data Singapore
ການບໍລິຫານທີມງານ	團隊管理
ທະນາຄານອິນດູຈີນ (ສະຫະພັນອິນດູຈີນຝະລັ່ງ)	东方汇理银行
ຢູຊາກີ	颱風天兔
ແມ່ແບບ:G8	Template:G8
ແມ່ແບບ:ຄູ່ມື	Template:Style
ແມ່ແບບ:User wa	Template:User wa
ແມ່ແບບ:User lo-2	Template:User lo-2
ໝວດ:ເສດຖະສາດມະຫາພາກ	Category:宏观经济学
ໝວດ:ແຂວງເກແບັກ	Category:魁北克
ໝວດ:ພາສາປືນໃຫຍ່	Category:火炮
ໝວດ:ຂົວ	Category:橋樑
ໝວດ:ເອແດມບວກ	Category:爱丁堡
ໝວດ:ຮາດແວ	Category:電腦硬體
ໝວດ:ພະລັງງານ	Category:能量
ໝວດ:ລິກຂະສິດ	Category:版权
ໝວດ:ພາສາຝະລັ່ງ	Category:法语
ໝວດ:ໝວດໄວຍາກອນ	Category:語法範疇
ໝວດ:ວາຈົກ	Category:語態
ແມ່ແບບ:Lts	Template:Lts
ໝວດ:ສຽງມະນຸດ	Category:人聲
ໝວດ:ຫຼັກ້ຮົບ tanks	Category:主戰坦克
ຊ່ວຍເຫຼືອ:ເຈ້ຍກ່າຍ	Wikipedia:備忘單
ໝວດ:ເຮືອບິນຄູຝຶກທະຫານ	Category:軍用教練機
ໝວດ:ຫຸ່ນຍົນສາດ	Category:机器人学
ໝວດ:ໂຣບົດ	Category:机器人
ໝວດ:ພາສາລູມານີ	Category:罗马尼亚语
ໝວດ:ຕາກດີກະລາດາ	Category:缓步动物门
ໝວດ:ສັດມີແກນສັນຫຼັງ	Category:脊索動物門
ໝວດ:ມົງເລອານ	Category:蒙特婁
ໝວດ:ໂທລະສັບ	Category:电话
ໝວດ:ໜ່ວຍນັບເວລາ	Category:时间单位
ໝວດ:ວິທະຍາສາດປະຍຸກ	Category:应用科学
ໝວດ:ທາດ	Category:塔
ແມ່ແບບ:Image label begin	Template:Image label begin
ໝວດ:ພາສາກໍາລັງທາງອາກາດ	Category:空軍
ໝວດ:ໂຣບົດທະຫານ	Category:軍用機器人
ແມ່ແບບ:Infobox Language/statesregion	Template:Infobox Language/statesregion
ໝວດ:User lo-0	Category:Lo-0 使用者
ແມ່ແບບ:Infobox Language/IPA notice	Template:Infobox Language/IPA notice
ໝວດ:User en-1	Category:En-1 使用者
ໝວດ:ນັກສະແດງອາເມລິກັນ	Category:美国演员
ໝວດ:ບົດຄວາມຕ້ອງຂະຫຍາຍ	Category:扩充中的条目
ແມ່ແບບ:Infobox Language/official	Template:Infobox Language/official
ແມ່ແບບ:Infobox Language/quilt	Template:Infobox language/quilt
ປະເທດໂມນດາວີ	摩尔达维亚公国
ແມ່ແບບ:ກ່ອງຂໍ້ມູນ ແຂວງໃນປະເທດໄທ	Template:Infobox Thailand province
ແມ່ແບບ:Infobox file format	Template:Infobox file format
ວິກິພີເດຍ:ຄຳຖາມມີເລື້ອຍ ກ່ຽວກັບ ການປະກອບສ່ວນ	Wikipedia:参与者常见问题解答
ວິກິພີເດຍ:ຄຳຖາມມີເລື້ອຍ ກ່ຽວກັບ ການດັດແປງ	Wikipedia:编辑者常见问题解答
ແມ່ແບບ:ຂະຫຍາຍ	Template:Expand
ວິກິພີເດຍ:ຄຳຖາມມີເລື້ອຍ ຂອງ ຜູ້ອ່ານ	Wikipedia:读者常见问题解答
ແມ່ແບບ:Infobox Language/genetic2	Template:Infobox language/genetic
ແມ່ແບບ:ເສດຖະສາດມະຫາພາກ	Template:Macroeconomics
ເຫດຍົນຕົກທີ່ປາກເຊ	寮國航空301號班機空難
ຮຳຊະ	法蒂玛之手
ພິເສດ:ການດັດແກ້ຫຼ້າສຸດ	Special:最近更改
Module:Coordinates	模块:Coordinates
ສາຍການບິນມາເລເຊຍທຽ່ວບິນMH370	马来西亚航空370号班机空难
ອຸປະຕິເຫດເຮືອເຊໂວລຫລົ່ມ	世越号沉没事故
