Naakaii Łizhiní Bikéyah	非洲
Binaʼadaałtzózí Dinéʼiʼ Bikéyah	日本
Bitsiighaʼ Łichííʼí Bikéyah	爱尔兰共和国
Hángewii	匈牙利
Dibé Diníí Bikéyah	西班牙
Wááshindoon Bikéyah Ałhidadiidzooígíí	美国
Bélgii Bikéyah	比利时
Látsębooʼ	卢森堡
Yágháhookáán	宇宙
Nahasdzáán	地球
Nahoditsʼǫʼłání	芬兰
Déinish Dineʼé Bikéyah	丹麦
Póolish Dineʼé Bikéyah	波兰
Łitʼoowę́ęya	立陶宛
Ídelii	意大利
Swis Bikéyah	瑞士
Óóswiya	奥地利
Gwíík Dineʼé Bikéyah	希腊
Tʼóok Bikéyah	土耳其
Béésh Bichʼahníí Bikéyah	欧洲
(*"asia")	亚洲
Shádiʼááhjí kéyah yistinígíí	南极洲
Kéyah Wóyahgo Siʼánígíí	荷兰
Béésh bee akʼeʼelchíhí tʼáá bí nitsékeesígíí	電子計算機
Hastiin alą́ąjįʼ dahsidáhígíí Barack Obama	贝拉克·奥巴马
Táłtłʼááh Chʼosh Bitooh (Kéyah Dah Siʼánígíí)	乌拉圭
Bilasáana	苹果
Méhigo	墨西哥
Akééháshį́į́h Hahoodzo	加利福尼亚州
Máaz	火星
Kénya	肯尼亚
Iithiyópya	埃塞俄比亚
Gáana	加纳
Náshdóítsoh bitsiijįʼ daditłʼooígíí	狮
Dáághahii Dinéʼiʼ Bikéyah	法国
Łééchąąʼí	犬
Tótaʼ Dinéʼiʼ Bikéyah	英国
Mósí	猫
Dáághahii bizaad	法语
Łóóʼ	鱼
Bwazííl	巴西
Biʼééʼ Łichííʼí Bikéyah	俄罗斯
Łóóʼtsoh dóó Tééh hóyáanii	鯨目
Élábéemah Hahoodzo	亚拉巴马州
Béésh Bichʼahii Bikéyah	德国
Bééshbichʼahii bizaad	德语
Tin Bikéyah	冰岛
Ééstii Bikéyah	爱沙尼亚
Séetin	土星
Didzéchííʼ	樱
Chidí naatʼaʼí	固定翼飛機
Hastiin alą́ąjįʼ dahsidáhígíí George W. Bush	乔治·沃克·布什
Létbiiya	拉脫維亞
Yóókwein	乌克兰
Chek Bikéyah	捷克
Słóbaʼ Bikéyah	斯洛伐克
Słobíín Bikéyah	斯洛文尼亚
Wooméiniya	羅馬尼亞
Bálgaa Bikéyah	保加利亚
Dziłigaii Bikéyah	阿尔巴尼亚
Haʼaʼaahjí Hakʼaz Dineʼé Bikéyah	格陵兰
Kwóóʼad Bikéyah	克罗地亚
Bosna dóó Hetsog Bikéyah	波斯尼亚和黑塞哥维那
Azééwii Bikéyah	阿塞拜疆
Andówa	安道尔
Béésh Łichíiʼii Bikéyah	賽普勒斯
Jóojah (Kéyah)	格鲁吉亚
Kʼazah Bikéyah	哈萨克斯坦
Dziłizhin Bikéyah	蒙特內哥羅
Bádikin Sídii	梵蒂冈
San Mawínoo Bikéyah	圣马力诺
Kyóoba	古巴
Hashkʼaan Bikéyah	巴巴多斯
Indoníízha	印度尼西亚
Tʼóok bizaad	土耳其语
Kéyah Naakai Łizhinii Bikéyah Shádiʼááhjí Siʼánígíí	南非
Aljííya	阿尔及利亚
Ózbeʼ Bikéyah	乌兹别克斯坦
Tó	水
Níłchʼi naalkidí	电视
Chíilii	智利
Doodaatsaahii (Jíísas)	耶稣
Mókiwii	水星
Ákáʼátʼįįł (béésh ntsékeesígíí álʼíní)	蘋果公司
Biinis	金星
Jíbitoo	木星
Yoowéinis	天王星
Néʼtoon	海王星
Sį́ʼgaboo	新加坡
Tłóotoo	冥王星
Łííhtensain	列支敦斯登
Dágháilchįįh	阿道夫·希特勒
Naaltsoos biniiʼ	Facebook
Naaki góneʼ yéigo daʼahijoogą́ą́ʼ	第二次世界大战
Ałhíʼayiiltááh	数学
Aooméénii Bikéyah	亞美尼亞
Ooljééʼ	月球
Nahatʼeʼiitsoh Bikéyah	澳大利亚
Béésh Łigaii Bikéyah	阿根廷
Kolíya Bikéyah Náhookǫsjí Siʼánígíí	朝鲜民主主义人民共和国
Naayééʼ	恐龙
Bilasáana bitseeʼ nineezígíí	梨
Naturalis Historia of Pliny the Elder	博物志 (老普林尼)
Encyclopædia Britannica	大英百科全书
Tó yaʼnidaʼaazgééd	高架渠
Chʼil łitsooí díkʼǫ́zhígíí	柠檬
Hashkʼaan (łitsooígíí)	香蕉
Sǫʼ	恒星
Jóhonaaʼéí	太阳
Háájiʼjin	氢
Níłchʼi Ászólí	氦
Haʼaʼaahjí Tíímow	东帝汶
Séwes	穀神星
Haʼooméya	妊神星
Maakiimaakii	鸟神星
Ééwis	阋神星
Káábin	碳
Níłchʼi Yáʼátʼéehii	氧
Hadoh dóó hakʼaz neiłkidígíí	溫度計
Níłchʼi Łitsxooí	氖
Chihuahua Hahoodzo	奇瓦瓦州
Soodin	钠
Béésh Łikoní	镁
Béésh Ászólí	铝
Tó Wónaanídę́ę́ʼ Bitsįʼ Yishtłizhii Bikéyah	印度
Tʼoobááloo	圖瓦盧
Béésh (Fe)	铁
Tʼónga	東加
Łeetsoii	硫
Samóa	萨摩亚
Sólomon Tó Bináhaazyínígíí	所罗门群岛
Banoʼáátʼoo	瓦努阿图
Páápowa Bigíní Ániidí	巴布亚新几内亚
Níłchʼi Dootłʼizhí	氩
Eʼeʼaahjí Tónteel bikáaʼgi Kéyah Yázhí dah Ndaaʼeełgo Ałhidadiidzooígíí	密克罗尼西亚联邦
Káálsiiyin	钙
Dilyį́hí	铅
Kílíbas	基里巴斯
Chʼah Diʼilii Bikéyah	蒙古国
Fííjii	斐濟
Béésh doo Ńdiniichxíihii	钛
Táłkááʼ Bighan Dineʼé Bikéyah	委內瑞拉
Méíin Hahoodzo	缅因州
Łį́į́ʼ	马
Naaldeehii	动物
Sówinam	蘇利南
Kéyah Nahasdzáán Ałníiʼgi Siʼánígíí	厄瓜多尔
Kolámbiya	哥伦比亚
Béésh Łibáhí	钴
Bolíbiya	玻利維亞
Béésh Łichíiʼii	铜
Niihémpshoo Hahoodzo	新罕布什尔州
Chʼosh doo yitʼíinii dláádí dóó Ábishjaaʼ	真菌
Jaméíkʼa	牙买加
Méésíchóoshish Hahoodzo	麻薩諸塞州
Kanédikiʼ Hahoodzo	康乃狄克州
Naaʼahóóhai	鸡
Antíígwa dóó Hashkʼaan Bikéyah Yázhí	安提瓜和巴布达
Kéyah Ałkéé Nitį́įgo Dah Ndaaʼeełí	夏威夷州
Damóo Bikéyah	多米尼克
Domingo Bikéyah	多明尼加
Bisóodi	家豬
Héítii	海地
Iiwą́ą́	伊朗
Iiwááʼ	伊拉克
Hakʼaz Dineʼé Bikéyah Hahoodzo	阿拉斯加州
Ízrel Bikéyah	以色列
Shádiʼááhjí Ásáí Bikéyah	也门
Jóoʼdan	约旦
Gah Bikeeʼ Taahíʼahí	佛罗里达州
Kíígiz Bikéyah	吉尔吉斯斯坦
Hoozdo Hahoodzo	亞利桑那州
Kóóweiʼ	科威特
Lááʼos	老挝
Łíbanoo	黎巴嫩
Óogin Hahoodzo	俄勒冈州
Naakaii Dootłʼizhí Bikéyah Yázhí (Tó Bináhaazyínígíí)	马尔代夫
Kéyah dah siʼánígíí	美洲
Áshįįh Biiʼtó Hahoodzo	犹他州
Béégashii	家牛
Maléízha	马来西亚
Dziłgaiitsoh Honeezkʼazii Bikéyah	尼泊尔
Omą́ą́	阿曼
Eʼeʼaahjí Naakaii Dootłʼizhí Bikéyah	巴基斯坦
Kʼatár	卡塔尔
Ásáí Bikéyah Saʼoodí	沙特阿拉伯
Swii Lankʼa	斯里蘭卡
Sííwiya	叙利亚
Tʼajiʼ Bikéyah	塔吉克斯坦
Tʼáí Bikéyah	泰国
Kǫʼ naʼałbąąsii diné bee nágéhéʼ	鐵路列車
Tʼóokmen Bikéyah	土库曼斯坦
Ásáí Bikéyah Yázhí Ałhidadiidzooígíí	阿拉伯联合酋长国
Biʼednam	越南
Kolíya Bikéyah Shádiʼááhjí Siʼánígíí	大韩民国
Óola	金
Naʼałkaahí	科学家
Bangla Bikéyah	孟加拉国
Angóola	安哥拉
Iiʼniʼ Tłʼiishtsoh Bikéyah	不丹
Bwoonéí	文莱
Tʼanzanííya	坦桑尼亚
Béésh Tózháanii	汞
Kéyah Dańlíinii	菲律宾
Naakaii Łizhinii Bikéyah Beʼałnííʼ	中非共和國
Hastiin Albert Einstein	阿尔伯特·爱因斯坦
Tʼóogo	多哥
Hooghan Tsé Bee Ádaalyaaí Bikéyah	辛巴威
Shádiʼááhjí Soodą́ą	南蘇丹
Tswana Dineʼé Bikéyah	波札那
Wóndii Dineʼé Bikéyah	蒲隆地
Ooljééʼ Bikéyah Yázhí	葛摩
Kéyah Káango Náhookǫsjí Siʼánígíí	刚果共和国
Kéyah Káango Shádiʼááhjí Siʼánígíí	刚果民主共和国
Jibótii	吉布提
Gíní Nahasdzáán Ałníiʼgi Siʼánígíí	赤道几内亚
Gabǫ́ǫ́ (Kéyah)	加蓬
Géémbiya	冈比亚
Gíní	几内亚
Gíní Bisó	幾內亞比索
Chį́į́h Yee Adilohii Bideeʼ Tónteel Bibąąh	科特迪瓦
Táłtłʼááh Chʼosh Daadánígíí Bitooh (Łizhinii Bikéyahdi)	喀麦隆
Tónteel Bibąąh Dootłʼizhí	佛得角
Sotho Dineʼé Bikéyah	莱索托
Łíbya	利比亚
Madaʼgéésgáá	马达加斯加
Malááwii	马拉维
Moowitéínya	毛里塔尼亚
Moroko	摩洛哥
Namííbya	纳米比亚
Yogénda	乌干达
Wánda Dineʼé Bikéyah	卢旺达
Seishel	塞舌尔
Náshdóítsoh Bitsiijįʼ Daditłʼooʼígíí Bidził	塞拉利昂
Soomáálii Bikéyah	索马里
Soodą́ą	苏丹共和国
Swáazi Dineʼé Bikéyah	斯威士兰
Nahasdzáán Bikáaʼgi Kéyah Naaznilgo Ałhidadiidzooígíí	联合国
Nidaashchʼąąʼígíí	颜色
Béésh Łigaii	銀
Béésh Dildǫʼí	锡
Łéétsoh	鈾
Hastiin alą́ąjįʼ dahsidáhígíí Bill Clinton	比尔·克林顿
Míshigin Hahoodzo	密歇根州
Tó Nitsaa Nílį́bąąh Hahoodzo	伊利诺伊州
Náhookǫsjí Dzígaii	北达科他州
Ałnííʼjí Dzígaii	南达科他州
Ayání Naakaii Hahoodzo	蒙大拿州
Tóʼííbézhí	怀俄明州
Nímasii Kʼidadilyéhé	爱达荷州
Ahééhałtį́į́h Hahoodzo	华盛顿州
Naʼazhǫǫsh Hahoodzo	内华达州
Kayíbíyinsíí (tónteel)	加勒比海
Dibé Nitsaa Hahoodzo	科羅拉多州
Naakaii bizaad	西班牙语
Naʼashjéʼii	蜘蛛
Chʼosh bijáád tseebíhígíí	蛛形纲
Chʼosh bideeʼ ádaadinígíí	螯肢亞門
Chʼosh bijáád dahólónígíí	节肢动物
Béeso	貨幣
Bijíniyah Hahoodzo	弗吉尼亚州
Eʼeʼaahjí Bijiniyah Hahoodzo	西維吉尼亞州
Kin Yótʼááh Deezʼá Hahoodzo	纽约州
Wóód Áalin Hahoodzo	羅德島州
Chʼosh bijáád hastání	昆虫
Méelin Hahoodzo	马里兰州
Déláwee Hahoodzo	特拉华州
Oohááyoo Hahoodzo	俄亥俄州
Pénsówéíniyah Hahoodzo	宾夕法尼亚州
Niijéízii Hahoodzo	新泽西州
Índíʼyéenah Hahoodzo	印第安纳州
Chidí	汽车
Jóojah Hahoodzo	喬治亞州
Akałii Bikéyah	德克萨斯州
Náhookǫsjí Kééláanah Hahoodzo	北卡罗来纳州
Shádiʼááhjí Kééláanah Hahoodzo	南卡罗来纳州
Méhigoʼ sídii	墨西哥城
Bilasáana diwozhí	菠蘿
Mísísípii Hahoodzo	密西西比州
Ténésii Hahoodzo	田纳西州
Yootó Hahoodzo	新墨西哥州
Mínisóodah Hahoodzo	明尼蘇達州
Wiskaansin Hahoodzo	威斯康辛州
Haʼaʼaahjí Dzígaii	艾奥瓦州
Nabeeskah Hahoodzo	內布拉斯加州
Shádiʼááhjí Dzígaii	堪薩斯州
Tó Dzígaii Nílį́	密蘇里州
Tónteel Chʼínílį́	路易斯安那州
Kentákii Hahoodzo	肯塔基州
Dził Biiʼ Dzígaii	阿肯色州
Halgai Hóteel Hahoodzo	奧克拉荷馬州
Ho Chi Min Sídii	胡志明市
Bilagáana bizaad	英语
Náhookǫsjí Hakʼaz Dineʼé Bikéyah	努納武特
1901 – 1950	1902年
Tłʼiish	蛇
1951 – 2000	1979年
Pope Benedict XVI	本篤十六世
Maʼii Ashkii	傑羅尼莫
Tsin naaʼeeł táłtłʼááh naagháhígíí	潛艇
Tahoniigááh	流行性感冒
Tłʼízí	家山羊
Kǫʼ	火
Tʼááłáhági átʼéego:Templates	Category:維基百科模板
Tʼááłáhági átʼéego:Naaldlooshii Bikéshgaan Dahólónígíí	Category:有蹄類
Dloziłchííʼ	歐亞紅松鼠
Tʼááłáhági átʼéego:Bideeʼtsʼinígíí	Category:牛科
Tʼááłáhági átʼéego:Ndaaʼnaʼii	Category:有鳞目
Tiníléítsoh	科摩多巨蜥
Chʼosh bijáád neeznánígíí	十足目
Aymara bizaad	艾馬拉語
Łeeyiʼ chʼoshtsoh binááʼ hólónígíí	无足目
Tʼááłáhági átʼéego:Dééł dóó Tóidoozohii	Category:鹤形目
Médíwííyin Sii	地中海
Jóojah (Ałtsʼáʼáztiin)	喬治亞 (消歧義)
Alóós	稻
Tsídii	鸟
Kéłánii bikágí yilzhólígíí	有爪动物门
Kéchwa bizaad	克丘亞語
Ínsadoobíídiiya	百科全书
Íiyisíí Naaltsoos	Wikipedia:首页
Dziłgaiitsoh Honeezkʼazii	喜马拉雅山脉
Tʼááłáhági átʼéego:Candidates for speedy deletion	Category:快速删除候选
Chʼil ahwééh	茶
Adijiłii	刺猬
Kéyah Sahééwa Eʼeʼaahjí Siʼánígíí	西撒哈拉
1801 – 1850	1815年
Łį́į́ʼ Bideeʼłáaʼii	独角兽
Hastiin Hernán Cortés	埃爾南·科爾特斯
Tsʼíʼii daʼaneezí	蚊
Dibé	綿羊
Łóóʼ hashkéhé	鲨鱼
Ghą́ą́ʼaskʼidii	骆驼
Bidił Daazdoígíí dóó Daʼałtʼoʼígíí	哺乳动物
Bíchį́į́h yee adilohii	象
Mágí dóó Mágí Ndahalinígíí	灵长目
(*wálá-)	蚂蚁
Tsísʼná	蜂族
Naayízítsʼósí	西葫芦
Jiłtʼoʼí	大黄
Sęęschʼil	花椰菜
Ayęęzhii yiltʼąąʼí	茄
Naalʼeełí	鸭科
Yas	雪
Jádí dághaaʼígíí	角马
1851 – 1900	1865年
Biʼééʼ Łichííʼí bizaad	俄语
1751 – 1800	1784年
Bááh	麵包
Bee Hazʼą́ą Ił Chʼétʼaah	世界人权宣言
Kéyah haʼdéísná	地震
Tó nitéél nitságoʼ atságáá	海啸
Níyoltsoh	龍捲風
Saad bee alʼį́į́hni	文字
Tʼááłáhági átʼéego:Dáághahii	Category:法国
Mąʼii łitsooí	赤狐
Naaltéʼ	奴隶制度
Ahwééh	咖啡
Abeʼ	乳
Dził	山
Doo Nidahałtingóó	荒漠
Cryptographic	密码学
Guadalajara	瓜达拉哈拉 (墨西哥)
Tsídii naʼałkʼaiʼí	企鵝
Kolíya Dineʼé bizaad	朝鮮語
Gah	兔
Tó niteel	洋
Hodíłchʼil Níłtsánígíí	雨林
HiTSʼezh	IPod
Hazéí	松鼠
Hazéí naatʼáʼii	鼯鼠
Ééʼ néíshoodí	天主教會
Kwį́į́n Elizabeth II	伊丽莎白二世
Hastiin alą́ąjįʼ dahsidáhígíí Ronald Reagan	罗纳德·里根
Hastiin Emperor Yongle	明成祖
Naʼashjéʼiitsoh	狼蛛
Naaldlooshii dadichʼízhii	爬行动物
Tsin Deigházhígíí	啮齿目
Hasbídí	鸠鸽科
Tééh hóyáanii	鼠海豚科
Biyáázh Tsʼǫʼasánígíí (Táyiʼ dóó Niʼkáágóó Ndaakaaígíí)	两栖动物
Géeso	乾酪
Chʼil naʼatłʼoʼii (chʼiyáán)	葡萄
Tsísʼná bitłʼizh	蜂蜜
Atsįʼ	肉类食物
Nímasii	马铃薯
Áshįįh łikan	食糖
Haʼałtsédii	坚果
Wááshindoon bisiláołtsooí	美军
Naʼiiniʼ bá Hooghantsoh	世界贸易中心
Áshįįh	食盐
Wááshindoondi bee hazʼáanii ádeiłʼíní	美国国会
Tsin naaʼeeł	船
Nidaʼąnyéézh	灌溉
Naadą́ą́ʼ	玉米
Naʼashchʼąąʼ	绘画
Wótáahgoo ałnaaʼáłtʼahiʼ	宇航员
Azhish	舞蹈
Naʼashjéʼii nahachaʼígíí	蠅虎科
Kéyah Daʼnaaznilígíí	世界政區索引
Shash	熊科
Hastiin alą́ąjįʼ dahsidáhígíí John Adams	约翰·亚当斯
Hastiin alą́ąjįʼ dahsidáhígíí Thomas Jefferson	托马斯·杰斐逊
Hastiin alą́ąjįʼ dahsidáhígíí Andrew Jackson	安德鲁·杰克逊
Ńdíshchííʼ	松屬
Tłʼoh naadą́ą́ʼ	小麦
Naałniih yichʼą́ą́h naabaahígíí bąąh dahooʼaahgo	艾滋病
Abeʼ bee neezmasí	可麗餅
Jéíʼádįįh	結核
Łóódtsoh	天花
Zelda bahaneʼ	薩爾達傳說系列
Naakáí dinéʼiʼ biempire Méhigodi	阿茲特克
Łéétsoh bee atsiniltłʼish álʼį́	核動力
Łéétsoh beeʼeldǫǫhtsoh beeʼalį́į́h	核武器
Chidí naaʼnaʼí beeʼeldǫǫh bikááʼ dah naaznilígíí	坦克
Dah woozh	草莓
Jalisco Hahoodzo	哈利斯科州
Dzidzé łikaní dootłʼizhígíí	藍莓
Dzidzé łikaní dinilchííʼígíí	樹莓
Mágí bichʼiyąʼ	椰
Dzidzétsoh	桃
Chʼil łitsxooí	橙
Chʼil dishooí	奇異果
Chʼil dootłʼizhí díkʼǫ́zhígíí	青檸
Abeʼ yistiní	冰淇淋
Méhigo bizaad	納瓦特爾語
Diné bizaad	納瓦荷語
Jeeʼiighááh	蠼螋
Tenochtitlan	特諾奇提特蘭
Ásáí Bizaad	阿拉伯语
Honeezílígi	亚热带
Atʼaʼ yiltʼąąʼí	棕榈科
Niłchiis	貂熊
Tsin yilátah ayání	长颈鹿
Naalʼeełídaaʼí	鸭嘴兽
Naʼashǫ́ʼii	蜥蜴
Béésh bee akʼeʼelchí áłtsisígíí	个人电脑
Wikiibíídiiya:Naaltsoos nizhónígo ádaalyaaígíí	Wikipedia:特色条目
Bee álnééhí:Link FA	Template:Link FA
Bimááʼ Hahoodzo	佛蒙特州
Hoozdoh	鳳凰城 (亞利桑那州)
Tʼáyaałchííʼ	北撲翅鴷
Táłkááʼ tsʼin bíchį́į́hnézí	恆河鱷
Tsin naaʼeeł chidí naatʼaʼí bee nágéhéʼ	航空母舰
Tsídiitsoh	鸵鸟
Kolíya bikéyah (Ałtsʼáʼáztiin)	朝鲜 (称谓)
Mąʼiitsoh	狼
Chʼídeeldlóohiitsoh	鲸头鹳
Hodíłchʼilgi dlǫ́ʼiitsoh	椰子貓
Tóidoozohii bidaaʼ łichííʼígíí	黑水鸡
Táłtłʼááh yilcháazhii	多孔动物门
Tónteel naʼashjéʼii	海蜘蛛
Séigoʼ bíláshgaanézí	鈍尾目
Naʼashjéʼii jáádnézí	盲蛛目
Séigoʼchilí bitseeʼ ádinígíí	拟蝎目
Séigoʼ	蠍子
Zahalchíʼii	避日目
Hastiin Emperor Qianlong	乾隆帝
Séigoʼ bitseeʼ áłtsʼózígíí	有鞭目
Yaaʼ doo yitʼíinii	蜱蟎亞綱
Hodíłchʼilgi naaʼahóóhai	䳍形目
Télii	驴
Náshdóítsoh noodǫ́zígíí	虎
Kʼíneeshbízhiinééz	意大利粉
Azeeʼ hókániitsoh	翼蓟
Táłkáaʼgi Tsídii	雁形目
Tązhii dóó Naaʼahóóhai Ndahalinígíí	鸡形目
Naalʼeełii keelóól	鷿鷈科
Tsídii Deílʼésígíí	鹳形目
Daʼałtʼoʼígíí Biyęęzhii Deiłchíhígíí	单孔目
Adijiłii bíchį́į́hnézí	针鼹
Hazéítsʼósii	花栗鼠
Chidí bikʼah	石油
Chéłchaaʼ	鞘翅目
Łį́į́ʼ ałchiní	普氏野马
Dlǫ́ʼii yił aheełtʼéhii noodǫ́zígíí	缟獴
Naʼastsʼǫǫsíʼniiʼí	袋狸科
Shash naʼazísí	袋熊
Nahatʼeʼiitsohchilí	鼠袋鼠科
Náʼagéédí łichíiʼii	金毛鼹科
Bįįh Danilínígíí	鹿科
Tin	冰
Tłʼohchin díchʼííʼí	蒜
Taʼneeskʼání áłtsʼóózígíí	黄瓜
Tłʼohchin (chʼil daadánígíí)	洋蔥
Chʼil łichxíʼí	番茄
Béésh Łichíiʼii Bikéyah Náhookǫsjígo Siʼanígíí	北賽普勒斯土耳其共和國
Naʼazhǫǫsh Hátsoh	拉斯维加斯
Náshdóí dilwoʼí	猎豹
Tsékǫʼ	煤
Néʼéshjaaʼ	貓頭鷹
Bíígháán Dahólónígíí	脊椎动物
Kʼishchííʼ	桦木属
Ǫǫbǫʼii	戴胜
Náshdóí Ndahalinígíí	猫科
Yádiłhił yiiyídíʼ nahosdzáán yináádáłiʼ	国际空间站
Tó wónaanídę́ę́ʼ toohjįʼ noołnahii	苍鹭
Hashkʼaan dijéʼé	海枣
Wááshindoon (Ałtsʼáʼáztiin)	华盛顿
Bidił Daazdoígíí dóó Daʼalghałígíí	食肉目
Chʼoshtsoh	蟑螂
Dlǫ́ʼii yázhí	伶鼬
Tsʼíʼii dóó Tséʼédǫ́ʼii	雙翅目
Biniiʼłigaii (néʼéshjaaʼ)	仓鸮
Mąʼii Ndahalinígíí	犬科
Bijáád Ádaadinígíí	软体动物
Chʼosh łitsxooí dóó Chʼosh łichííʼí	瓢蟲
Táłkááʼ naalzheehí	鹗
Bizaʼazis Dahólónígíí	有袋類
Dlǫ́ʼiiłgaii	白鼬
Naalʼeełí bitsiiʼ dootłʼizhí	绿头鸭
Sǫʼ łóóʼ	海星
Giníłbáhí	蒼鷹
Tʼádootłʼizhii	松鴉
Zhį́ʼii	渡鴉
Táłkááʼ tsʼin Danilínígíí	鳄目
Chʼosh bikágí dantłʼizí	甲壳亚门
Dééł	鹤科
Chʼosh bitsʼaʼígíí	双壳纲
Atsá dóó Giní Ndahalinígíí	隼形目
Łóóʼ ooshgę́ęzhii	軟骨魚綱
Tániilʼáí	蜻蛉目
Wóláchííʼ yildeełí bikágí ntłʼizí	穿山甲
Gah Danilínígíí	兔形目
Tsísʼnátsoh	熊蜂
Hazéí yiltseeʼí	蓍
Chʼosh bikǫʼí	萤科
Zéédzísgaii	雉鸡
Dlǫ́ʼii Ndahalinígíí	鼬科
Tsin yiłkaałii	啄木鸟科
Bideeʼtsʼinígíí	牛科
Dééł dóó Tóidoozohii Ndahalinígíí	鹤形目
Gáagii dóó Joogii Ndahalinígíí	鸦科
Chʼiltaatʼagii	白尾鹞
Tsin naaʼeeł diné bee nágéhéʼ	渡船
Gad	刺柏属
Jááłánii	多足類
Biishchʼid Dahólónígíí	真獸下綱
Chʼosh Deildeełii	食虫目
Tó wónaanídę́ę́ʼ naalʼeełítsoh łibáhígíí	灰雁
Tónteel dóó Tábąąhgi Tsídii	鸻形目
Ńdíshchíitah dlǫ́ʼii	松貂
Biyaatsʼiin Dahólónígíí	有颔下门
Tooh łéʼétsoh	麝鼠
Chaatʼíní	酸模
Łóóʼ hashkéhé dootłʼizhígíí	大青鲨
Wóʼatsʼǫǫsii Ádaatʼéhígíí	半翅目
Atsáłgaii	毛脚鵟
Béégashiiʼilí	牦牛
Tsxį́į́łnaalkʼįhii	雨燕科
Dziłditłʼoii Bił Hahoodzo	聖胡安縣 (猶他州)
Naalʼeełítsoh bitsiiʼ halzhinígíí	加拿大雁
Chʼó	云杉属
Łóóʼtsoh łizhin dóó łigaígíí	虎鯨
Jáádtsʼósí	反嘴鹬科
Naalʼeełítsoh diłhiłígíí	黑雁
Dlǫ́ʼii bitéél halgaií	石貂
Tábąąstííntsoh łibáhígíí	灰海豹
Naakaii Łizhiní Bikéyahdi Hadahóólįįdígíí	非洲獸總目
Diné Nááhódlóonii bizaad	德内语支
Tónteel tsídii	鷗
Ałtį́į́ jikʼáshí (chʼil)	木贼属
Hazaʼaleehtsoh (dííshjį́ ááłjiní)	旱芹
Kʼaalógii dóó Iichʼąhii	鱗翅目
Díłdánii yił aheełtʼéhii	鹌鹑
Chʼałdą́ą́ʼ / Jádí nátʼoh (chʼil daadánígíí)	芦笋
Tséʼédǫ́ʼii dootłʼizhí	麗蠅
Jaaʼabaní Danilínígíí	蝙蝠
Tsídii bidaanézí	鹳科
Dlǫ́ʼii	鼬屬
Lókʼaaʼ	芦苇
Tsídiiłbáhí	雀科
Biłʼeʼeliníʼ	發粉
Táłtłʼááh chʼoshchilí	磷蝦
Tsiiʼyiishbizhí Dinéʼiʼ Bikéyah	中國
Naalʼeełí binááʼ łitsooígíí	鹊鸭
Tábąąstíín	歐亞水獺
Jélii łóóʼ	水母
Náshdóíłgaii łikizhígíí	雪豹
Tábąąstííntsoh Danilínígíí	鰭足類
Dlǫ́ǫ́ʼ	草原犬鼠
Náshdóí bijaałizhiní	獰貓
Chʼóhojilyééh	曼陀罗花
Chʼah Diʼilii Bikéyahdę́ę́ʼ naalʼeełítsoh	鸿雁
Tsídii yáłtiʼí	鹦形目
Tééh łį́į́ʼ	斑馬
Náshdóí łikizhígíí	虎貓
Dííłdzid jeeshóóʼ	白兀鷲
Tʼáadoo leʼé danílʼį́ bił hazʼą́	博物馆
Shash łizhin dóó łigaígíí	大熊猫
Shash łigaígíí	北極熊
Gaantsʼosí	海百合
Hastiin alą́ąjįʼ dahsidáhígíí Theodore Roosevelt	西奥多·罗斯福
Neeshchʼííłgai	腰果
Beeʼódleehí	狩獵陷阱
Dilní bee Nidaʼanéhígíí	乐器
Dééłgai	天鹅
Bikááʼ náʼoobałí	直升機
Dziʼizítsoh	摩托車
Tééhoołtsódii	河马
Séí	沙
Naakaii Łizhiní Bikéyahdę́ę́ʼ náshdóítsoh łikizhígíí	豹
Déélgééd	犀牛
Beeʼeldííl Dahsinil	阿布奎基 (新墨西哥州)
Hashkʼaan dootłʼizhí (babáayah)	番木瓜
Chʼil łigaii (atʼééké bijish)	捲心菜
Náshdóítsoh	美洲狮
Ásáí dinéʼiʼ	阿拉伯人
Deeteel	駝鹿
Shádiʼááhdę́ę́ʼ náshdóítsoh łikizhígíí	美洲豹
Lókʼaatsoh	竹
Káango (Ałtsʼáʼáztiin)	刚果
Kʼaiʼ	柳树
Shash bizaʼazis hólóní	無尾熊
Náshdóí kʼos bee naashchʼąąʼígíí	雲豹
Shashtsoh	棕熊
Łéʼétsoh	大家鼠
Akʼáán	麵粉
Mágítsoh	大猩猩
Bitsįʼ yishtłizhii	美洲原住民
Dáʼákaz łikaní	甘蔗
Chʼil akʼahí	鳄梨
Neeshchʼííłbáhí	花生
Dzidzétsoh díkʼǫ́ǫzhii	杏
Naʼashǫ́ʼii łahgo ánééhé	變色龍
Yootó	圣菲 (新墨西哥州)
Łééchąąłgaii	格雷伊獵犬
Nahatʼeʼiitsoh Bikéyahdę́ę́ʼ łééchąąʼí ałchiní	澳洲野犬
Chʼééhjiyáán	西瓜
Teide	泰德峰
Naʼastsʼǫǫsí	小鼠属
Hakʼaz bįįh	驯鹿
Chʼosh doo yitʼínii	微生物
Táshchozhii	燕科
Neeshchʼííʼ hááheeshchiiʼí	扁桃
Łóóʼ bigaan tseebíí	章鱼
Chʼosh bikágí ntłʼizí	螃蟹
Tábąąstííntsoh bideeʼ hólónígíí	海象
Mágí diʼilí	猩猩屬
Atsátsoh	金雕
Łóóʼtʼą́hí atsiniltłʼish ííłʼínígíí	电鳐目
Chʼil łitsxooí ntsxaaígíí	葡萄柚
Kʼíníjíłʼahí (dííshjį́ ááłjiní)	鵝莓
Kʼaalógiiłgaígíí	粉蝶科
Naʼastsʼǫǫsí binááʼ áłtsʼíísígíí	鼩鼱科
Dzaanééz	骡
Tsinlátah shash łichíʼígíí	小熊猫
Tsídii jáádnézí	火烈鸟
Tééh łééchąąʼí	鬣狗科
Łóóʼtsoh dootłʼizhígíí	蓝鲸
Sóól	槭属
Aghaaʼ	羊毛
Deesdoigi	热带
Shádiʼááhdę́ę́ʼ tłʼízí	大羊駝
Mósíʼilí	波斯貓
Lókʼaatah mósí ałchiní	丛林猫
Náátsʼózídę́ę́ʼ mósíłkizhii ałchinígíí	豹貓
Náshdóítʼą́ʼí łikizhígíí	藪貓
Tábąąh béégashii	水牛
Béégashiitsoh naʼałkǫ́ǫ́ʼígíí	海牛屬
Hastiin Leiw Éíwiksson	萊夫·埃里克松
Akágí yitsʼǫǫsii	蚂蟥
Anáʼálwoʼ:TʼAN (FAQ)	Wikipedia:常见问题解答
Táłkááʼ tsʼin	鱷科
Chidítsoh	载货汽车
Dlǫ́ʼiitsoh áłtsʼózígíí	獛属
Gáagii	乌鸦
Tó wónaanídę́ę́ʼ náshdóí	歐亞猞猁
Jááłánii (bitsiitsʼiin nteelígíí)	蜈蚣
Giní	隼
Dahiitį́hii	蜂鸟
Tsídii biyęęzhtsohígíí	鷸鴕
Tązhii	火雞
Chʼosh (Bíígháán Ádaadinígíí)	无脊椎动物
Gáagii naashchʼąąʼígíí	佛法僧科
Mąʼii	郊狼
Dah Naatʼaʼí Sǫʼ bił Sinil	星条旗 (美国国歌)
Akʼah sisíʼí tsin	桉树
Mááya dinéʼiʼ	玛雅人
Gahtsoh	兔属
Bisóodi bíchį́į́h nineezí	土豚
Sonora Hahoodzo	索諾拉州
Nahakʼízii	蟋蟀
Chaaʼ	河狸
Chʼilzooł	西蘭花
Kááʼtsʼiní	犰狳科
Atsʼiis naałdzid	肺癌
Yágháhoníkáángóó ałánátʼahí	航天飞机
Béésh náábałí atsiniltłʼish ííłʼínígíí	風力發動機
Méhigo tééh	墨西哥谷
Shą́ą́ʼnahalghałí (naaldeehii)	蹄兔目
Nahatʼeʼiitsoh łichíiʼii	紅大袋鼠
Azeeniłchin	唇形科
Chʼał	无尾目
Tsxilghááh	有尾目
Shádiʼááhdę́ę́ʼ atsátsoh	角雕
Shádiʼááhdę́ę́ʼ chʼał kʼaasdáhígíí	箭毒蛙
Chʼał niłtólí	玻璃蛙
Chʼał dichʼízhí	蟾蜍科
Tónteel tsídiitsoh	信天翁科
Chidí nadlééh	敞篷车
Chʼał atʼąąʼ nahalinii	角蟾科
Bisóodi ałchiní	野豬
Naʼastsʼǫǫsí dóó Łéʼétsoh Danilínígíí	鼠
Mariner 10	水手10號
Sǫʼ łóóʼ bigaanézí	蛇尾
Dághaałóóʼ	鮎形目
Łóóʼtʼą́hí	比目魚
Toohjįʼ ndiigaii	雪鹭
Kʼaalógii bitseeʼ hólóní	凤蝶科
Mágí binááʼtsohígíí	眼鏡猴
Tó wónaanídę́ę́ʼ dlǫ́ʼiiłkizhii	虎鼬
Díłdánii	齿鹑科
Táłtłʼááh łį́į́ʼ	海馬
Łóóʼ bíígháántsiighąąʼ ádaadinígíí	盲鰻
Béésh Sinil	温斯洛 (亚利桑那州)
Achʼįʼ Náhiłtį́į́	萨福德 (亚利桑那州)
Tó wónaanídę́ę́ʼ dzeeh	欧洲马鹿
Tsézhin Deezʼáhí	圣约翰斯 (亚利桑那州)
Béésh Bá Hooghan	格洛布 (亚利桑那州)
Kinłání (Hoozdoh Hahoodzo)	弗拉格斯塔夫 (亚利桑那州)
Michoacán Hahoodzo	米却肯州
Tʼiisyaakin	霍尔布鲁克 (亚利桑那州)
Naʼníʼá Hótsaa	佩吉市
Mágíshzhin	黑猩猩屬
Łóóʼntsxaaí łikizhígíí	鯨鯊
Dlǫ́ʼii yił Aheedaałtʼéhígíí	獴科
Béésh Bichʼahníí Bikéyahdę́ę́ʼ ayání	欧洲野牛
Łóóʼtsoh bitsiiʼ dikʼání	抹香鲸
Waaʼ (dííshjį́ ááłjiní)	菠菜
Néʼéshjaatsoh	大雕鴞
Shádiʼááhdę́ę́ʼ tłʼízíʼilí	羊驼
Chʼosh ditłʼooí	毛蟲
Łóóʼ bigaan neeznání	管魷目
Bijáád noodǫ́ǫzii	㺢㹢狓
Méhigo Hahoodzo	墨西哥州
Ayání	美洲野牛
Mąʼiiłgaii	北極狐
Gólízhii Danilínígíí	臭鼬科
Táłtłʼááh adijiłii	海膽
Nahachagii	草蜢
Wóóneeshchʼįįdii (nahachaʼígíí)	蝗蟲
Tsídiitsoh ditsʼozígíí	鸸鹋
Ałhaʼdeetʼaah	契约
Naayééʼ tsídii	始祖鸟
Tsísʼná (bitłʼizh ííłʼínígíí)	蜜蜂屬
Chééwokii dinéʼiʼ	切羅基人
Tsin naaʼeeł hééł bee nágéhéʼ	貨船
Ałtį́į́ jikʼáshí áłtsʼózígíí (chʼil)	问荆
Yéigo ałhoshii	睡鼠科
Naʼashjéʼii bijéí dah łichíiʼii	黑寡婦蜘蛛
Mágí dághaaʼígíí	皇狨猴
Didzéłchííʼ	冬青
Oozéí / Ayahkinii	霍皮族
Toohjįʼ noołnahiitsoh	巨鹭
Bidááʼ Haʼaztʼiʼ Tsékooh	科羅拉多大峽谷
Táłtłʼááh naʼashjéʼii	水蛛
Táłtłʼááh tsisteełtsoh	棱皮龜
Nahatʼeʼii	更格盧鼠屬
Tsídii yáłtiʼí yázhí	虎皮鸚鵡
Tábąąh mąʼii	浣熊
Hołchʼíʼí	蕁麻
Tsįdláád	鬍鬚地衣
Dáághahii dinéʼiʼ	法兰西人
Shash łizhinígíí	美洲黑熊
Náshdóí bizaʼazis hólóní	袋狼
Łeeyiʼ chʼosh	蚯蚓
Shash bitéélgaígíí	亞洲黑熊
Chʼoshtʼą́hí	扁形动物门
Hashtłʼish jeeshóóʼ	胡兀鷲
Jádí bíchį́į́htsohígíí	高鼻羚羊
Táłtłʼááh chʼoshtsoh chʼééh digháhii	海參
Chidí naatʼaʼí dilwoʼí	战斗机
Bíchį́į́h naatsʼǫǫdí	貘
Tó wónaanídę́ę́ʼ mąʼii	亞洲胡狼
Łóóʼ Bigaan Dahólónígíí	头足纲
Naʼashǫ́ʼii łóóʼ	鰻
Dahbaʼ (tsin)	梣树
Łóóʼ hashkéhétsoh	大白鲨
Neeshchʼííłchííʼ	栗
Chį́į́hnézí nahatʼeʼígíí	象鼩
Táłtłʼááh ayání	儒艮
Dibé Diníí Bikéyahdę́ę́ʼ náshdóí	伊比利亞猞猁
Maadíséloo	蒙蒂塞洛 (犹他州)
Kʼaiʼ Bił Hahazteel	卡纳布 (犹他州)
Toohjįʼ ndiigaiitsoh	大白鹭
Wóóneeshchʼįįdii	蝉
Dééshzhiin	黑天鹅
Naakaii náásééł	螳螂
Dlǫ́ǫ́ʼ ntsxaaígíí	水豚
Mąʼii bijaaʼtsohí	耳廓狐
Náshdóí łibáhígíí	短尾貓
Chʼilhaatʼaʼii	灰背隼
Tééh hóyáaniitsoh	白鲸
Jádí bideeʼ yisdizígíí	高角羚
Náátsʼózídę́ę́ʼ mąʼiiłchííʼ	豺
Łóóʼtsoh bighą́ą́ʼ yílkʼidígíí	座头鲸
Ghą́ą́ʼnaakiskʼidii	双峰骆驼
Tábąąh mąʼiiniiʼí	貉
Naʼazhǫǫsh (ndajiné dóó adazhdikaʼgi)	賭場
Ndikʼąʼ	陆地棉
Dlǫ́tʼą́ʼí	狐獴
Azeeʼ hókániitsoh (chʼil daadánígíí)	菜薊
Mąʼii bizaʼazis hólóní	袋獾
Shash bítááʼłgaígíí	眼鏡熊
Jádítsoh	扭角林羚
Naatʼáanii Moctezuma II	蒙特祖馬二世
Biwooʼ Ádaałtsʼíísígíí	披毛目
Ásáí dinéʼiʼ bikéyah	阿拉伯世界
Shash yázhí	马来熊
Shash ndilnaʼii	懒熊
Teeł	香蒲属
Łéʼétsoh yiljaaʼí	毛茛属
Hakʼaz náshdóí	加拿大猞猁
Mąʼii yił Ałhidanoolinígíí Yázhí	浣熊科
Béésh Bichʼahii beʼakétłʼóól dijoolí	苤藍
Nahooyéí (chʼil naʼatłʼoʼii)	旋花属
Tłʼoh waaʼí nahalinígíí	白三葉草
Tséʼésgízii	香茶藨子
Tábąąstííntsoh dághaaʼígíí	髯海豹
Hoshdódii chʼil	密花独行菜
Atʼééké bijish yázhí	抱子甘藍
Tsékooh	峡谷
Noodah	龍舌蘭屬
Łeeʼdoolʼeezí	列當科
Kinteel Bił Hahoodzo	聖胡安縣 (新墨西哥州)
Beeʼeldííl Dahsinil Bił Hahoodzo	伯納利歐縣
Aniłtʼánii	脈翅目
Kʼaalógii bijáád dį́įʼii	蛺蝶科
Nímasii yiyání	科羅拉多金花蟲
Awééʼchíʼí (chʼil)	風鈴草屬
Taʼaghálii	黄芪
Naaʼołí yiltʼąąʼí	香豌豆属
Azeeʼ ndootʼeezhí łibáhígíí	欧夏至草
Hastóí tsiiyéélí	铁线莲属
Chʼilátah atsʼos	柳叶菜属
Dééłjáád	皱叶酸模
Shį́náldzidí (chʼil bilátah hózhóón)	金鱼草属
Kʼįįʼ	盐肤木属
Naaztání	美国皂荚
Táłkááʼbéésh	慈姑属
Tsinyaa tłʼoh	早熟禾属
Tłʼééʼ yiigáhii	月見草屬
Tłʼoh deeskʼidí	反枝苋
Ndootʼeezhí	美國薄荷屬
Wóóseekʼidii	天蛾科
Dzílí bíláshgaan	芹叶牻牛儿苗
Díkʼǫ́ǫ́zhí (chʼil)	滨藜属
Tʼąąʼdoolghasí	蕨麻
Teełikaní	海韭菜
Láʼashdlaʼ	五叶地锦
Tséghániłchʼi	马齿苋
Zééʼiilwoʼii	看麦娘属
Tólchiintsoh	沼生水苏
Tséyaa hataałí	蕪菁甘藍
Tłʼohtsʼózí	灯心草属
Tłʼoh dichʼíízh	薹草属
Shashdą́ą́ʼ	小檗属
Tłʼoh waaʼítsoh	白花草木樨
Díkʼǫ́ǫ́zhí yiltʼąąʼí	藜
Bįįh yildeeʼí	酸浆属
Kʼaalógii bitʼaʼ ndikʼąʼ nahalinígíí	灰蝶科
Hosh niteelí	仙人掌属
Teeł bitʼąąʼłánígíí	藨草属
Chʼał nineezí	美国牛蛙
Tééh hóyáanii bíchį́į́htsahí	一角鲸
Mágí bíchį́į́htsohígíí	狒狒屬
Bįįh łikizhígíí (Béésh Bichʼahníí Bikéyahdę́ę́ʼígíí)	黇鹿
Tábąąh ayání	非洲水牛
Nátʼostsoh	毛蕊花
Tólchiin (chʼil)	野薄荷
Dibé diníí dinéʼiʼ	西班牙人
Táłkááʼ dah yikał	豆瓣菜屬
Binaʼadaałtzózí	日本人
Chʼil awoshí	刺沙蓬
Chʼil naamaasii	白苋
Naʼashjéʼiichʼil	北点地梅
Ahaditʼáán	刺酸模
Yéʼiibeʼetsʼos	绢雀麦
Naazkaadí	北美苋
Tsáʼásziʼ nteelí	鳳尾蘭
Ostseʼ yiltʼąąʼí	播娘蒿
Azeediilchʼílii	狭叶羽扇豆
Bikétłʼóól názbąs	东北柳叶菜
Gad yił aheełtʼéhígíí	红荆
Łóóʼ bíchį́į́h nineezí	劍旗魚科
Łį́į́ʼ Ndahalinígíí	马科
Binááʼ Ádaałtsʼózí bichʼil łigaií	大白菜
Kolíya Tááʼ Bikéyahą́ą	朝鲜三国时代
Hashkʼaantsoh yiltʼeesígíí	大蕉
Iiʼnótʼį́į́	感染
Chʼah Diʼilii Bikéyahdę́ę́ʼ mósí ałchinígíí	兔猻
Jááłánii (bikágí ntłʼizígíí)	馬陸
Iichʼąhii ntsxaaígíí	皇蛾
Łóóʼ ńdídzihígíí	肺鱼亚纲
Chʼíshiibeezhii	山雀科
Giní jáádnézí	蛇鷲
Hakʼaz néʼéshjaaʼ	雪鸮
Shádiʼááhdę́ę́ʼ jeeshóóʼ	安地斯神鷹
Chidí naatʼaʼítsoh beeʼeldǫǫh bikǫʼ neiyéhé	轰炸机
Shash bighą́ąʼgi hadzíbáhí	灰熊
Kǫʼ naʼałbąąsii	蒸汽機車
Ndíyíliitsoh	向日葵
Naaʼahóóhaiłkizhígíí	珠雞
Tłʼiish yighání	蜜獾
Dadilhóni aheltłʼidígíí	手榴弹
Naakaii Łizhiní Bikéyahdę́ę́ʼ łééchąąʼí ałchiní	非洲野犬
Aniłtʼánii (tʼááłaʼajínígoʼígíí)	蜉蝣目
Ayánítsoh bighą́ą́ʼaskʼidígíí	印度野牛
Máaz yikááʼ nandahí Spirit	勇气号火星探测器
Hakʼaz giníłgaii	海东青
Tsétah jeeshóóʼ łibáhí	西域兀鹫
Tééh łééchąąʼí łikizhígíí	斑鬣狗
Tłʼízí ałchiní	野山羊
Yaaʼ dóó chʼosh bíchį́į́h dadichʼízhí	棘头动物门
Beeʼeldǫǫh	鳥銃
Chʼosh bitsʼaʼígíí bigaan dahólónígíí	腕足动物门
Tʼąąʼdoolghasí (daadánígíí)	苦苣
Dlǫ́ʼii (bílaʼashdlaʼii bilį́į́ʼ)	矇眼貂
Łóóʼtsoh łibáhígíí	灰鯨
Chʼah Diʼilii Bikéyahdę́ę́ʼ atsátsoh	草原雕
Yiisnááh	战俘
Dzeeh	加拿大馬鹿
Tsinlátahgi tsídii nahatʼeʼígíí	鼠鸟目
Nátʼoh (chʼil)	烟草
Tsin naaʼeeł bee daʼahijighánígíí	戰艦
Tsísʼná yiyání	蜂虎科
Bisóodi bizęęs dį́įʼii	疣豬
Dlǫ́ʼiitsoh naalzheehígíí	馬島長尾狸貓
Nahachagii biyázhí	蚜虫
Naalkʼįhiitsoh	皮翼目
Łóóʼ naatʼaʼí	飞鱼
Hakʼaz ayání	麝牛
Tsétah gah	鼠兔
Mąʼiitsoh bikʼos bineʼdę́ę́ʼ łizhinígíí	鬃狼
Iichʼąhiitsʼósí	石蛾
Kéyah Dańlínídę́ę́ʼ atsátsoh	食猿鵰
Tábąąstííntsoh bíchį́į́htsohígíí	象海豹属
Łóóʼntsxaaí díníchʼahii	姥鲨
Chʼosh yighání	土狼
Mágí bitseeʼ noodǫ́zígíí	环尾狐猴
Táyiʼ chʼoshnézí	纽形动物门
Dlǫ́tsʼósí łibáhígíí	窄紋獴
Tó naagoʼ	水滴
Dlǫ́ʼiitsoh Danilínígíí	灵猫科
Mágí bigaanézí	长臂猿
Bílaneezii	指猴
Séí mąʼii	沙狐
Naalʼeełítsoh bitéél halchíʼí	红胸黑雁
Tłʼízí bideeʼ yisdizígíí	捻角山羊
Jádí	叉角羚
Wónikǫsí	竹節蟲目
Tééh łééchąąʼí noodǫ́zígíí	条纹鬣狗
Tsídiiłchxoní	麝雉
Táłtłʼááh chʼoshtʼą́hí bikááʼtsʼinígíí	多板纲
Mąʼii bighą́ąʼgi hadzíjiní	黑背胡狼
Naakaii Łizhiní Bikéyahdę́ę́ʼ mąʼiiłchííʼ	衣索比亞狼
Tsétah dibé	大角羊
Dibé dóó Tłʼízí Ndahalinígíí	羊亚科
Mágí bíchį́į́h dootłʼizhígíí	山魈
Tsiighájíłchí	菟絲子屬
Bįįhyázhí biwooʼnézí	原麝
Dzeeh łikizhígíí	梅花鹿
Tábąąh mósí ałchiní	漁貓
Chį́į́h yee achʼiishíhii	锯鳐科
Shádiʼááhdę́ę́ʼ hodíłchʼil mąʼii	藪犬
Hakʼaz mágí	日本獼猴
Tsé Biiʼ Ndzisgaii	紀念碑谷
Mágí bíchį́į́h niilyoolígíí	長鼻猴
Shádiʼááhdę́ę́ʼ tsídiitsoh	美洲鴕鳥
Dáádílí łibáhígí	烏鰭石斑魚
Ayání dóó Béégashii Danilínígíí	牛
Náátsʼózídę́ę́ʼ mósíłtsxooí ałchinígíí	金貓
Łóóʼnteeltsoh	翻車魚
Gaanłáníchilí dóó Gaanłání doo yitʼíinii	水螅
Chʼoshkʼaaʼ	毛颚动物门
Tábąąh bįįh	獐
Hodíłchʼil jeeshóóʼ	王鷲
Dlǫ́ǫ́ʼ bitseetłʼooígíí	毛絲鼠
Achʼąąʼ adáʼatsʼiʼ	疫苗接種
Néʼéshjaaʼ bíńdáhii	猛鴞
Bitseeʼ yee adiłhałii	美國短吻鱷
Jádítsoh noodǫ́zígíí	紫羚
Tádídíín yiyání	金花蟲科
Tsídiidaashiyishí	朱鷺亞科
Yílnoodii (łóóʼ)	梭子魚
Shádiʼááhdę́ę́ʼ łéʼétsoh bitseeʼ ádinígíí	刺豚鼠属
Chʼosh bitsʼaʼłáaʼii	单板纲
Naʼashǫ́ʼii łóóʼ hashkéhé	皺鰓鯊
Jeeshóóʼ	加州神鷲
Táłkááʼ chʼó	天山泽芹
Chʼosh dilwoʼígíí	虎甲
Chʼosh doo yitʼíinii bee nílʼíní	顯微鏡
Tsin ditʼinii	美洲黃鼠屬
Joogii	冠蓝鸦
Łeeyiʼ nahakʼízii	螻蛄
Náátsʼózídę́ę́ʼ naalʼeełí	鸳鸯
Mąʼii bijaaʼabanígíí	大耳狐
Tsídiitsoh bikʼos dootłʼizhí	鹤鸵
Atsiniltłʼish ííłʼíinii (naʼashǫ́ʼii łóóʼ)	電鰻
Dįʼ	松鸡科
Łeeyiʼ tłʼiish áłtsʼíísígíí	盲蛇下目
Niicháadii (łóóʼ)	四齒魨科
Tééhoołtsódiichilí	倭河马
Kʼiiznoodǫ́ǫzii (tsin yigházhígíí)	無尾刺豚鼠
Wóláchííʼ yildeełítsoh	大食蟻獸
Bináʼadaałtsózí bitsin naaʼeeł	中国帆船
Níłtsą́goʼ (bideeneezígíí)	天牛
Tséʼédǫ́ʼii bitsiinézí	長翅目
Tłʼohtahgi díłdánii yił aheełtʼéhii	三趾鹑科
Shádiʼááhdę́ę́ʼ tó hóyáanii	亞馬遜河豚
Naʼashǫ́ʼiitsoh	美洲鬣蜥屬
Binaʼadaałtsózí dinéʼi	东洋
Łóóʼ adishishí	魟科
Tsin yąąh dzootʼihí	鳾屬
Atʼaʼ yiltʼąąʼí dah sidáhígíí (chʼosh ntsxaaígíí)	椰子蟹
Yółeehii	鮟鱇魚
Tiníléí	美國毒蜥
Dijádídlǫ́ʼí	角百灵
Tłʼoh	草地
Dinas	熊果
Yadiizį́įgo ayání	长颈羚
Télii bijáád noodǫ́zí	非洲野驴
Bitsʼáá bidaʼhodiʼniil	焦土政策
Mágíłchííʼ	金獅面狨
Dááʼadeeʼii	琵鷺
Łóóʼ hashkéhé bitsiiʼ dikʼání	双髻鲨
Taahilnoodii	鲣鸟
Kʼíneedlíshii adiłhashígíí	鍬形蟲
Naʼashǫ́ʼiitsoh naʼałkǫ́ʼígíí	海鬣蜥
Yaaʼ bitsʼaʼígíí	介殼蟲總科
Tééh łééchąąʼí ditsʼozígíí	褐鬣狗
Tsétaʼ łį́į́ʼ	美洲野馬
Kénézí	雉鸻科
Neeshchʼííʼ	松子
Naalʼeełítsoh yił aheełtʼéhii łizhin dóó łigaiígíí	鵲鵝
Mąʼii chʼil	一枝黄花属
Yaadaaʼnézí (tónteel tsídii)	剪嘴鸥属
Tsídii disxǫsígíí	鹟鴷科
Náátsʼózídę́ę́ʼ mósíłchíiʼii ałchinígíí	婆羅洲金貓
Shádiʼááhdę́ę́ʼ tsétah mósí ałchinígíí	山原貓
Tsinlátahgi dlǫ́ʼiitsoh	熊狸
Jeeshóóʼ łizhinígíí	黑美洲鷲
Naałʼashí	捕鳥蛛科
Dééłdą́ą́ʼ	欧洲蕨
Hashkʼaan yildeełígíí (tsídii)	蕉鵑
Łį́į́chilí	昔德蘭矮種馬
Mąʼiiłtsooí łibáhígíí	灰狐
Naʼashǫ́ʼiitsoh dootłʼizhígíí	美洲鬣蜥
Chidí bikéíjį́ʼ adeizʼááhígíí	皮卡
Bįįh bitseełgaiígíí	白尾鹿
Díʼdikii (jádí)	犬羚属
Hakʼaz mąʼiitsoh	北極狼
Dark Ages	歐洲黑暗時代
Dlóóʼ binaalniih	腺鼠疫
Naaʼołí biyaʼ	绿豆象
Ááhooshtʼįįh	投降
Tséʼédǫ́ʼii dishooí	食蚜蝇
Tsáʼásziʼ dóó Noodah	龙舌兰科
Tééh tsisteeł	海龟
Bichʼah Dootłʼizhii	联合国维持和平部队
Dlǫ́ʼii łizhin dóó łitsooígíí	黃喉貂
Łeʼesoołii (bitseeʼ naakiígíí)	双尾目
Dlǫ́ʼátsoh	美洲旱獺
Chʼééh digháhii dóó Tsisteeł	龜
Łóóʼ bigaanłánígo bitsʼaʼígíí	鹦鹉螺
Łeʼesoołii (bitseeʼ tááʼígíí)	纓尾目
Tłʼézhii	虻
Tániilʼáítsʼóóz	豆娘
Naashtʼézhí	祖尼人
Aniłtʼániitsʼóóz	蟻獅
Tó wónaanídę́ę́ʼ hazéí bíchį́į́hnézí	樹鼩目
Hakʼaz gah	北极兔
Bįįh łikizhígíí (Naakaii Dootłʼizhii Bikéyahdę́ę́ʼígíí)	花鹿
Nahashchʼidí (naaldeehii)	美洲獾
Bisóodi bideeʼ názhahígíí	鹿豚
Tsídii bichʼahtsooígíí	双角犀鸟
Shádiʼááhdę́ę́ʼ bisóodi diʼilígíí	西猯科
Náʼagéédí bizaʼazis hólóní	袋鼹属
Bilagáana	白人
Tłʼézhiiłbáhí	寄生蠅
Shash nátʼoh	蒺藜
Jádítsoh diłhiłígíí	安氏林羚
Jádítsoh bideeʼ shiyishígíí	黑马羚
Dlǫ́ʼiitsoh łikizhígíí	非洲靈貓
Tsinaʼayąʼii yildeełí	袋食蚁兽
Tsétah tłʼízí	雪羊
Gahchilí	侏兔
Cháʼoł bidahtsʼaaʼ	油杉寄生属
Dééłgai bitsiiʼ halzhinígíí	黑颈天鹅
Hóółtseiigi naʼastsʼǫǫsí	沙鼠
Laanaa Yáʼátʼéehgo Késhmish	我們祝你聖誕快樂
Chį́į́shłigaií (bílaʼashdlaʼii bilį́į́ʼ)	鹅
Nahatʼeʼiitsoh Bikéyahdę́ę́ʼ naalʼeełítsoh łibáhígíí	蠟嘴雁
Dahsánítsoh	非洲冕豪豬
Naʼastsʼǫǫsí bitseeʼ dichʼízhí	非洲刺毛鼠屬
Tsétah nahatʼeʼiitsoh	岩袋鼠属
Táłkááʼ dilwoʼí	水黽科
Akáshtʼóózh biyaʼ	啮虫目
Łeʼesoołii (bideeʼ ádinígíí)	原尾目
Ąąʼąʼii	喜鹊属
Jádí bideeʼ dį́įʼii	四角羚
Táłtłʼááh chʼosh ntsxaaígíí	甘氏巨螯蟹
Mósí ałchiní bitsiiʼtʼąhígíí	扁頭豹貓
Naakaii Łizhiní Bikéyahdę́ę́ʼ naalʼeełítsoh dibéłchíʼígíí	埃及雁
Hosh aditsahiitsoh	巨人柱
Tʼáá łichíʼígo náʼagéédí	裸鼹鼠
Tsisteeł łizhinígíí	紅腿象龜
Atʼąąʼ nahalinii	葉竹節蟲科
Ghą́ą́ʼnoodǫ́ǫzii (tsin yigházhígíí)	長尾豚鼠
Łéʼétsoh beeniʼíhoniitaahígíí	豚鼠属
Naʼashǫ́ʼii dichʼízhii	角蜥
Naʼashǫ́ʼiitsoh łitsooígíí	加拉巴哥陸鬣蜥
Sahdii Bisí (Tsé Nástánii)	石化林國家公園
Tsé Bighánílíní	羚羊峽谷
Naakaii Dootłʼizhii bimósí ałchinígíí	鏽斑豹貓
Dahiitį́hídą́ą́ʼtsoh	火焰草属
Dlǫ́ʼbéʼézhóóʼ	三芒草属
Chʼil abeʼéntsxaaí	柳葉馬利筋
Jáád neishoodí (łeyiʼdi bighanígíí)	掘土蜂
Dáʼághálii	豬屎豆屬
Chʼał bikʼos ádinígíí	紫蛙
Tłʼohtah náshdóí	潘帕斯猫
Tsídii naʼałkǫ́ʼígíí	海鸚
Tsisteeł diyogí	楓葉龜
Łóóʼ adishishí ntsxaaígíí	鬼蝠魟
Tónteel bibąąh hóyáanii	江豚
Naakaii Łizhiní Bikéyahdę́ę́ʼ tsétah dibé	蛮羊
Naalʼeełí naashchʼąąʼígíí	美洲木鴨
Tsinlátah nahatʼeʼiitsoh	樹袋鼠
Chʼosh biyaʼ	捻翅目
Táłtłʼááh chʼosh	龍蝨
Shádiʼááhdę́ę́ʼ tábąąstííntsoh	南海狮
Táłtłʼááh álééh	大藍鷺
Tsísʼnáłtsooítsoh	虎頭蜂屬
Táłtłʼááh naakaii náásééł yił aheełtʼéhii	蝦蛄
Náátsʼózídę́ę́ʼ tsiiłtsooí	红腹锦鸡
Bisóodi Danilínígíí	猪形亚目
Gólízhii noodǫ́zígíí	臭鼬
Tsinlátah naʼashǫ́ʼiitsoh	小安德烈斯島鬣蜥
Naʼastsʼǫǫsí bijaaʼntsxaaígíí	兔耳袋狸
Tsʼání	蓝头鸦
Chʼééh digháhii bitsʼaʼ yilzhólí	鳖
Chį́į́shghą́ʼiiłgaii	白胸鳾
Hastiin Biʼééʼ Łichíiʼii	基特·卡森
Tábąąstííntsoh (Akééháshį́į́dę́ę́ʼígíí)	加州海獅
Mósí bizaʼazis hólóní	袋鼬属
Tségad	卷柏
Naaʼołí	豆类
Yaaʼ nahachagiígíí	跳蚤
Náátsʼózídę́ę́ʼ toohjįʼ ndiigaii	黄嘴白鹭
Dlǫ́ʼii łizhiní	黑足鼬
Wóláchííʼ yildeełí łizhin dóó łigaígíí	小食蚁兽属
Hodíłchʼil tłʼízí	鬣羚
Hakʼaz Dineʼé Bikéyahdę́ę́ʼ tábąąstííntsoh	北海狮
Dziłtah dlǫ́ʼii	香鼬
Naayééʼ tsídiitsoh	恐鳥
Atseełtsoii	红尾鵟
Tóniłhę́ęshii (dééł)	美洲鶴
Naaltsoos Mormon Wolyéhígíí	摩爾門經
Téél halchíʼí	旅鶇
Dlǫ́ʼátah néʼéshjaaʼ	穴鴞
Naʼashǫ́ʼii bijáád ádinígíí	蚓蜥
Naʼatłʼoʼii (chʼosh)	纺足目
Dííłdzid yiyání	隱翅蟲
Tsintah łéʼétsoh	林鼠屬
Tłʼéeʼgo mágí	夜猴屬
Náʼagéédíchilí	北美鼩鼴屬
Chʼil ditsʼozíłchííʼ	红毛丹
Mágíłtsooí bináázhiní	松鼠猴
Tsídiiłtsooí bitʼaʼ łizhinígíí	美洲金翅雀
Tsʼíʼii noodǫ́zí	白紋伊蚊
Anaasází	阿那萨吉人
Chʼééh digháhiitsoh	加拉帕戈斯象龜
Yeenaʼałkǫ́ʼíłániichilí	槳足綱
Naʼnízhoozhí Bił Hahoodzo	麥金萊縣
Mąʼii Deeshgiizh Bił Hahoodzo	桑多瓦爾縣
Naatoohí Bił Hahoodzo	錫沃立縣
Tábąąstííntsoh łikizhígíí	斑海豹
Ooljééʼ yiikááʼ nandahí	登陸月球
Báshdo	巴斯托 (加利福尼亞州)
Łóóʼ hashkéhé bíchį́į́hnézí	欧氏尖吻鲛
Tłʼiishtsiiʼí (łóóʼ)	鱧科
Chéłchaaʼ bideeneezígíí	長戟大兜蟲
Déłí	沙丘鹤
Ąąʼąʼiiłbáhí	灰喜鹊
Tsétah chaaʼ	山河狸
Béíyózhin	派尤特人
Tsin naabąąs	篷車
Tó Hasłeeh	曼科斯 (科罗拉多州)
Dlǫ́tsʼósí łichííʼígíí	環尾獴
2010 yihahígíí bílaʼashdlaʼii náóltahígíí	2010年美國人口普查
Tséʼédǫ́ʼii	蠅
Dahsání dah Yikahjí Tsin Deigházhígíí	豪猪亚目
Tsinaʼayąʼii biyázhí	缺翅目
Tseekʼi nástánii	羚松鼠屬
Naatooh Sikʼaiʼí	格兰茨 (新墨西哥州)
Tsooʼtsʼiní (łóóʼ)	骨舌鱼科
Tsinaʼayąʼii	白蟻
Náʼagéédí bíchį́į́h sǫʼ nahalinígíí	星鼻鼴
Naaʼahóóhai disxǫsígíí	虹雉属
Náhookǫsdę́ę́ʼ tsétah dibé	白大角羊
Neeshchʼíínímazí	榛子
Łóóʼ binááʼtsohí	大眼鯛科
Tsisteeł bikʼosneezígíí	蛇頸龜科
Nákʼeʼnáʼijiní	红胸鳾
Ałtaʼneetsʼéhii	苍耳属
Yáhashjool yił aheełtʼéhii	日鳽
Tsintah bisóoditsoh	大林猪
Tóikałí	冷蒿
Kááʼtsʼiní ditłʼooígíí	毛犰狳属
Dlǫ́ʼii yił aheełtʼéhii łibáhígíí	灰獴
Łóóʼ hashkéhé bitseeneezígíí	細尾長尾鯊
Jádí biniiʼtsʼózí	狷羚
Tábąąh jádí	水羚
Jádí binááʼ dį́įʼii	亨氏牛羚
Ásáí Dineʼé Bikéyahdę́ę́ʼ mąʼiitsoh	阿拉伯狼
Dlǫ́iitsoh bíchį́į́hdzísgaiígíí	果子狸
Sǫʼ tsisteeł	射紋龜
Chéłchaaʼtsoh	兜蟲亞科
Kʼaalógiitsoh disxǫsígíí	閃蝶屬
Tsisteeł hashkéhé	鱷龜科
Tsídiidą́ą́ʼ	天蓝绣球属
Wóniłchxoní	蝽科
Nahatʼeʼii niłchxoní	麝袋鼠
Náátsʼózídę́ę́ʼ tsiidootłʼizhii	大眼斑雉
Kéyah Dańlínídę́ę́ʼ naalʼeełí	棕頸鴨
Tiníléítsoh naʼałkǫ́ʼígíí	圆鼻巨蜥
Kézhoozhʼilí (tsin yigházhígíí)	梳齿鼠科
Jádí bideeneezígíí	劍羚
Dáádílí łikizhígíí	驼背鲈
Tsísʼná náʼagéédígíí	条蜂族
Nahatʼeʼiitsoh yázhí	丛林袋鼠属
Kʼiiłtsoii	一枝黃
Łóóʼ bigháhootʼíní	雙邊魚科
Tónhidigaii	锡尔弗顿 (科罗拉多州)
Dééłtsoh	灰颈鹭鸨
Nahatʼeʼiitsoh Danilínígíí	袋鼠亞目
Tsénáhádzoh	双子湖 (新墨西哥州)
Kéyahígíí nidineesdzaʼ	黑色风暴事件
Nahachagii dootłʼizhí	螽斯科
Nahatʼeʼiitsoh Bikéyahdę́ę́ʼ biyázhí neiyéhé	刷尾负鼠
Tsísʼnádą́ą́ʼ	天人菊屬
Łóóʼ adiłdoní	射水魚
Dlǫ́ʼii yił aheełtʼéhii łitsxooígíí	筆尾獴
Naakaii Łizhiní Bikéyahdę́ę́ʼ nahatʼeʼii	跳兔
Táłtłʼááh chʼosh chʼééh digháhii bitsʼaʼ ádinígíí	裸鰓類
Naʼashǫ́ʼii bideewozhii	刺尾飛蜥
Naalʼeełí (bílaʼashdlaʼii bilį́į́ʼ)	家鸭
Dlǫ́ʼii yił aheełtʼéhii yázhí	侏獴
Nahatʼeʼiitsoh Bikéyahdę́ę́ʼ tábąąstííntsoh	澳洲海獅
Gałbáhí	棉尾兔属
Tsékááʼgóó naagháhii (chʼosh)	螳䗛
Tłʼohtahilzhahí	叫鹤科
Táłtłʼááh tsxilghááhtsoh	隱鰓鯢科
Dibé dághaaʼígíí	日本髭羚
Chʼééh digháhii bitsiiʼntsxaaígíí	大頭龜
Tsékʼi naʼałkǫ́ʼii	比利牛斯鼬鼹
Tsídiiłtsooí	北美黃林鶯
Chʼagii	紅翅黑鸝
Dlǫ́ʼiitsoh noodǫ́zígíí	縞椰子貓
Tábąąstííntsoh łizhin dóó łigaiígíí	環海豹
Jeeshóóʼ bitsiiłgaiígíí	白頭禿鷲
Shádiʼááhdę́ę́ʼ niłchiis	巢鼬屬
Naʼazísí	囊鼠科
Łeeyiʼ chʼał dichʼízhí	异舌穴蟾
Táłtłʼááh naatʼáʼii	飛角魚科
Naakaii Dootłʼizhí Dabikéyah	南亚
Sháńdíín bitsʼą́ą́dę́ę́ʼ atsiniltłʼish álʼį́	光伏模組
Néʼétsah azeeʼ	小蓬草
Naʼastsʼǫǫsí bitsʼohígíí	纹猬属
Atsá diłhiłígíí	林鵰
Ąąʼąʼii dootłʼizhígíí	蓝绿鹊
Iichʼąhii biyázhí	粉虱科
Hashtłʼishdi tádíʼnéehii	背眼虾虎鱼亚科
Tsiikʼánii (łóóʼ ooshgę́ęzhii)	犁头鳐科
Biniiʼdootłʼizh	鵂鶹屬
Mágí biniiłgaígíí	白面僧面猴
Wónaʼałtéhii	食蟲虻
Tłʼoh azihii	麻黃屬
Kʼaalógii bitʼaʼ disxǫsgo łikizhígíí	蜆蝶科
Tiníléítsoh bikʼosnézí	荒漠巨蜥
Shádiʼááhdę́ę́ʼ gahniiʼí ntsxaaígíí	长耳豚鼠属
Łéʼétsoh bitseetłʼooígíí	非洲岩鼠
Tsídii bizééʼ naashchʼąąʼí	角雉属
Dilzhę́ʼii	暗冠蓝鸦
Mágí naashchʼąąʼígíí	白臀葉猴
Tééh jádítsoh	旋角大羚羊属
Łeeyiʼ bitiiní	田鼠
Dáádílítsoh	鞍帶石斑魚
Tsétah bįįhchilí	普度鹿属
Tsʼánídílzhiʼí	西丛鸦
Iichʼąh	驚厥
Kiisʼáanii	普韋布洛人
Dlǫ́ʼii noodǫ́zígíí	白頸鼬
Łéʼétsoh yił aheełtʼéhii	八齿鼠科
Ghą́ą́ʼdiʼilii (tsin yigházhígíí)	冠鼠亞科
Lókʼaaʼ yigházhígíí	蔗鼠
Dichin	餓死
Chį́į́hʼadeeʼii (łóóʼ)	匙吻鲟科
Hazéíntsxaaígíí	巨松鼠屬
Chąąneiłmaasii	蜣螂
Dzílí	庫柏鷹
Chʼałniiʼí (łóóʼ)	蟾魚科
Dah Naatʼaʼí Bééhoʼdílzin	效忠宣誓
Tónteel táshchozhii	燕鷗
Naʼastsʼǫǫsí noodǫ́zígíí	草鼠屬
Łóóʼ binááʼ ádiní	洞穴魚科
Mágí bichį́į́łgaígíí	红尾猴
Naakaii Bikéyahdę́ę́ʼ bįįh yázhí	短角鹿属
Naʼashǫ́ʼii dootłʼizhí (naaldeehii)	环颈蜥
Naʼashǫ́ʼiiłbáhí	沙漠鬣蜥
Łéʼétsoh gahjaaʼígíí	馬島倉鼠屬
Chʼoshtsoh bíláshgaanʼilí	基瓦多毛怪
Anáʼálwoʼ:Bee hadítʼéhígíí	Help:目录
Táłtłʼááh chʼoshtsoh bideeneezí	龍蝦
Táshchozhiizhiin	黑菲比霸鶲
Hodíílid	多洛雷斯 (科罗拉多州)
Néʼéshjaaʼkálii	姬鴞
Tiníléítsoh łikizhígíí	眼斑巨蜥
Dloziłgaii	美洲紅松鼠
Halchíítah	佩恩蒂德沙漠
Wóósitsʼílí	臭虫科
Tábąąh ndoochííʼ	绿花鹿蹄草
Kǫʼ naʼałbąąsii hééł bee nágéhéʼ	货物列车
Chʼosh chʼééh digháhii bideeʼ dį́įʼii	柄眼目
Wóláchííʼ yildeełí	食蟻獸
Niłchʼiʼ bee naalkaahiʼ	靜止環境觀測衛星
Tséʼédǫ́ʼii łibáhígíí	麻蝇
Tó Sido Háálį́	帕戈萨斯普林斯 (科罗拉多州)
Tsisteeł naʼazísí	穴龜屬
Tó Diłhił Biih Yílį́	雪花 (亚利桑那州)
Yoołgai (Hoozdoh Hahoodzo)	苏必利尔 (亚利桑那州)
Tsé Noodǫ́ǫ́z	斯皮灵威尔 (亚利桑那州)
Kin Łání (Dibé Nitsaa Hahoodzo)	杜兰戈 (科罗拉多州)
Tségháhoodzání	温多罗克
Tsé Yaatóhí	科尔特斯 (科罗拉多州)
Táłtłʼááh chʼoshtsoh bideeteelí	蟬蝦科
Chʼoshtsoh bíláshgaantsohí (tónteelgiʼígíí)	海螯蝦
Tábąąstííntsoh bighaaʼ díłchʼilígíí	海狗
Naakáí dootłʼizhí	南亞裔
Azeeʼ hókánii łibáhígíí	花叶滇苦菜
Tsiiʼnteelí (łóóʼ)	牛尾魚科
Bikétłʼááh Hoolzhólígíí	胼足亚目
Táłtłʼááh séigoʼ bitsʼaʼígíí	美洲鱟
Nááʼnoodǫ́ǫzii	遏蓝菜属
Chʼagiiłbáhí	牛鸝屬
Bitsiichįįshgahí	北美星鸦
Gólízhii bíchį́į́h tʼáá łichíiʼii	獾臭鼬
Iichʼąhii naashchʼąąʼígíí	日落蛾
Wóóseetsʼiniiniłhiní	灶馬
Tó bichʼosh (wónikǫsí nahalinígíí)	水螳螂
Gólízhii yistłʼinígíí	斑臭鼬屬
Łóóʼchilí bitʼaʼ ádaadinígíí	文昌鱼目
Aniłtʼánii (bideeneezígíí)	蝶角蛉科
Zábąąhnteelii (łóóʼ ooshgę́ęzhii)	圆犁头鳐
Sílátsoh (chʼil)	金光菊
Naaldlooshii Bikéshgaan Dahólónígíí	有蹄類
Hoshdódii	三聲夜鷹
Chʼééh digháhii bitsʼaʼ dah deezʼáhí	地圖龜
Chʼosh bitsʼaʼ doolghasígíí	扇贝
Niʼbéshjah	紫穗槐屬
Tsídii bidaatsoh naashchʼąąʼí	大嘴鳥
Chʼał bikéshgaan hólóní	爪蟾屬
Tó bichʼosh (ałchozhígíí)	划蝽科
Bidił Daazdoígíí dóó Daʼałtʼoʼígíí ałkééʼ daasdzoh	哺乳动物分类表
Nahashchʼidí yił aheełtʼéhii yázhí	鼬獾屬
Dáánézí (łóóʼ)	蝦魚科
Tsékʼi yaʼiiʼáhii	烟草天蛾
Táłkááʼ sikaadí	卷耳
Dahtooʼ yinooghałii	长嘴沼泽鹪鹩
Tʼááłáhági átʼéego:Bééshbichʼahí	Category:德国
Tʼááłáhági átʼéego:Wááshindoon bikéyah ałhidadiidzooígíí	Category:美国
Táłtłʼááh kʼaaʼ (łóóʼ)	烟管鱼科
Tʼááłáhági átʼéego:Dibé diníí bikéyah	Category:西班牙
Tʼááłáhági átʼéego:Naakaii Bikéyah	Category:墨西哥
Naalkʼįhí bizaʼazis hólóní	袋鼯属
Tsinlátah mąʼii	犬浣熊属
Tsiiyah wozhii	草地鷚屬
Chʼóyáázh nahalinígíí (táłtłʼááh chʼosh)	大旋鰓蟲
Tʼááłáhági átʼéego:Bidił daazdoígíí dóó daʼałtʼoʼígíí	Category:哺乳類
Tʼááłáhági átʼéego:Naaldlooshii dadichʼízhii	Category:爬行動物
Tʼááłáhági átʼéego:Biyáázh Tsʼǫʼasánígíí	Category:兩棲類
Tʼááłáhági átʼéego:Tsídii	Category:鸟类
Tʼááłáhági átʼéego:Chʼosh doo yitʼíinii dláádí dóó Ábishjaaʼ	Category:真菌
Tʼááłáhági átʼéego:Chʼil	Category:植物
Tʼááłáhági átʼéego:Nátʼą́ą́ʼ náháneʼ	Category:历史
Tʼááłáhági átʼéego:Naʼalkaah	Category:科学
Azeeʼ ndootʼeezhítsoh	拟美国薄荷
Łóóʼtsoh bizábąąh shiyishí	露脊鯨
Iichʼąhii	蛾
Chʼoshtsoh yázhí bíláshgaantsohí	鎧甲蝦類
Roman dinéʼiʼ	古罗马
Shádiʼááhdę́ę́ʼ tsékʼi dlǫ́ǫ́ʼ	岩豚鼠
Naabeehó	纳瓦霍族保留地
Chʼoshtsoh bikágí diwozhí	皇帝蟹
Tábąąh béégashii ałchiní	河水牛
Dáádílí ntsxaaígíí	伊氏石斑魚
Tʼááłáhági átʼéego:Ałtsʼáʼáztiin	Category:消歧义
Tsintah bįįhchilí	鼷鹿属
Tʼiistsʼóóz	窄叶杨
Sǫʼtsoh nátʼoh	黄线柳
Atsá	鵰
Séíbéʼézhóóʼ	乱子草属
Ndilnaʼii	树懒
Tsísʼnáyázhí	集蜂科
Bíina	伊格纳西奥 (科罗拉多州)
Dą́ʼáchaan	黑粉菌属
Yaaʼ	螨
Beeʼaghádaʼdildlaadí	X射线机
Íijeehí	鹤虱属
Jááłánii noodǫ́zígíí	亞利桑那沙漠蜈蚣
Nááʼ łitsooí	银叶茄
Tłʼoh nástasí	格兰马草
Tʼááłáhági átʼéego:Stubs	Category:小作品
Tʼááłáhági átʼéego:Chidí naatʼaʼí	Category:航空器
Tsékʼi naʼazólii yistłʼinígíí	聖埃斯特萬島黑叩壁蜥
Niʼdiidlídii	长毛落芒草
Azeeʼ shaazhí	水葫芦苗
Bee álnééhí:User uk-2	Template:User uk-2
Azeeʼ sikʼazí	小花山桃草
Hosh Dikʼání	安德森台地
Tʼááłáhági átʼéego:Wikipedia bots	Category:維基百科機器人
Niłtsínii bikétłʼóól dijoolí (daadánígíí)	芜菁
Bee álnééhí:Tl	Template:Tl
Tʼááłáhági átʼéego:Bee Hazʼáanii	Category:法学
Tʼááłáhági átʼéego:Kéyah daʼnaaznilígíí dóó kéyah biłhaʼdaʼhaasdzoígíí	Category:国家
Wikiibíídiiya:Dahwéetʼaahígíí	Wikipedia:管理员
Wikiibíídiiya:Botígíí beehazʼą́ąnii	Wikipedia:机器人
Ííjip	埃及
Dlodziłgaii bitseeʼ (tłʼoh)	长芒棒头草
Bee álnééhí:Bot	Template:Bot
Deeteel Bikéyah	加拿大
Wikiibíídiiya:Baa haneʼ	Wikipedia:关于
Tʼááłáhági átʼéego:Béésh bichʼahníí bikéyah	Category:欧洲国家
Tʼááłáhági átʼéego:Choyoołʼįįhí Bizaad	Category:用户语言
Anáʼálwoʼ:Wikiibíídiiya beehazʼą́ąnii	Wikipedia:方針與指引
Tséłnííʼjí (chʼil)	鐵線蕨
Bee álnééhí:Softredirect	Template:軟重定向
Chʼosh chʼééh digháhii	腹足纲
Tłʼoh hosh	蒺藜草
Tʼááłáhági átʼéego:Saad	Category:语言
Wikiibíídiiya:General disclaimer	Wikipedia:免责声明
Tʼááłáhági átʼéego:Noindexed pages	Category:不可索引页面
Wikiibíídiiya:Statistics	Wikipedia:统计
Nahatʼeʼiitsoh	袋鼠
Łóóʼ hashkéhéchilí	银鲛目
Tʼááłáhági átʼéego:Living people	Category:在世人物
Tʼááłáhági átʼéego:Béésh bee akʼeʼelchíhí tʼáá bí nitsékeesígíí	Category:计算
Bee álnééhí:Bots	Template:Bots
Tʼááłáhági átʼéego:Naaltsoos	Category:書籍
Bee álnééhí:Wikisource	Template:Wikisource
Bee álnééhí:Babel	Template:Babel
Bee álnééhí:Commons	Template:Commons
Bee álnééhí:Reflist	Template:Reflist
Bee álnééhí:Stub	Template:Stub
Bee álnééhí:User af-1	Template:User af-1
Bee álnééhí:User ar-1	Template:User ar-1
Bee álnééhí:User az	Template:User az
Bee álnééhí:User bar-1	Template:User bar-1
Bee álnééhí:User eo-1	Template:User eo-1
Bee álnééhí:See also	Template:See also
Bee álnééhí:User da-2	Template:User da-2
Bee álnééhí:User da	Template:User da
Bee álnééhí:User ca-1	Template:User ca-1
Bee álnééhí:User ca-4	Template:User ca-4
Bee álnééhí:User be-2	Template:User be-2
Bee álnééhí:User da-1	Template:User da-1
Bee álnééhí:User cs-1	Template:User cs-1
Bee álnééhí:User bg-1	Template:User bg-1
Bee álnééhí:User eo-3	Template:User eo-3
Bee álnééhí:User de	Template:User de
Bee álnééhí:User de-1	Template:User de-1
Bee álnééhí:User eu-4	Template:User eu-4
Bee álnééhí:User eu	Template:User eu
Bee álnééhí:User et-1	Template:User et-1
Bee álnééhí:User el	Template:User el
Bee álnééhí:User es	Template:User es
Bee álnééhí:User de-3	Template:User de-3
Bee álnééhí:User en-3	Template:User en-3
Bee álnééhí:User el-1	Template:User el-1
Bee álnééhí:User en-1	Template:User en-1
Bee álnééhí:User en-2	Template:User en-2
Bee álnééhí:User fa-1	Template:User fa-1
Bee álnééhí:User eo-2	Template:User eo-2
Bee álnééhí:User en-4	Template:User en-4
Bee álnééhí:User fi	Template:User fi
Bee álnééhí:User en-0	Template:User en-0
Bee álnééhí:User es-4	Template:User es-4
Bee álnééhí:User en	Template:User en
Bee álnééhí:User de-2	Template:User de-2
Bee álnééhí:User es-1	Template:User es-1
Bee álnééhí:User fa	Template:User fa
Bee álnééhí:User fi-1	Template:User fi-1
Bee álnééhí:User fr-1	Template:User fr-1
Bee álnééhí:User ia-2	Template:User ia-2
Bee álnééhí:User hi-1	Template:User hi-1
Bee álnééhí:User hr	Template:User hr
Bee álnééhí:User he-2	Template:User he-2
Bee álnééhí:User he-1	Template:User he-1
Bee álnééhí:User hu	Template:User hu
Bee álnééhí:User id-3	Template:User id-3
Bee álnééhí:User io-3	Template:User io-3
Bee álnééhí:User it-3	Template:User it-3
Bee álnééhí:User grc-1	Template:User grc-1
Bee álnééhí:User ja-4	Template:User ja-4
Bee álnééhí:User sk	Template:User sk
Bee álnééhí:User tr-2	Template:User tr-2
Bee álnééhí:User fr-2	Template:User fr-2
Bee álnééhí:User tr	Template:User tr
Bee álnééhí:User ja	Template:User ja
Bee álnééhí:User ja-1	Template:User ja-1
Bee álnééhí:User it-1	Template:User it-1
Bee álnééhí:User hr-1	Template:User hr-1
Bee álnééhí:User fr	Template:User fr
Bee álnééhí:User gsw-1	Template:User gsw-1
Bee álnééhí:User he	Template:User he
Tʼááłáhági átʼéego:Chʼosh bijáád hastánígíí	Category:昆蟲綱
Tʼááłáhági átʼéego:Choyoołʼįįhí uk	Category:Uk 使用者
Tʼááłáhági átʼéego:Choyoołʼįįhí uk-N	Category:Uk 母語使用者
Tʼááłáhági átʼéego:Chʼiyáán	Category:食品
Bee álnééhí:User sv	Template:User sv
Bee álnééhí:SIL	Template:SIL
Bee álnééhí:User it	Template:User it
Bee álnééhí:User uk	Template:User uk
Bee álnééhí:User es-2	Template:User es-2
Tʼááłáhági átʼéego:Choyoołʼįįhí ms	Category:Ms 使用者
Tʼááłáhági átʼéego:Choyoołʼįįhí fr-1	Category:Fr-1 使用者
Bee álnééhí:Image label	Template:Image label
Bee álnééhí:User ms	Template:User ms
Tʼááłáhági átʼéego:Atsá dóó Giní Ndahalinígíí	Category:隼形目
Bee álnééhí:User hi-3	Template:User hi-3
Tʼááłáhági átʼéego:Choyoołʼįįhí en-4	Category:En-4 使用者
Tʼááłáhági átʼéego:Choyoołʼįįhí en	Category:En 使用者
Tʼááłáhági átʼéego:Choyoołʼįįhí zh	Category:Zh 使用者
Tʼááłáhági átʼéego:Choyoołʼįįhí zh-N	Category:Zh 母语使用者
Tʼááłáhági átʼéego:Choyoołʼįįhí en-2	Category:En-2 使用者
Bee álnééhí:User eo	Template:User eo
Bee álnééhí:User zh	Template:User zh
Bee álnééhí:User ru-4	Template:User ru-4
Bee álnééhí:User sr	Template:User sr
Bee álnééhí:GeoTemplate	Template:GeoTemplate
Bee álnééhí:User nl-1	Template:User nl-1
Bee álnééhí:User nl-2	Template:User nl-2
Tʼááłáhági átʼéego:Néʼéshjaaʼ	Category:鸱鸮科
Tʼááłáhági átʼéego:Choyoołʼįįhí hi	Category:Hi 使用者
Tʼááłáhági átʼéego:Choyoołʼįįhí ms-N	Category:Ms 母語使用者
Tʼááłáhági átʼéego:Dził	Category:山
Bee álnééhí:User ru	Template:User ru
Tʼááłáhági átʼéego:Kéyah yádiłhił biiʼ dahólónígíí	Category:太阳系行星
Tʼááłáhági átʼéego:Kéyah dah siʼánígíí	Category:美洲
Bee álnééhí:Archive	Template:Archive box
Bee álnééhí:User eo-4	Template:User eo-4
Bee álnééhí:PD-US-gov	Template:PD-USGov
Tʼááłáhági átʼéego:Siláołtsooí	Category:军事
Tʼááłáhági átʼéego:Naʼashǫ́ʼii	Category:蜥蜴
Bee álnééhí:User pt-1	Template:User pt-1
Bee álnééhí:Tb	Template:Talkback
Bee álnééhí:Pt elements	Template:元素週期表
Bee álnééhí:User oc-4	Template:User oc-4
Bee álnééhí:User pl	Template:User pl
Bee álnééhí:User nl	Template:User nl
Bee álnééhí:User no-2	Template:User no-2
Bee álnééhí:Image label end	Template:Image label end
Bee álnééhí:Userpage	Template:Userpage
Bee álnééhí:Emergency-bot-shutoff	Template:Emergency-bot-shutoff
Bee álnééhí:User pl-1	Template:User pl-1
Bee álnééhí:Image label small	Template:Image label small
Bee álnééhí:User fr-3	Template:User fr-3
Tʼááłáhági átʼéego:Choyoołʼįįhí gsw-4	Category:Gsw-4 使用者
Bee álnééhí:User lt	Template:User lt
Bee álnééhí:User nds-1	Template:User nds-1
Tʼááłáhági átʼéego:Hosh	Category:仙人掌科
Bee álnééhí:User tr-4	Template:User tr-4
Bee álnééhí:User is-1	Template:User is-1
Bee álnééhí:User is-2	Template:User is-2
Bee álnééhí:User ar-2	Template:User ar-2
Bee álnééhí:User ar-3	Template:User ar-3
Bee álnééhí:User is	Template:User is
Bee álnééhí:User ar	Template:User ar
Bee álnééhí:User az-3	Template:User az-3
Bee álnééhí:User en-5	Template:User en-5
Tʼááłáhági átʼéego:Choyoołʼįįhí ja-N	Category:Ja 母语使用者
Bee álnééhí:User als	Template:User gsw
Bee álnééhí:@	Template:@
Tʼááłáhági átʼéego:Tłʼoh	Category:禾本科
Bee álnééhí:Ałtsʼáʼáztiin	Template:Disambig
Bee álnééhí:User no-3	Template:User no-3
Bee álnééhí:User ksh	Template:User ksh
Bee álnééhí:User yue-3	Template:User zh-yue-3
Bee álnééhí:User no	Template:User no
Bee álnééhí:User yue-1	Template:User zh-yue-1
Bee álnééhí:Chʼiyáánbiiʼ	Template:营养值
Bee álnééhí:Naʼalkaah	Template:Science
Bee álnééhí:User sv-2	Template:User sv-2
Tʼááłáhági átʼéego:Choyoołʼįįhí gsw-1	Category:Gsw-1 使用者
Bee álnééhí:User it-2	Template:User it-2
Tʼááłáhági átʼéego:Kǫʼ naʼałbąąsii	Category:鐵路
Tʼááłáhági átʼéego:Choyoołʼįįhí gsw-2	Category:Gsw-2 使用者
Bee álnééhí:User pt-3	Template:User pt-3
Bee álnééhí:User pt-2	Template:User pt-2
Bee álnééhí:User th-1	Template:User th-1
Bee álnééhí:User lb-1	Template:User lb-1
Bee álnééhí:User ro-4	Template:User ro-4
Bee álnééhí:User ro	Template:User ro
Bee álnééhí:User fr-4	Template:User fr-4
Bee álnééhí:User lv	Template:User lv
Bee álnééhí:User bg	Template:User bg
Tʼááłáhági átʼéego:Choyoołʼįįhí vi-3	Category:Vi-3 使用者
Bee álnééhí:User la-1	Template:User la-1
Tʼááłáhági átʼéego:Templates/doc	Category:模板說明文件
Tʼááłáhági átʼéego:Choyoołʼįįhí yue	Category:Zh-yue 使用者
Tʼááłáhági átʼéego:Choyoołʼįįhí pdc	Category:Pdc 使用者
Tʼááłáhági átʼéego:Choyoołʼįįhí mzn	Category:Mzn 使用者
Tʼááłáhági átʼéego:Choyoołʼįįhí at	Category:De-at 使用者
Tʼááłáhági átʼéego:Choyoołʼįįhí az	Category:Az 使用者
Tʼááłáhági átʼéego:Choyoołʼįįhí be	Category:Be 使用者
Tʼááłáhági átʼéego:Choyoołʼįįhí nb-N	Category:Nb 母语使用者
Tʼááłáhági átʼéego:Choyoołʼįįhí bs	Category:Bs 使用者
Tʼááłáhági átʼéego:Choyoołʼįįhí chr	Category:Chr 使用者
Tʼááłáhági átʼéego:Choyoołʼįįhí hr	Category:Hr 使用者
Tʼááłáhági átʼéego:Choyoołʼįįhí sk	Category:Sk 使用者
Tʼááłáhági átʼéego:Choyoołʼįįhí sl	Category:Sl 使用者
Tʼááłáhági átʼéego:Choyoołʼįįhí eo	Category:Eo 使用者
Tʼááłáhági átʼéego:Choyoołʼįįhí et	Category:Et 使用者
Tʼááłáhági átʼéego:Choyoołʼįįhí fr	Category:Fr 使用者
Tʼááłáhági átʼéego:Choyoołʼįįhí gl	Category:Gl 使用者
Tʼááłáhági átʼéego:Choyoołʼįįhí cy	Category:Cy 使用者
Tʼááłáhági átʼéego:Choyoołʼįįhí gn	Category:Gn 使用者
Tʼááłáhági átʼéego:Choyoołʼįįhí hu-N	Category:Hu 母語使用者
Tʼááłáhági átʼéego:Choyoołʼįįhí id	Category:Id 使用者
Tʼááłáhági átʼéego:Choyoołʼįįhí ia	Category:Ia 使用者
Tʼááłáhági átʼéego:Choyoołʼįįhí ga	Category:Ga 使用者
Tʼááłáhági átʼéego:Choyoołʼįįhí ja	Category:Ja 使用者
Tʼááłáhági átʼéego:Choyoołʼįįhí km	Category:Km 使用者
Tʼááłáhági átʼéego:Choyoołʼįįhí rn	Category:Rn 使用者
Tʼááłáhági átʼéego:Choyoołʼįįhí la	Category:La 使用者
Tʼááłáhági átʼéego:Choyoołʼįįhí li	Category:Li 使用者
Tʼááłáhági átʼéego:Choyoołʼįįhí lt	Category:Lt 使用者
Tʼááłáhági átʼéego:Choyoołʼįįhí mk	Category:Mk 使用者
Tʼááłáhági átʼéego:Choyoołʼįįhí mg	Category:Mg 使用者
Tʼááłáhági átʼéego:Choyoołʼįįhí mwl	Category:Mwl 使用者
Tʼááłáhági átʼéego:Choyoołʼįįhí mn	Category:Mn 使用者
Tʼááłáhági átʼéego:Choyoołʼįįhí nn	Category:Nn 使用者
Tʼááłáhági átʼéego:Choyoołʼįįhí nah	Category:Nah 使用者
Tʼááłáhági átʼéego:Choyoołʼįįhí oc	Category:Oc 使用者
Tʼááłáhági átʼéego:Choyoołʼįįhí pt	Category:Pt 使用者
Tʼááłáhági átʼéego:Choyoołʼįįhí ro	Category:Ro 使用者
Tʼááłáhági átʼéego:Choyoołʼįįhí sc	Category:Sc 使用者
Tʼááłáhági átʼéego:Choyoołʼįįhí sh	Category:Sh 使用者
Tʼááłáhági átʼéego:Choyoołʼįįhí sv	Category:Sv 使用者
Tʼááłáhági átʼéego:Choyoołʼįįhí sw	Category:Sw 使用者
Tʼááłáhági átʼéego:Choyoołʼįįhí sa	Category:Sa 使用者
Tʼááłáhági átʼéego:Choyoołʼįįhí th	Category:Th 使用者
Tʼááłáhági átʼéego:Choyoołʼįįhí ta	Category:Ta 使用者
Tʼááłáhági átʼéego:Choyoołʼįįhí vo	Category:Vo 使用者
Tʼááłáhági átʼéego:Choyoołʼįįhí az-3	Category:Az-3 使用者
Tʼááłáhági átʼéego:Choyoołʼįįhí be-3	Category:Be-3 使用者
Tʼááłáhági átʼéego:Choyoołʼįįhí cs-3	Category:Cs-3 使用者
Tʼááłáhági átʼéego:Choyoołʼįįhí sl-3	Category:Sl-3 使用者
Tʼááłáhági átʼéego:Choyoołʼįįhí fr-3	Category:Fr-3 使用者
Tʼááłáhági átʼéego:Choyoołʼįįhí cy-3	Category:Cy-3 使用者
Tʼááłáhági átʼéego:Choyoołʼįįhí hi-3	Category:Hi-3 使用者
Tʼááłáhági átʼéego:Choyoołʼįįhí ia-3	Category:Ia-3 使用者
Tʼááłáhági átʼéego:Choyoołʼįįhí it-3	Category:It-3 使用者
Tʼááłáhági átʼéego:Choyoołʼįįhí ja-3	Category:Ja-3 使用者
Tʼááłáhági átʼéego:Choyoołʼįįhí li-3	Category:Li-3 使用者
Tʼááłáhági átʼéego:Choyoołʼįįhí lt-3	Category:Lt-3 使用者
Tʼááłáhági átʼéego:Choyoołʼįįhí mk-3	Category:Mk-3 使用者
Tʼááłáhági átʼéego:Choyoołʼįįhí nl-3	Category:Nl-3 使用者
Tʼááłáhági átʼéego:Choyoołʼįįhí no-3	Category:No-3 使用者
Tʼááłáhági átʼéego:Choyoołʼįįhí nah-3	Category:Nah-3 使用者
Tʼááłáhági átʼéego:Choyoołʼįįhí oc-3	Category:Oc-3 使用者
Tʼááłáhági átʼéego:Choyoołʼįįhí pl-3	Category:Pl-3 使用者
Tʼááłáhági átʼéego:Choyoołʼįįhí sh-3	Category:Sh-3 使用者
Tʼááłáhági átʼéego:Choyoołʼįįhí sw-3	Category:Sw-3 使用者
Tʼááłáhági átʼéego:Choyoołʼįįhí sa-3	Category:Sa-3 使用者
Tʼááłáhági átʼéego:Choyoołʼįįhí ta-3	Category:Ta-3 使用者
Tʼááłáhági átʼéego:Choyoołʼįįhí tr-3	Category:Tr-3 使用者
Tʼááłáhági átʼéego:Choyoołʼįįhí ar-3	Category:Ar-3 使用者
Tʼááłáhági átʼéego:Choyoołʼįįhí pdc-1	Category:Pdc-1 使用者
Tʼááłáhági átʼéego:Choyoołʼįįhí an-1	Category:An-1 使用者
Tʼááłáhági átʼéego:Choyoołʼįįhí be-1	Category:Be-1 使用者
Tʼááłáhági átʼéego:Choyoołʼįįhí cs-1	Category:Cs-1 使用者
Tʼááłáhági átʼéego:Choyoołʼįįhí da-1	Category:Da-1 使用者
Tʼááłáhági átʼéego:Choyoołʼįįhí sl-1	Category:Sl-1 使用者
Tʼááłáhági átʼéego:Choyoołʼįįhí et-1	Category:Et-1 使用者
Tʼááłáhági átʼéego:Choyoołʼįįhí fi-1	Category:Fi-1 使用者
Tʼááłáhági átʼéego:Choyoołʼįįhí cy-1	Category:Cy-1 使用者
Tʼááłáhági átʼéego:Choyoołʼįįhí hi-1	Category:Hi-1 使用者
Tʼááłáhági átʼéego:Choyoołʼįįhí ia-1	Category:Ia-1 使用者
Tʼááłáhági átʼéego:Choyoołʼįįhí ga-1	Category:Ga-1 使用者
Tʼááłáhági átʼéego:Choyoołʼįįhí jv-1	Category:Jv-1 使用者
Tʼááłáhági átʼéego:Choyoołʼįįhí ku-1	Category:Ku-1 使用者
Tʼááłáhági átʼéego:Choyoołʼįįhí lv-1	Category:Lv-1 使用者
Tʼááłáhági átʼéego:Choyoołʼįįhí li-1	Category:Li-1 使用者
Tʼááłáhági átʼéego:Choyoołʼįįhí lt-1	Category:Lt-1 使用者
Tʼááłáhági átʼéego:Choyoołʼįįhí mk-1	Category:Mk-1 使用者
Tʼááłáhági átʼéego:Choyoołʼįįhí nl-1	Category:Nl-1 使用者
Tʼááłáhági átʼéego:Choyoołʼįįhí nah-1	Category:Nah-1 使用者
Tʼááłáhági átʼéego:Choyoołʼįįhí oc-1	Category:Oc-1 使用者
Tʼááłáhági átʼéego:Choyoołʼįįhí pl-1	Category:Pl-1 使用者
Tʼááłáhági átʼéego:Choyoołʼįįhí ro-1	Category:Ro-1 使用者
Tʼááłáhági átʼéego:Choyoołʼįįhí sc-1	Category:Sc-1 使用者
Tʼááłáhági átʼéego:Choyoołʼįįhí sh-1	Category:Sh-1 使用者
Tʼááłáhági átʼéego:Choyoołʼįįhí sw-1	Category:Sw-1 使用者
Tʼááłáhági átʼéego:Choyoołʼįįhí sa-1	Category:Sa-1 使用者
Tʼááłáhági átʼéego:Choyoołʼįįhí tr-1	Category:Tr-1 使用者
Tʼááłáhági átʼéego:Choyoołʼįįhí vo-1	Category:Vo-1 使用者
Tʼááłáhági átʼéego:Choyoołʼįįhí ar-1	Category:Ar-1 使用者
Tʼááłáhági átʼéego:Choyoołʼįįhí be-4	Category:Be-4 使用者
Tʼááłáhági átʼéego:Choyoołʼįįhí cs-4	Category:Cs-4 使用者
Tʼááłáhági átʼéego:Choyoołʼįįhí ko-4	Category:Ko-4 使用者
Tʼááłáhági átʼéego:Choyoołʼįįhí sl-4	Category:Sl-4 使用者
Tʼááłáhági átʼéego:Choyoołʼįįhí fr-4	Category:Fr-4 使用者
Tʼááłáhági átʼéego:Choyoołʼįįhí cy-4	Category:Cy-4 使用者
Tʼááłáhági átʼéego:Choyoołʼįįhí hi-4	Category:Hi-4 使用者
Tʼááłáhági átʼéego:Choyoołʼįįhí hu-4	Category:Hu-4 使用者
Tʼááłáhági átʼéego:Choyoołʼįįhí id-4	Category:Id-4 使用者
Tʼááłáhági átʼéego:Choyoołʼįįhí ia-4	Category:Ia-4 使用者
Tʼááłáhági átʼéego:Choyoołʼįįhí it-4	Category:It-4 使用者
Tʼááłáhági átʼéego:Choyoołʼįįhí li-4	Category:Li-4 使用者
Tʼááłáhági átʼéego:Choyoołʼįįhí lt-4	Category:Lt-4 使用者
Tʼááłáhági átʼéego:Choyoołʼįįhí mk-4	Category:Mk-4 使用者
Tʼááłáhági átʼéego:Choyoołʼįįhí nah-4	Category:Nah-4 使用者
Tʼááłáhági átʼéego:Choyoołʼįįhí oc-4	Category:Oc-4 使用者
Tʼááłáhági átʼéego:Choyoołʼįįhí pl-4	Category:Pl-4 使用者
Tʼááłáhági átʼéego:Choyoołʼįįhí sw-4	Category:Sw-4 使用者
Tʼááłáhági átʼéego:Choyoołʼįįhí ar-4	Category:Ar-4 使用者
Tʼááłáhági átʼéego:Choyoołʼįįhí mzn-2	Category:Mzn-2 使用者
Tʼááłáhági átʼéego:Choyoołʼįįhí be-2	Category:Be-2 使用者
Tʼááłáhági átʼéego:Choyoołʼįįhí bs-2	Category:Bs-2 使用者
Tʼááłáhági átʼéego:Choyoołʼįįhí cs-2	Category:Cs-2 使用者
Tʼááłáhági átʼéego:Choyoołʼįįhí da-2	Category:Da-2 使用者
Tʼááłáhági átʼéego:Choyoołʼįįhí sk-2	Category:Sk-2 使用者
Tʼááłáhági átʼéego:Choyoołʼįįhí sl-2	Category:Sl-2 使用者
Tʼááłáhági átʼéego:Choyoołʼįįhí fr-2	Category:Fr-2 使用者
Tʼááłáhági átʼéego:Choyoołʼįįhí cy-2	Category:Cy-2 使用者
Tʼááłáhági átʼéego:Choyoołʼįįhí hi-2	Category:Hi-2 使用者
Tʼááłáhági átʼéego:Choyoołʼįįhí hu-2	Category:Hu-2 使用者
Tʼááłáhági átʼéego:Choyoołʼįįhí ia-2	Category:Ia-2 使用者
Tʼááłáhági átʼéego:Choyoołʼįįhí it-2	Category:It-2 使用者
Tʼááłáhági átʼéego:Choyoołʼįįhí ja-2	Category:Ja-2 使用者
Tʼááłáhági átʼéego:Choyoołʼįįhí la-2	Category:La-2 使用者
Tʼááłáhági átʼéego:Choyoołʼįįhí li-2	Category:Li-2 使用者
Tʼááłáhági átʼéego:Choyoołʼįįhí lt-2	Category:Lt-2 使用者
Tʼááłáhági átʼéego:Choyoołʼįįhí mk-2	Category:Mk-2 使用者
Tʼááłáhági átʼéego:Choyoołʼįįhí mwl-2	Category:Mwl-2 使用者
Tʼááłáhági átʼéego:Choyoołʼįįhí nl-2	Category:Nl-2 使用者
Tʼááłáhági átʼéego:Choyoołʼįįhí nah-2	Category:Nah-2 使用者
Tʼááłáhági átʼéego:Choyoołʼįįhí oc-2	Category:Oc-2 使用者
Tʼááłáhági átʼéego:Choyoołʼįįhí pl-2	Category:Pl-2 使用者
Tʼááłáhági átʼéego:Choyoołʼįįhí sh-2	Category:Sh-2 使用者
Tʼááłáhági átʼéego:Choyoołʼįįhí sv-2	Category:Sv-2 使用者
Tʼááłáhági átʼéego:Choyoołʼįįhí sw-2	Category:Sw-2 使用者
Tʼááłáhági átʼéego:Choyoołʼįįhí sa-2	Category:Sa-2 使用者
Tʼááłáhági átʼéego:Choyoołʼįįhí tr-2	Category:Tr-2 使用者
Tʼááłáhági átʼéego:Choyoołʼįįhí vo-2	Category:Vo-2 使用者
Tʼááłáhági átʼéego:Choyoołʼįįhí ar-2	Category:Ar-2 使用者
Tʼááłáhági átʼéego:Choyoołʼįįhí ast-N	Category:Ast 母语使用者
Tʼááłáhági átʼéego:Choyoołʼįįhí be-N	Category:Be 母語使用者
Tʼááłáhági átʼéego:Choyoołʼįįhí cs-N	Category:Cs 母語使用者
Tʼááłáhági átʼéego:Choyoołʼįįhí ko-N	Category:Ko 母語使用者
Tʼááłáhági átʼéego:Choyoołʼįįhí hr-N	Category:Hr 母語使用者
Tʼááłáhági átʼéego:Choyoołʼįįhí sl-N	Category:Sl 母語使用者
Tʼááłáhági átʼéego:Choyoołʼįįhí fr-N	Category:Fr 母語使用者
Tʼááłáhági átʼéego:Choyoołʼįįhí fy-N	Category:Fy 母語使用者
Tʼááłáhági átʼéego:Choyoołʼįįhí gl-N	Category:Gl 母語使用者
Tʼááłáhági átʼéego:Choyoołʼįįhí hi-N	Category:Hi 母语使用者
Tʼááłáhági átʼéego:Choyoołʼįįhí id-N	Category:Id 母語使用者
Tʼááłáhági átʼéego:Choyoołʼįįhí is-N	Category:Is 母語使用者
Tʼááłáhági átʼéego:Choyoołʼįįhí it-N	Category:It 母語使用者
Tʼááłáhági átʼéego:Choyoołʼįįhí jv-N	Category:Jv 母語使用者
Tʼááłáhági átʼéego:Choyoołʼįįhí ku-N	Category:Ku 母语使用者
Tʼááłáhági átʼéego:Choyoołʼįįhí lv-N	Category:Lv 母語使用者
Tʼááłáhági átʼéego:Choyoołʼįįhí li-N	Category:Li 母語使用者
Tʼááłáhági átʼéego:Choyoołʼįįhí lt-N	Category:Lt 母語使用者
Tʼááłáhági átʼéego:Choyoołʼįįhí lb-N	Category:Lb 母語使用者
Tʼááłáhági átʼéego:Choyoołʼįįhí mk-N	Category:Mk 母語使用者
Tʼááłáhági átʼéego:Choyoołʼįįhí mg-N	Category:Mg 母语使用者
Tʼááłáhági átʼéego:Choyoołʼįįhí nl-N	Category:Nl 母語使用者
Tʼááłáhági átʼéego:Choyoołʼįįhí no-N	Category:No 母語使用者
Tʼááłáhági átʼéego:Choyoołʼįįhí nn-N	Category:Nn 母語使用者
Tʼááłáhági átʼéego:Choyoołʼįįhí nah-N	Category:Nah 母语使用者
Tʼááłáhági átʼéego:Choyoołʼįįhí oc-N	Category:Oc 母語使用者
Tʼááłáhági átʼéego:Choyoołʼįįhí or-N	Category:Or 母語使用者
Tʼááłáhági átʼéego:Choyoołʼįįhí ru-N	Category:Ru 母語使用者
Tʼááłáhági átʼéego:Choyoołʼįįhí sh-N	Category:Sh 母语使用者
Tʼááłáhági átʼéego:Choyoołʼįįhí sw-N	Category:Sw 母語使用者
Tʼááłáhági átʼéego:Choyoołʼįįhí ar-N	Category:Ar 母语使用者
Bee álnééhí:User yue	Template:User zh-yue
Bee álnééhí:User pdc-1	Template:User pdc-1
Tʼááłáhági átʼéego:Choyoołʼįįhí eu-3	Category:Eu-3 使用者
Tʼááłáhági átʼéego:Choyoołʼįįhí eu-N	Category:Eu 母語使用者
Tʼááłáhági átʼéego:Choyoołʼįįhí af	Category:Af 使用者
Tʼááłáhági átʼéego:Choyoołʼįįhí af-1	Category:Af-1 使用者
Tʼááłáhági átʼéego:Choyoołʼįįhí af-2	Category:Af-2 使用者
Tʼááłáhági átʼéego:Choyoołʼįįhí af-3	Category:Af-3 使用者
Tʼááłáhági átʼéego:Choyoołʼįįhí als	Category:Als 使用者
Tʼááłáhági átʼéego:Choyoołʼįįhí an	Category:An 使用者
Tʼááłáhági átʼéego:Choyoołʼįįhí ar	Category:Ar 使用者
Tʼááłáhági átʼéego:Choyoołʼįįhí as	Category:As 使用者
Tʼááłáhági átʼéego:Choyoołʼįįhí ast	Category:Ast 使用者
Tʼááłáhági átʼéego:Choyoołʼįįhí az-1	Category:Az-1 使用者
Tʼááłáhági átʼéego:Choyoołʼįįhí az-2	Category:Az-2 使用者
Tʼááłáhági átʼéego:Choyoołʼįįhí az-4	Category:Az-4 使用者
Tʼááłáhági átʼéego:Choyoołʼįįhí az-N	Category:Az 母語使用者
Tʼááłáhági átʼéego:Choyoołʼįįhí bar	Category:Bar 使用者
Tʼááłáhági átʼéego:Choyoołʼįįhí bar-1	Category:Bar-1 使用者
Tʼááłáhági átʼéego:Choyoołʼįįhí bg	Category:Bg 使用者
Tʼááłáhági átʼéego:Choyoołʼįįhí bg-1	Category:Bg-1 使用者
Tʼááłáhági átʼéego:Choyoołʼįįhí bg-2	Category:Bg-2 使用者
Tʼááłáhági átʼéego:Choyoołʼįįhí bg-3	Category:Bg-3 使用者
Tʼááłáhági átʼéego:Choyoołʼįįhí bg-N	Category:Bg 母语使用者
Tʼááłáhági átʼéego:Choyoołʼįįhí bn	Category:Bn 使用者
Tʼááłáhági átʼéego:Choyoołʼįįhí bn-2	Category:Bn-2 使用者
Tʼááłáhági átʼéego:Choyoołʼįįhí ca	Category:Ca 使用者
Tʼááłáhági átʼéego:Choyoołʼįįhí ca-1	Category:Ca-1 使用者
Tʼááłáhági átʼéego:Choyoołʼįįhí ca-2	Category:Ca-2 使用者
Tʼááłáhági átʼéego:Tádídíín deiyání	Category:金花蟲科
Tʼááłáhági átʼéego:Choyoołʼįįhí ca-3	Category:Ca-3 使用者
Tʼááłáhági átʼéego:Choyoołʼįįhí ca-4	Category:Ca-4 使用者
Tʼááłáhági átʼéego:Choyoołʼįįhí ca-N	Category:Ca 母語使用者
Tʼááłáhági átʼéego:Choyoołʼįįhí cr	Category:Cr 使用者
Tʼááłáhági átʼéego:Choyoołʼįįhí cs	Category:Cs 使用者
Tʼááłáhági átʼéego:Choyoołʼįįhí csb	Category:Csb 使用者
Tʼááłáhági átʼéego:Choyoołʼįįhí csb-1	Category:Csb-1 使用者
Tʼááłáhági átʼéego:Choyoołʼįįhí da	Category:Da 使用者
Tʼááłáhági átʼéego:Choyoołʼįįhí sk-N	Category:Sk 母語使用者
Tʼááłáhági átʼéego:Choyoołʼįįhí da-3	Category:Da-3 使用者
Tʼááłáhági átʼéego:Choyoołʼįįhí da-4	Category:Da-4 使用者
Tʼááłáhági átʼéego:Choyoołʼįįhí de	Category:De 使用者
Tʼááłáhági átʼéego:Choyoołʼįįhí de-2	Category:De-2 使用者
Tʼááłáhági átʼéego:Choyoołʼįįhí de-3	Category:De-3 使用者
Tʼááłáhági átʼéego:Choyoołʼįįhí de-4	Category:De-4 使用者
Tʼááłáhági átʼéego:Choyoołʼįįhí de-N	Category:De 母語使用者
Tʼááłáhági átʼéego:Choyoołʼįįhí dsb	Category:Dsb 使用者
Tʼááłáhági átʼéego:Choyoołʼįįhí dsb-1	Category:Dsb-1 使用者
Tʼááłáhági átʼéego:Choyoołʼįįhí el	Category:El 使用者
Tʼááłáhági átʼéego:Choyoołʼįįhí el-1	Category:El-1 使用者
Tʼááłáhági átʼéego:Choyoołʼįįhí el-2	Category:El-2 使用者
Tʼááłáhági átʼéego:Choyoołʼįįhí el-3	Category:El-3 使用者
Tʼááłáhági átʼéego:Choyoołʼįįhí el-N	Category:El 母語使用者
Tʼááłáhági átʼéego:Choyoołʼįįhí en-0	Category:En-0 使用者
Tʼááłáhági átʼéego:Choyoołʼįįhí en-3	Category:En-3 使用者
Tʼááłáhági átʼéego:Choyoołʼįįhí en-5	Category:En-5 使用者
Tʼááłáhági átʼéego:Choyoołʼįįhí en-N	Category:En 母语使用者
Tʼááłáhági átʼéego:Choyoołʼįįhí eo-1	Category:Eo-1 使用者
Tʼááłáhági átʼéego:Choyoołʼįįhí eo-2	Category:Eo-2 使用者
Tʼááłáhági átʼéego:Choyoołʼįįhí eo-3	Category:Eo-3 使用者
Tʼááłáhági átʼéego:Choyoołʼįįhí eo-4	Category:Eo-4 使用者
Tʼááłáhági átʼéego:Choyoołʼįįhí eo-N	Category:Eo 母語使用者
Tʼááłáhági átʼéego:Choyoołʼįįhí es	Category:Es 使用者
Tʼááłáhági átʼéego:Choyoołʼįįhí es-1	Category:Es-1 使用者
Tʼááłáhági átʼéego:Choyoołʼįįhí es-2	Category:Es-2 使用者
Tʼááłáhági átʼéego:Choyoołʼįįhí es-3	Category:Es-3 使用者
Tʼááłáhági átʼéego:Choyoołʼįįhí es-4	Category:Es-4 使用者
Tʼááłáhági átʼéego:Choyoołʼįįhí es-N	Category:Es 母语使用者
Tʼááłáhági átʼéego:Choyoołʼįįhí eu	Category:Eu 使用者
Tʼááłáhági átʼéego:Choyoołʼįįhí eu-1	Category:Eu-1 使用者
Tʼááłáhági átʼéego:Choyoołʼįįhí eu-4	Category:Eu-4 使用者
Tʼááłáhági átʼéego:Choyoołʼįįhí fa	Category:Fa 使用者
Tʼááłáhági átʼéego:Choyoołʼįįhí fa-1	Category:Fa-1 使用者
Tʼááłáhági átʼéego:Choyoołʼįįhí fa-2	Category:Fa-2 使用者
Tʼááłáhági átʼéego:Choyoołʼįįhí fa-3	Category:Fa-3 使用者
Tʼááłáhági átʼéego:Choyoołʼįįhí fa-N	Category:Fa 母語使用者
Tʼááłáhági átʼéego:Choyoołʼįįhí fi	Category:Fi 使用者
Tʼááłáhági átʼéego:Choyoołʼįįhí fi-2	Category:Fi-2 使用者
Tʼááłáhági átʼéego:Choyoołʼįįhí fi-3	Category:Fi-3 使用者
Tʼááłáhági átʼéego:Choyoołʼįįhí fi-4	Category:Fi-4 使用者
Tʼááłáhági átʼéego:Choyoołʼįįhí fi-N	Category:Fi 母語使用者
Tʼááłáhági átʼéego:Choyoołʼįįhí fy	Category:Fy 使用者
Tʼááłáhági átʼéego:Choyoołʼįįhí fy-1	Category:Fy-1 使用者
Tʼááłáhági átʼéego:Choyoołʼįįhí grc	Category:Grc 使用者
Tʼááłáhági átʼéego:Choyoołʼįįhí grc-1	Category:Grc-1 使用者
Tʼááłáhági átʼéego:Choyoołʼįįhí grc-2	Category:Grc-2 使用者
Tʼááłáhági átʼéego:Choyoołʼįįhí grc-3	Category:Grc-3 使用者
Tʼááłáhági átʼéego:Choyoołʼįįhí gsw	Category:Gsw 使用者
Tʼááłáhági átʼéego:Choyoołʼįįhí gsw-3	Category:Gsw-3 使用者
Tʼááłáhági átʼéego:Choyoołʼįįhí gsw-N	Category:Gsw 母語使用者
Tʼááłáhági átʼéego:Choyoołʼįįhí he	Category:He 使用者
Tʼááłáhági átʼéego:Choyoołʼįįhí he-1	Category:He-1 使用者
Tʼááłáhági átʼéego:Choyoołʼįįhí he-2	Category:He-2 使用者
Tʼááłáhági átʼéego:Choyoołʼįįhí he-3	Category:He-3 使用者
Tʼááłáhági átʼéego:Choyoołʼįįhí he-4	Category:He-4 使用者
Tʼááłáhági átʼéego:Choyoołʼįįhí he-N	Category:He 母語使用者
Tʼááłáhági átʼéego:Choyoołʼįįhí hr-1	Category:Hr-1 使用者
Tʼááłáhági átʼéego:Choyoołʼįįhí hr-2	Category:Hr-2 使用者
Tʼááłáhági átʼéego:Choyoołʼįįhí hr-3	Category:Hr-3 使用者
Tʼááłáhági átʼéego:Choyoołʼįįhí hr-4	Category:Hr-4 使用者
Tʼááłáhági átʼéego:Choyoołʼįįhí hsb	Category:Hsb 使用者
Tʼááłáhági átʼéego:Choyoołʼįįhí hsb-1	Category:Hsb-1 使用者
Tʼááłáhági átʼéego:Choyoołʼįįhí hu	Category:Hu 使用者
Tʼááłáhági átʼéego:Choyoołʼįįhí hu-1	Category:Hu-1 使用者
Tʼááłáhági átʼéego:Choyoołʼįįhí hu-3	Category:Hu-3 使用者
Tʼááłáhági átʼéego:Choyoołʼįįhí hy	Category:Hy 使用者
Tʼááłáhági átʼéego:Choyoołʼįįhí hy-1	Category:Hy-1 使用者
Tʼááłáhági átʼéego:Choyoołʼįįhí hy-2	Category:Hy-2 使用者
Tʼááłáhági átʼéego:Choyoołʼįįhí hy-3	Category:Hy-3 使用者
Tʼááłáhági átʼéego:Choyoołʼįįhí hy-4	Category:Hy-4 使用者
Tʼááłáhági átʼéego:Choyoołʼįįhí id-1	Category:Id-1 使用者
Tʼááłáhági átʼéego:Choyoołʼįįhí id-2	Category:Id-2 使用者
Tʼááłáhági átʼéego:Choyoołʼįįhí id-3	Category:Id-3 使用者
Tʼááłáhági átʼéego:Choyoołʼįįhí io	Category:Io 使用者
Tʼááłáhági átʼéego:Choyoołʼįįhí io-1	Category:Io-1 使用者
Tʼááłáhági átʼéego:Choyoołʼįįhí io-2	Category:Io-2 使用者
Tʼááłáhági átʼéego:Choyoołʼįįhí io-3	Category:Io-3 使用者
Tʼááłáhági átʼéego:Choyoołʼįįhí is	Category:Is 使用者
Tʼááłáhági átʼéego:Choyoołʼįįhí is-1	Category:Is-1 使用者
Tʼááłáhági átʼéego:Choyoołʼįįhí is-2	Category:Is-2 使用者
Tʼááłáhági átʼéego:Choyoołʼįįhí is-3	Category:Is-3 使用者
Tʼááłáhági átʼéego:Choyoołʼįįhí is-4	Category:Is-4 使用者
Tʼááłáhági átʼéego:Choyoołʼįįhí als-N	Category:Als 母语使用者
Bee álnééhí:User la-3	Template:User la-3
Bee álnééhí:User swg-1	Template:User swg-1
Tʼááłáhági átʼéego:Choyoołʼįįhí pt-3	Category:Pt-3 使用者
Tʼááłáhági átʼéego:Choyoołʼįįhí pl-N	Category:Pl 母語使用者
Tʼááłáhági átʼéego:Choyoołʼįįhí pt-1	Category:Pt-1 使用者
Tʼááłáhági átʼéego:Choyoołʼįįhí ka-1	Category:Ka-1 使用者
Bee álnééhí:Hooʼááłígíí	Template:User wikipedia/Administrator
Tʼááłáhági átʼéego:Choyoołʼįįhí it	Category:It 使用者
Tʼááłáhági átʼéego:Choyoołʼįįhí it-1	Category:It-1 使用者
Tʼááłáhági átʼéego:Choyoołʼįįhí ja-1	Category:Ja-1 使用者
Tʼááłáhági átʼéego:Choyoołʼįįhí jv	Category:Jv 使用者
Tʼááłáhági átʼéego:Choyoołʼįįhí jv-2	Category:Jv-2 使用者
Tʼááłáhági átʼéego:Choyoołʼįįhí jv-3	Category:Jv-3 使用者
Tʼááłáhági átʼéego:Choyoołʼįįhí ka	Category:Ka 使用者
Tʼááłáhági átʼéego:Choyoołʼįįhí ka-2	Category:Ka-2 使用者
Tʼááłáhági átʼéego:Choyoołʼįįhí ka-3	Category:Ka-3 使用者
Tʼááłáhági átʼéego:Choyoołʼįįhí kg	Category:Kg 使用者
Tʼááłáhági átʼéego:Choyoołʼįįhí kl	Category:Kl 使用者
Tʼááłáhági átʼéego:Choyoołʼįįhí km-1	Category:Km-1 使用者
Tʼááłáhági átʼéego:Choyoołʼįįhí km-2	Category:Km-2 使用者
Tʼááłáhági átʼéego:Choyoołʼįįhí km-3	Category:Km-3 使用者
Tʼááłáhági átʼéego:Choyoołʼįįhí km-4	Category:Km-4 使用者
Tʼááłáhági átʼéego:Choyoołʼįįhí kn	Category:Kn 使用者
Tʼááłáhági átʼéego:Choyoołʼįįhí kn-1	Category:Kn-1 使用者
Tʼááłáhági átʼéego:Choyoołʼįįhí ko	Category:Ko 使用者
Tʼááłáhági átʼéego:Wááshindoon bikéyah bił haʼdaʼhaasdzoígíí	Category:美国州份
Tʼááłáhági átʼéego:Choyoołʼįįhí ko-1	Category:Ko-1 使用者
Tʼááłáhági átʼéego:Choyoołʼįįhí ko-2	Category:Ko-2 使用者
Tʼááłáhági átʼéego:Choyoołʼįįhí ko-3	Category:Ko-3 使用者
Tʼááłáhági átʼéego:Choyoołʼįįhí ksh	Category:Ksh 使用者
Tʼááłáhági átʼéego:Choyoołʼįįhí ksh-1	Category:Ksh-1 使用者
Tʼááłáhági átʼéego:Choyoołʼįįhí ksh-2	Category:Ksh-2 使用者
Tʼááłáhági átʼéego:Choyoołʼįįhí ksh-3	Category:Ksh-3 使用者
Tʼááłáhági átʼéego:Choyoołʼįįhí ksh-4	Category:Ksh-4 使用者
Tʼááłáhági átʼéego:Choyoołʼįįhí ksh-N	Category:Ksh 母語使用者
Tʼááłáhági átʼéego:Choyoołʼįįhí ku	Category:Ku 使用者
Tʼááłáhági átʼéego:Choyoołʼįįhí ku-2	Category:Ku-2 使用者
Tʼááłáhági átʼéego:Choyoołʼįįhí ku-3	Category:Ku-3 使用者
Tʼááłáhági átʼéego:Choyoołʼįįhí ku-4	Category:Ku-4 使用者
Tʼááłáhági átʼéego:Choyoołʼįįhí la-1	Category:La-1 使用者
Tʼááłáhági átʼéego:Choyoołʼįįhí la-3	Category:La-3 使用者
Tʼááłáhági átʼéego:Choyoołʼįįhí la-4	Category:La-4 使用者
Tʼááłáhági átʼéego:Choyoołʼįįhí lb	Category:Lb 使用者
Tʼááłáhági átʼéego:Choyoołʼįįhí lb-1	Category:Lb-1 使用者
Tʼááłáhági átʼéego:Choyoołʼįįhí lb-2	Category:Lb-2 使用者
Tʼááłáhági átʼéego:Choyoołʼįįhí lb-3	Category:Lb-3 使用者
Bee álnééhí:User sh	Template:User sh
Tʼááłáhági átʼéego:Choyoołʼįįhí nn-2	Category:Nn-2 使用者
Bee álnééhí:User gl	Template:User gl
Tʼááłáhági átʼéego:Choyoołʼįįhí ru-1	Category:Ru-1 使用者
Bee álnééhí:User af-4	Template:User af-4
Yaaʼ bijáád hastánígíí	蝨毛目
Bee álnééhí:User ta	Template:User ta
Bee álnééhí:User sv-1	Template:User sv-1
Tʼááłáhági átʼéego:Chʼil bikétłʼóól daadánígíí	Category:根菜類
Tʼááłáhági átʼéego:Choyoołʼįįhí lo	Category:Lo 使用者
Tʼááłáhági átʼéego:Choyoołʼįįhí lo-1	Category:Lo-1 使用者
Tʼááłáhági átʼéego:Choyoołʼįįhí lv	Category:Lv 使用者
Tʼááłáhági átʼéego:Choyoołʼįįhí mn-1	Category:Mn-1 使用者
Tʼááłáhági átʼéego:Choyoołʼįįhí mn-2	Category:Mn-2 使用者
Tʼááłáhági átʼéego:Choyoołʼįįhí mn-3	Category:Mn-3 使用者
Tʼááłáhági átʼéego:Choyoołʼįįhí mn-N	Category:Mn 母语使用者
Tʼááłáhági átʼéego:Choyoołʼįįhí ms-1	Category:Ms-1 使用者
Tʼááłáhági átʼéego:Choyoołʼįįhí my	Category:My 使用者
Nahasdzáán bimagnetic field	地磁场
Tsiiʼyiishbizhí dinéʼiʼ	中國人
Bee álnééhí:User jv	Template:User jv
Bee álnééhí:User id	Template:User id
Tʼááłáhági átʼéego:Choyoołʼįįhí nds	Category:Nds 使用者
Tʼááłáhági átʼéego:Choyoołʼįįhí nds-1	Category:Nds-1 使用者
Tʼááłáhági átʼéego:Choyoołʼįįhí nds-2	Category:Nds-2 使用者
Tʼááłáhági átʼéego:Choyoołʼįįhí nds-3	Category:Nds-3 使用者
Tʼááłáhági átʼéego:Choyoołʼįįhí nds-4	Category:Nds-4 使用者
Tʼááłáhági átʼéego:Choyoołʼįįhí nds-N	Category:Nds 母語使用者
Tʼááłáhági átʼéego:Choyoołʼįįhí nds-nl	Category:Nds-nl 使用者
Bee álnééhí:User oc-1	Template:User oc-1
Tʼááłáhági átʼéego:Kéyah Ałhidadiidzooígíí dóó Ahiih Yikaígíí	Category:国际组织
Tʼááłáhági átʼéego:Chʼosh bijáád dahólónígíí	Category:节肢动物门
Tʼááłáhági átʼéego:Kʼaalógii	Category:蝴蝶
Tʼááłáhági átʼéego:Tó	Category:水
Tʼááłáhági átʼéego:Bidił daazdoígíí dóó daʼalghałígíí	Category:食肉目
Tʼááłáhági átʼéego:Choyoołʼįįhí tt-N	Category:Tt 母語使用者
Tʼááłáhági átʼéego:Choyoołʼįįhí nn-1	Category:Nn-1 使用者
Tʼááłáhági átʼéego:Choyoołʼįįhí nb	Category:Nb 使用者
Bee álnééhí:User sw-1	Template:User sw-1
Bee álnééhí:User ka-1	Template:User ka-1
Bee álnééhí:User af	Template:User af
Tʼááłáhági átʼéego:Naakaii Łizhiní Bikéyah	Category:非洲国家
Bee álnééhí:User ka-3	Template:User ka-3
Bee álnééhí:User da-3	Template:User da-3
Bee álnééhí:User pt-4	Template:User pt-4
Bee álnééhí:User grc-4	Template:User grc-4
Bee álnééhí:User sl-3	Template:User sl-3
Bee álnééhí:User ja-2	Template:User ja-2
Bee álnééhí:User ko-2	Template:User ko-2
Bee álnééhí:User ko-1	Template:User ko-1
Bee álnééhí:User cs	Template:User cs
Bee álnééhí:User ru-2	Template:User ru-2
Bee álnééhí:User es-3	Template:User es-3
Bee álnééhí:User ja-3	Template:User ja-3
Bee álnééhí:User eu-1	Template:User eu-1
Bee álnééhí:User ko-3	Template:User ko-3
Tʼááłáhági átʼéego:Tsin bineestʼąʼ dadíkʼǫ́zhígíí	Category:柑橘屬
Tʼááłáhági átʼéego:Choyoołʼįįhí pt-2	Category:Pt-2 使用者
Tʼááłáhági átʼéego:Choyoołʼįįhí pt-4	Category:Pt-4 使用者
Tʼááłáhági átʼéego:Choyoołʼįįhí pt-N	Category:Pt 母語使用者
Tʼááłáhági átʼéego:Choyoołʼįįhí qu	Category:Qu 使用者
Tʼááłáhági átʼéego:Choyoołʼįįhí qu-1	Category:Qu-1 使用者
Tʼááłáhági átʼéego:Choyoołʼįįhí qu-2	Category:Qu-2 使用者
Tʼááłáhági átʼéego:Choyoołʼįįhí qu-3	Category:Qu-3 使用者
Tʼááłáhági átʼéego:Choyoołʼįįhí qu-N	Category:Qu 母語使用者
Tʼááłáhági átʼéego:Choyoołʼįįhí ro-2	Category:Ro-2 使用者
Tʼááłáhági átʼéego:Choyoołʼįįhí ro-3	Category:Ro-3 使用者
Tʼááłáhági átʼéego:Choyoołʼįįhí ro-4	Category:Ro-4 使用者
Tʼááłáhági átʼéego:Choyoołʼįįhí ro-N	Category:Ro 母語使用者
Tʼááłáhági átʼéego:Choyoołʼįįhí ru	Category:Ru 使用者
Tʼááłáhági átʼéego:Choyoołʼįįhí ru-2	Category:Ru-2 使用者
Tʼááłáhági átʼéego:Choyoołʼįįhí ru-3	Category:Ru-3 使用者
Tʼááłáhági átʼéego:Choyoołʼįįhí ru-4	Category:Ru-4 使用者
Tʼááłáhági átʼéego:Choyoołʼįįhí sk-1	Category:Sk-1 使用者
Tʼááłáhági átʼéego:Choyoołʼįįhí sk-3	Category:Sk-3 使用者
Tʼááłáhági átʼéego:Choyoołʼįįhí sr	Category:Sr 使用者
Tʼááłáhági átʼéego:Choyoołʼįįhí sr-1	Category:Sr-1 使用者
Tʼááłáhági átʼéego:Choyoołʼįįhí sr-2	Category:Sr-2 使用者
Tʼááłáhági átʼéego:Choyoołʼįįhí sr-3	Category:Sr-3 使用者
Tʼááłáhági átʼéego:Choyoołʼįįhí sr-4	Category:Sr-4 使用者
Tʼááłáhági átʼéego:Choyoołʼįįhí sr-N	Category:Sr 母語使用者
Tʼááłáhági átʼéego:Choyoołʼįįhí stq	Category:Stq 使用者
Tʼááłáhági átʼéego:Choyoołʼįįhí stq-1	Category:Stq-1 使用者
Tʼááłáhági átʼéego:Choyoołʼįįhí sv-1	Category:Sv-1 使用者
Tʼááłáhági átʼéego:Choyoołʼįįhí sv-3	Category:Sv-3 使用者
Tʼááłáhági átʼéego:Choyoołʼįįhí sv-4	Category:Sv-4 使用者
Tʼááłáhági átʼéego:Choyoołʼįįhí sv-N	Category:Sv 母語使用者
Tʼááłáhági átʼéego:Choyoołʼįįhí swg	Category:Swg 使用者
Tʼááłáhági átʼéego:Choyoołʼįįhí swg-1	Category:Swg-1 使用者
Tʼááłáhági átʼéego:Choyoołʼįįhí sxu	Category:Sxu 使用者
Tʼááłáhági átʼéego:Choyoołʼįįhí sxu-1	Category:Sxu-1 使用者
Tʼááłáhági átʼéego:Choyoołʼįįhí ta-2	Category:Ta-2 使用者
Tʼááłáhági átʼéego:Choyoołʼįįhí th-1	Category:Th-1 使用者
Tʼááłáhági átʼéego:Choyoołʼįįhí th-2	Category:Th-2 使用者
Tʼááłáhági átʼéego:Choyoołʼįįhí th-3	Category:Th-3 使用者
Tʼááłáhági átʼéego:Choyoołʼįįhí th-N	Category:Th 母語使用者
Tʼááłáhági átʼéego:Choyoołʼįįhí tr	Category:Tr 使用者
Tʼááłáhági átʼéego:Choyoołʼįįhí tr-4	Category:Tr-4 使用者
Tʼááłáhági átʼéego:Choyoołʼįįhí tr-N	Category:Tr 母語使用者
Tʼááłáhági átʼéego:Choyoołʼįįhí tt	Category:Tt 使用者
Tʼááłáhági átʼéego:Choyoołʼįįhí tt-1	Category:Tt-1 使用者
Tʼááłáhági átʼéego:Choyoołʼįįhí tt-2	Category:Tt-2 使用者
Tʼááłáhági átʼéego:Choyoołʼįįhí tt-3	Category:Tt-3 使用者
Tʼááłáhági átʼéego:Choyoołʼįįhí tt-4	Category:Tt-4 使用者
Tʼááłáhági átʼéego:Choyoołʼįįhí uk-1	Category:Uk-1 使用者
Tʼááłáhági átʼéego:Choyoołʼįįhí uk-2	Category:Uk-2 使用者
Tʼááłáhági átʼéego:Choyoołʼįįhí uk-3	Category:Uk-3 使用者
Tʼááłáhági átʼéego:Choyoołʼįįhí uk-4	Category:Uk-4 使用者
Tʼááłáhági átʼéego:Choyoołʼįįhí vi	Category:Vi 使用者
Tʼááłáhági átʼéego:Choyoołʼįįhí vi-1	Category:Vi-1 使用者
Tʼááłáhági átʼéego:Choyoołʼįįhí vi-2	Category:Vi-2 使用者
Tʼááłáhági átʼéego:Choyoołʼįįhí vi-4	Category:Vi-4 使用者
Tʼááłáhági átʼéego:Choyoołʼįįhí vi-N	Category:Vi 母語使用者
Tʼááłáhági átʼéego:Choyoołʼįįhí vls	Category:Vls 使用者
Tʼááłáhági átʼéego:Choyoołʼįįhí vls-1	Category:Vls-1 使用者
Tʼááłáhági átʼéego:Choyoołʼįįhí yue-1	Category:Zh-yue-1 使用者
Tʼááłáhági átʼéego:Choyoołʼįįhí yue-2	Category:Zh-yue-2 使用者
Tʼááłáhági átʼéego:Choyoołʼįįhí yue-3	Category:Zh-yue-3 使用者
Tʼááłáhági átʼéego:Choyoołʼįįhí yue-4	Category:Zh-yue-4 使用者
Tʼááłáhági átʼéego:Choyoołʼįįhí yue-N	Category:Zh-yue 母语使用者
Bee álnééhí:User ro-1	Template:User ro-1
Tʼááłáhági átʼéego:Tsin ííʼáhígíí	Category:树
Bee álnééhí:User th	Template:User th
Bee álnééhí:User nds-2	Template:User nds-2
Bee álnééhí:User ca	Template:User ca
Tʼááłáhági átʼéego:Mágí: Diné Ndahalinígíí	Category:猿
Tʼááłáhági átʼéego:Mágí	Category:灵长目
Bee álnééhí:LivingP	Template:Blp
Bee álnééhí:Tsídii	Template:鳥類
Bee álnééhí:User sv-3	Template:User sv-3
Bee álnééhí:User hy-1	Template:User hy-1
Bee álnééhí:User hsb-1	Template:User hsb-1
Tʼááłáhági átʼéego:Naʼiiniʼ	Category:商業
Bee álnééhí:User af-3	Template:User af-3
Tʼááłáhági átʼéego:Naaki góneʼ yéigo daʼahijoogą́ą́ʼ	Category:第二次世界大战
Gad niʼeełii bílátah łichíʼígíí	檉柳
Bee álnééhí:User ms-1	Template:User ms-1
Tʼááłáhági átʼéego:Mósí dóó Náshdóí	Category:貓科
Bee álnééhí:User nds	Template:User nds
Tʼááłáhági átʼéego:Tó Kéyah Bináhaazyínígíí	Category:岛国
Bee álnééhí:User ar-4	Template:User ar-4
Bee álnééhí:User az-2	Template:User az-2
Bee álnééhí:User be	Template:User be
Bee álnééhí:User ca-2	Template:User ca-2
Bee álnééhí:User ca-3	Template:User ca-3
Bee álnééhí:User cs-3	Template:User cs-3
Bee álnééhí:User da-4	Template:User da-4
Bee álnééhí:User el-2	Template:User el-2
Bee álnééhí:User et-3	Template:User et-3
Bee álnééhí:User fa-2	Template:User fa-2
Bee álnééhí:User fa-3	Template:User fa-3
Bee álnééhí:User fa-4	Template:User fa-4
Bee álnééhí:User fi-2	Template:User fi-2
Bee álnééhí:User fi-3	Template:User fi-3
Bee álnééhí:User ga-2	Template:User ga-2
Bee álnééhí:User he-3	Template:User he-3
Bee álnééhí:User he-4	Template:User he-4
Bee álnééhí:User hu-1	Template:User hu-1
Bee álnééhí:User hy	Template:User hy
Bee álnééhí:User jv-1	Template:User jv-1
Bee álnééhí:User ka	Template:User ka
Bee álnééhí:User ko	Template:User ko
Bee álnééhí:User ku	Template:User ku
Bee álnééhí:User la-2	Template:User la-2
Bee álnééhí:User lb-2	Template:User lb-2
Bee álnééhí:User li-1	Template:User li-1
Bee álnééhí:User li-3	Template:User li-3
Bee álnééhí:User mk-1	Template:User mk-1
Bee álnééhí:User nn-2	Template:User nn-2
Bee álnééhí:User no-1	Template:User no-1
Bee álnééhí:User pl-2	Template:User pl-2
Bee álnééhí:User pt	Template:User pt
Bee álnééhí:User ro-2	Template:User ro-2
Bee álnééhí:User ru-1	Template:User ru-1
Bee álnééhí:User sa-1	Template:User sa-1
Bee álnééhí:User sk-1	Template:User sk-1
Bee álnééhí:User sk-2	Template:User sk-2
Bee álnééhí:User sk-3	Template:User sk-3
Bee álnééhí:User sr-1	Template:User sr-1
Bee álnééhí:User sxu-1	Template:User sxu-1
Bee álnééhí:User tr-1	Template:User tr-1
Bee álnééhí:User tr-3	Template:User tr-3
Bee álnééhí:User uk-1	Template:User uk-1
Bee álnééhí:User uk-4	Template:User uk-4
Bee álnééhí:User vo-1	Template:User vo-1
Bee álnééhí:User zh-1	Template:User zh-1
Bee álnééhí:User zh-2	Template:User zh-2
Bee álnééhí:User zh-3	Template:User zh-3
Bee álnééhí:User zh-4	Template:User zh-4
Tʼááłáhági átʼéego:Naakaii Łizhiní Bikéyahdę́ę́ʼ Ndaaldeehii	Category:非洲動物
Tʼááłáhági átʼéego:Hakʼazdi Ndaaldeehii	Category:北極動物
Tʼááłáhági átʼéego:Choyoołʼįįhí nl	Category:Nl 使用者
Tʼááłáhági átʼéego:Choyoołʼįįhí nn-3	Category:Nn-3 使用者
Tʼááłáhági átʼéego:Choyoołʼįįhí no-1	Category:No-1 使用者
Tʼááłáhági átʼéego:Choyoołʼįįhí no-2	Category:No-2 使用者
Tʼááłáhági átʼéego:Choyoołʼįįhí no	Category:No 使用者
Tʼááłáhági átʼéego:Choyoołʼįįhí pi-1	Category:Pi-1 使用者
Tʼááłáhági átʼéego:Choyoołʼįįhí nds-nl-1	Category:Nds-nl-1 使用者
Tʼááłáhági átʼéego:Choyoołʼįįhí zh-1	Category:Zh-1 使用者
Tʼááłáhági átʼéego:Choyoołʼįįhí zh-4	Category:Zh-4 使用者
Tʼááłáhági átʼéego:Choyoołʼįįhí zh-3	Category:Zh-3 使用者
Tʼááłáhági átʼéego:Choyoołʼįįhí zh-2	Category:Zh-2 使用者
Tʼááłáhági átʼéego:Chʼał	Category:无尾目
Tʼááłáhági átʼéego:Mąʼii yił Ałhidanoolinígíí Yázhí	Category:浣熊科
Tʼááłáhági átʼéego:Bitsįʼ yishtłizhii	Category:美國原住民部落
Tʼááłáhági átʼéego:Chéłchaaʼ	Category:鞘翅目
Tʼááłáhági átʼéego:Naakáí dootłʼizhí dóó Bééshbichʼahii dabizaad ndahalinígíí	Category:印欧语系
Tʼááłáhági átʼéego:Hazéí	Category:松鼠科
Tʼááłáhági átʼéego:Chidí naatʼaʼí ńdinibįįhígi	Category:機場
Tʼááłáhági átʼéego:Áʼádaatʼéhígíí	Category:化学元素
Bee álnééhí:User pfl-1	Template:User pfl-1
Bee álnééhí:User gsw-3	Template:User gsw-3
Tʼááłáhági átʼéego:Mósí Danilínígíí	Category:貓屬
Tʼááłáhági átʼéego:Articles by class	Category:各等級條目
Bee álnééhí:User de-4	Template:User de-4
Tʼááłáhági átʼéego:Biwooʼ Ádaałtsʼíísígíí dóó Kááʼtsʼiní	Category:贫齿目
Tʼááłáhági átʼéego:Naakaii dootłʼizhí bikéyah	Category:南亚国家
Tʼááłáhági átʼéego:Abeʼ bitsʼą́ą́dóó ádaalyaaígíí	Category:奶制品
Tʼááłáhági átʼéego:Tsin dóó chʼil bineestʼąʼ	Category:水果
Tʼááłáhági átʼéego:Kʼaalógii dóó Iichʼąhii	Category:鳞翅目
Tʼááłáhági átʼéego:Chʼosh bijáád ádaadinígíí	Category:软体动物门
Tʼááłáhági átʼéego:Deeteel Bikéyah bił haʼdaʼhaasdzoígíí	Category:加拿大一級行政區
Tʼááłáhági átʼéego:Shádiʼááhdę́ę́ʼ Mágí	Category:新世界猴
Tʼááłáhági átʼéego:Gáagii dóó Joogii Ndahalinígíí	Category:鸦科
Tʼááłáhági átʼéego:Mąʼii dóó Łééchąąʼí	Category:犬科
Tʼááłáhági átʼéego:Ayání dóó Béégashii	Category:牛亚科
Tʼááłáhági átʼéego:Tó Wónaanídę́ę́ʼ Mágí	Category:猴科
Tʼááłáhági átʼéego:Naayízí dóó taʼneeskʼání	Category:葫芦科
Tʼááłáhági átʼéego:Dlǫ́ʼii Ndahalinígíí	Category:鼬科
Tʼááłáhági átʼéego:Łóóʼtsoh biwooʼ dantłʼizígíí	Category:齒鯨亞目
Tʼááłáhági átʼéego:Łóóʼtsoh biwooʼ daditsʼózígíí	Category:鬚鯨亞目
Tʼááłáhági átʼéego:Naaldeehii	Category:动物
Tʼááłáhági átʼéego:Shádiʼááhdę́ę́ʼ Ndaaldeehii	Category:南美洲動物
Tʼááłáhági átʼéego:Bizaʼazis Dahólónígíí	Category:有袋類
Nádiznézí	斯克綿毛紫苑
Tʼááłáhági átʼéego:Choyoołʼįįhí pfl-1	Category:Pfl-1 使用者
Tʼááłáhági átʼéego:Chʼosh chʼééh diikáhii	Category:腹足纲
Tʼááłáhági átʼéego:Chʼosh bitsʼaʼígíí	Category:双壳纲
Tʼááłáhági átʼéego:Gah	Category:兔形目
Tʼááłáhági átʼéego:Łóóʼtsoh dóó Tééh hóyáanii	Category:鯨目
Bee álnééhí:User bn	Template:User bn
Bee álnééhí:User jv-2	Template:User jv-2
Bee álnééhí:User fy-1	Template:User fy-1
Bee álnééhí:User id-4	Template:User id-4
Bee álnééhí:User uk-3	Template:User uk-3
Bee álnééhí:User bn-2	Template:User bn-2
Tʼááłáhági átʼéego:Eʼeʼaahjí Tónteel bikáaʼgi Kéyah dah Ndaaʼeełígíí	Category:太平洋島嶼
Tʼááłáhági átʼéego:Łóóʼ Bigaan Dahólónígíí	Category:头足纲
Tʼááłáhági átʼéego:Chʼééh digháhii dóó Tsisteeł	Category:龟鳖目
Tʼááłáhági átʼéego:Béésh	Category:金属
Tʼááłáhági átʼéego:Naayééʼ	Category:恐龙
Tʼááłáhági átʼéego:Choyoołʼįįhí pi	Category:Pi 使用者
Tʼááłáhági átʼéego:Choyoołʼįįhí pl	Category:Pl 使用者
Tʼááłáhági átʼéego:Choyoołʼįįhí th-4	Category:Th-4 使用者
Tʼááłáhági átʼéego:Chʼosh bikágí dantłʼizí	Category:甲壳纲
Tʼááłáhági átʼéego:Jaaʼabaní	Category:翼手目
Tʼááłáhági átʼéego:Tłʼiish	Category:蛇亚目
Tʼááłáhági átʼéego:Shádiʼááhjí kéyah yistinígíí	Category:南极洲
Tʼááłáhági átʼéego:Beʼekʼid	Category:湖泊
Kʼíshíshjį́į́zh	毒漆藤
Bee álnééhí:User sl	Template:User sl
Tʼááłáhági átʼéego:Bįįh	Category:鹿科
Bee álnééhí:User sw-3	Template:User sw-3
Tʼááłáhági átʼéego:Łóóʼ hashkéhé	Category:鲨鱼
Tʼááłáhági átʼéego:Chidí	Category:汽车
Bee álnééhí:User ga-1	Template:User ga-1
Bee álnééhí:User lb	Template:User lb
Bee álnééhí:User af-2	Template:User af-2
Chąąshtʼezhiitsoh	胡萝卜
Tséyooʼáałii	象鼻蟲科
Tʼááłáhági átʼéego:Łį́į́ʼ Ndahalinígíí	Category:马科
Tʼááłáhági átʼéego:Wóʼatsʼǫǫsii Ádaatʼéhígíí	Category:半翅目
Tʼááłáhági átʼéego:Choyoołʼįįhí ta-4	Category:Ta-4 使用者
Tʼááłáhági átʼéego:Tsin Deigházhígíí	Category:啮齿目
Bee álnééhí:User hr-2	Template:User hr-2
Bee álnééhí:User sl-1	Template:User sl-1
Tʼááłáhági átʼéego:Choyoołʼįįhí ab	Category:Ab 使用者
Tʼááłáhági átʼéego:Choyoołʼįįhí ab-3	Category:Ab-3 使用者
Tʼááłáhági átʼéego:Choyoołʼįįhí ab-N	Category:Ab 母语使用者
Tʼááłáhági átʼéego:Choyoołʼįįhí ka-4	Category:Ka-4 使用者
Bee álnééhí:User pl-3	Template:User pl-3
Bee álnééhí:User pl-4	Template:User pl-4
Bee álnééhí:User an-1	Template:User an-1
Bee álnééhí:Biighan daholonigii	Template:脊索動物
Bee álnééhí:User yue-4	Template:User zh-yue-4
Bee álnééhí:User yue-2	Template:User zh-yue-2
Bee álnééhí:User vo-4	Template:User vo-4
Bee álnééhí:User vo-3	Template:User vo-3
Bee álnééhí:User vo-2	Template:User vo-2
Bee álnééhí:User vo	Template:User vo
Bee álnééhí:User vi-4	Template:User vi-4
Bee álnééhí:User vi-2	Template:User vi-2
Bee álnééhí:User vi-1	Template:User vi-1
Bee álnééhí:User tt-3	Template:User tt-3
Bee álnééhí:User tt-2	Template:User tt-2
Bee álnééhí:User tt-1	Template:User tt-1
Bee álnééhí:User ta-3	Template:User ta-3
Bee álnééhí:User ta-1	Template:User ta-1
Bee álnééhí:User sw	Template:User sw
Bee álnééhí:User stq-1	Template:User stq-1
Bee álnééhí:User sr-4	Template:User sr-4
Bee álnééhí:User sr-3	Template:User sr-3
Bee álnééhí:User sr-2	Template:User sr-2
Bee álnééhí:User sl-2	Template:User sl-2
Bee álnééhí:User sh-4	Template:User sh-4
Bee álnééhí:User sh-3	Template:User sh-3
Bee álnééhí:User sh-1	Template:User sh-1
Bee álnééhí:User sc-1	Template:User sc-1
Bee álnééhí:User qu-3	Template:User qu-3
Bee álnééhí:User qu-2	Template:User qu-2
Bee álnééhí:User qu-1	Template:User qu-1
Bee álnééhí:User pi-1	Template:User pi-1
Bee álnééhí:User oc-3	Template:User oc-3
Bee álnééhí:User oc-2	Template:User oc-2
Bee álnééhí:User oc	Template:User oc
Bee álnééhí:User nds-3	Template:User nds-3
Bee álnééhí:User nah-3	Template:User nah-3
Bee álnééhí:User nah-2	Template:User nah-2
Bee álnééhí:User nah-1	Template:User nah-1
Bee álnééhí:User mn-4	Template:User mn-4
Bee álnééhí:User mn-3	Template:User mn-3
Bee álnééhí:User mn-2	Template:User mn-2
Bee álnééhí:User mn-1	Template:User mn-1
Bee álnééhí:User mn	Template:User mn
Bee álnééhí:User mk-3	Template:User mk-3
Bee álnééhí:User mk-2	Template:User mk-2
Bee álnééhí:User mk	Template:User mk
Bee álnééhí:User lzh	Template:User zh-wenyan
Bee álnééhí:User lv-1	Template:User lv-1
Bee álnééhí:User lt-4	Template:User lt-4
Bee álnééhí:User lt-3	Template:User lt-3
Bee álnééhí:User lt-1	Template:User lt-1
Bee álnééhí:User li-4	Template:User li-4
Bee álnééhí:User li-2	Template:User li-2
Bee álnééhí:User lb-3	Template:User lb-3
Bee álnééhí:User la-4	Template:User la-4
Bee álnééhí:User la	Template:User la
Bee álnééhí:User ku-4	Template:User ku-4
Bee álnééhí:User ku-3	Template:User ku-3
Bee álnééhí:User ku-2	Template:User ku-2
Bee álnééhí:User ku-1	Template:User ku-1
Bee álnééhí:User ksh-1	Template:User ksh-1
Bee álnééhí:User ka-2	Template:User ka-2
Bee álnééhí:User jv-3	Template:User jv-3
Bee álnééhí:User it-4	Template:User it-4
Bee álnééhí:User is-3	Template:User is-3
Bee álnééhí:User io-2	Template:User io-2
Bee álnééhí:User io-1	Template:User io-1
Bee álnééhí:User id-2	Template:User id-2
Bee álnééhí:User ia-3	Template:User ia-3
Bee álnééhí:User ia-1	Template:User ia-1
Bee álnééhí:User ia	Template:User ia
Bee álnééhí:User hr-3	Template:User hr-3
Bee álnééhí:User hi-4	Template:User hi-4
Bee álnééhí:User hi-2	Template:User hi-2
Bee álnééhí:User grc-3	Template:User grc-3
Bee álnééhí:User grc-2	Template:User grc-2
Bee álnééhí:User grc	Template:User grc
Bee álnééhí:User gn-2	Template:User gn-2
Bee álnééhí:User ga	Template:User ga
Bee álnééhí:User fi-4	Template:User fi-4
Bee álnééhí:User et-4	Template:User et-4
Bee álnééhí:User et-2	Template:User et-2
Bee álnééhí:User et	Template:User et
Bee álnééhí:User el-4	Template:User el-4
Bee álnééhí:User el-3	Template:User el-3
Bee álnééhí:User dsb-2	Template:User dsb-2
Bee álnééhí:User dsb	Template:User dsb
Bee álnééhí:User cy-3	Template:User cy-3
Bee álnééhí:User cy-2	Template:User cy-2
Bee álnééhí:User cy-1	Template:User cy-1
Bee álnééhí:User cy	Template:User cy
Bee álnééhí:User csb-1	Template:User csb-1
Bee álnééhí:User cs-4	Template:User cs-4
Bee álnééhí:User bs-2	Template:User bs-2
Bee álnééhí:User bg-4	Template:User bg-4
Bee álnééhí:User bg-3	Template:User bg-3
Bee álnééhí:User bg-2	Template:User bg-2
Bee álnééhí:User be-3	Template:User be-3
Bee álnééhí:User be-1	Template:User be-1
Bee álnééhí:User an	Template:User an
Bee álnééhí:User tt	Template:User tt
Bee álnééhí:User gl-2	Template:User gl-2
Bee álnééhí:User eu-3	Template:User eu-3
Bee álnééhí:User ast	Template:User ast
Bee álnééhí:User ro-3	Template:User ro-3
Tʼááłáhági átʼéego:Dlǫ́ʼii yił Aheedaałtʼéhígíí	Category:獴科
Bee álnééhí:User lo-2	Template:User lo-2
Bee álnééhí:User nah-4	Template:User nah-4
Bee álnééhí:User nah	Template:User nah
Bee álnééhí:User mk-4	Template:User mk-4
Bee álnééhí:User nds-4	Template:User nds-4
Bee álnééhí:User or	Template:User or
Tʼááłáhági átʼéego:Choyoołʼįįhí lzh-2	Category:Lzh-2 使用者
Bee álnééhí:User lzh-2	Template:User zh-wenyan-2
Bee álnééhí:User eu-2	Template:User eu-2
Tʼááłáhági átʼéego:Chʼosh Deildeełii	Category:食虫目
Tʼááłáhági átʼéego:Tábąąstííntsoh	Category:鳍足亚目
Tʼááłáhági átʼéego:Táłkáaʼgi Tsídii	Category:雁形目
Tʼááłáhági átʼéego:Tsísʼná dóó Wáláchííʼ	Category:細腰亞目
Tʼááłáhági átʼéego:Chʼosh bijáád tseebíhígíí	Category:蛛形纲
Tʼááłáhági átʼéego:Yágháhonikáánji biłnaaztʼiʼígíí	Category:太空探索
Tʼááłáhági átʼéego:Shash	Category:熊科
Tʼááłáhági átʼéego:Tsin deiłkaałii	Category:啄木鸟科
Tʼááłáhági átʼéego:Tsékooh	Category:峽谷
Tó bichʼoshtsoh	負蝽科
Tʼááłáhági átʼéego:Chʼosh bijáád neeznánígíí	Category:十足目
Tʼááłáhági átʼéego:Bílaʼashdlaʼii bilį́į́ʼ danilínígíí	Category:馴養動物
Tʼááłáhági átʼéego:Dziil / Atsiniltłʼish álʼį́	Category:能量
Tʼááłáhági átʼéego:Shádiʼááh biyaadi dóó Kéyah Yistinígíí bikáaʼgi Ndaaldeehii	Category:南極洲動物
Tʼááłáhági átʼéego:Nahatʼeʼiitsoh Bikéyahdę́ę́ʼ Ndaaldeehii	Category:澳大利亞動物
Tʼááłáhági átʼéego:Tsʼíʼii dóó Tséʼédǫ́ʼii	Category:双翅目
Bee álnééhí:User ko-4	Template:User ko-4
Tʼááłáhági átʼéego:Tązhii dóó Naaʼahóóhai Ndahalinígíí	Category:鸡形目
Tʼááłáhági átʼéego:Daʼałchozhígíí	Category:草食性动物
Tʼááłáhági átʼéego:Kǫʼ naʼałbąąsii ninádaaltłiʼígi	Category:鐵路車站
Tʼááłáhági átʼéego:Daʼałtʼoʼígíí biyęęzhii deiłchíhígíí	Category:单孔目
Tʼááłáhági átʼéego:Nahachagii dóó Nahakʼízii	Category:直翅目
Tʼááłáhági átʼéego:Chéłchaaʼ bigaantéłígíí	Category:金龜子科
Tʼááłáhági átʼéego:Tábąąsdísí	Category:鹬科
Tʼááłáhági átʼéego:Séigoʼ	Category:蠍目
Tʼááłáhági átʼéego:Táłtłʼááhdę́ę́ʼ dóó tónteel biyiʼdę́ę́ʼ chʼiyáán	Category:海鮮
Tʼááłáhági átʼéego:Tsin naaʼeeł	Category:船艦
Tʼááłáhági átʼéego:Naʼashjéʼii	Category:蜘蛛目
Tʼááłáhági átʼéego:Jááłánii	Category:單肢亞門
Tʼááłáhági átʼéego:Chʼosh doo yitʼíinii	Category:微生物
Tʼááłáhági átʼéego:Bisóodi	Category:豬科
Tʼááłáhági átʼéego:Choyoołʼįįhí pfl	Category:Pfl 使用者
Tʼááłáhági átʼéego:Choyoołʼįįhí jv-4	Category:Jv-4 使用者
Tʼááłáhági átʼéego:Choyoołʼįįhí kg-1	Category:Kg-1 使用者
Tʼááłáhági átʼéego:Choyoołʼįįhí my-N	Category:My 母语使用者
Tʼááłáhági átʼéego:Choyoołʼįįhí nn-4	Category:Nn-4 使用者
Tʼááłáhági átʼéego:Choyoołʼįįhí no-4	Category:No-4 使用者
Tʼááłáhági átʼéego:Choyoołʼįįhí nv	Category:Nv 使用者
Tʼááłáhági átʼéego:Azeeʼ	Category:藥用植物
Tʼááłáhági átʼéego:Choyoołʼįįhí vo-3	Category:Vo-3 使用者
Tʼááłáhági átʼéego:Choyoołʼįįhí vo-4	Category:Vo-4 使用者
Tʼááłáhági átʼéego:Choyoołʼįįhí wep-1	Category:Wep-1 使用者
Tʼááłáhági átʼéego:Choyoołʼįįhí nl-4	Category:Nl-4 使用者
Tʼááłáhági átʼéego:Naʼastsʼǫǫsí dóó Łéʼétsoh	Category:鼠科
Bee álnééhí:User cs-2	Template:User cs-2
Bee álnééhí:Image label begin	Template:Image label begin
Tʼááłáhági átʼéego:Yootó Hahoodzodi kin naaznilígíí	Category:新墨西哥州城市
Tʼááłáhági átʼéego:Choyoołʼįįhí lzh	Category:Lzh 使用者
Tʼááłáhági átʼéego:Choyoołʼįįhí mn-4	Category:Mn-4 使用者
Tʼááłáhági átʼéego:Choyoołʼįįhí qu-4	Category:Qu-4 使用者
Tʼááłáhági átʼéego:Choyoołʼįįhí wep	Category:Wep 使用者
Tʼááłáhági átʼéego:Dibé dóó Tłʼízí Ndahalinígíí	Category:羊亚科
Tʼááłáhági átʼéego:Choyoołʼįįhí fa-4	Category:Fa-4 使用者
Tʼááłáhági átʼéego:Choyoołʼįįhí nv-0	Category:Nv-0 使用者
Tʼááłáhági átʼéego:Choyoołʼįįhí oj	Category:Oj 使用者
Bee álnééhí:User nn-3	Template:User nn-3
Bee álnééhí:User vi	Template:User vi
Tʼááłáhági átʼéego:Choyoołʼįįhí en-1	Category:En-1 使用者
Tʼááłáhági átʼéego:Choyoołʼįįhí de-1	Category:De-1 使用者
Tʼááłáhági átʼéego:Choyoołʼįįhí da-N	Category:Da 母語使用者
Tʼááłáhági átʼéego:Choyoołʼįįhí gl-2	Category:Gl-2 使用者
Tʼááłáhági átʼéego:Choyoołʼįįhí or	Category:Or 使用者
Tłʼiish áníní	響尾蛇
Yaaʼ bijáád tseebíhígíí	蜱
Bee álnééhí:User vls-1	Template:User vls-1
Dahsání	北美豪豬
Bee álnééhí:User nl-4	Template:User nl-4
Bee álnééhí:User no-4	Template:User no-4
Bee álnééhí:User nn-1	Template:User nn-1
Bee álnééhí:User lt-2	Template:User lt-2
Bee álnééhí:User ru-3	Template:User ru-3
Bee álnééhí:User be-4	Template:User be-4
Bee álnééhí:User az-1	Template:User az-1
Bee álnééhí:User nl-3	Template:User nl-3
Bee álnééhí:User nn	Template:User nn
Bee álnééhí:User az-4	Template:User az-4
Bee álnééhí:User dsb-1	Template:User dsb-1
Bee álnééhí:User km-1	Template:User km-1
Bee álnééhí:User li	Template:User li
Bee álnééhí:User fy	Template:User fy
Bee álnééhí:User sv-4	Template:User sv-4
Bee álnééhí:User dsb-3	Template:User dsb-3
Bee álnééhí:User nds-nl-1	Template:User nds-NL-1
Bee álnééhí:User hi	Template:User hi
Bee álnééhí:User hu-2	Template:User hu-2
Bee álnééhí:User hr-4	Template:User hr-4
Bee álnééhí:User sw-2	Template:User sw-2
Bee álnééhí:User th-2	Template:User th-2
Bee álnééhí:User sh-2	Template:User sh-2
Bee álnééhí:User hu-4	Template:User hu-4
Bee álnééhí:User cy-4	Template:User cy-4
Bee álnééhí:User hu-3	Template:User hu-3
Bee álnééhí:User sw-4	Template:User sw-4
Bee álnééhí:User tt-4	Template:User tt-4
Bee álnééhí:User ga-3	Template:User ga-3
Bee álnééhí:User qu	Template:User qu
Bee álnééhí:User kn-1	Template:User kn-1
Bee álnééhí:User gsw-4	Template:User gsw-4
Bee álnééhí:User vi-3	Template:User vi-3
Bee álnééhí:User th-3	Template:User th-3
Bee álnééhí:User ta-2	Template:User ta-2
Bee álnééhí:User id-1	Template:User id-1
Bee álnééhí:Bidił daazdoígíí dóó da'ałt'o'ígíí	Template:Mammals
Kʼaalógii	蝴蝶
Akétłʼóól łichxííʼí yázhí	萝卜
Hodíłchʼil ayáníchilí	倭水牛
Bee álnééhí:User gsw-2	Template:User gsw-2
Special:RecentChanges	Special:最近更改
Tʼááłáhági átʼéego:Choyoołʼįįhí ja-4	Category:Ja-4 使用者
Gaantsʼosí dóó Sǫʼ łóóʼ biyaʼ	吸口虫纲
Atseełtsʼózí (tónteel tsídii)	鹲属
Kʼaalógii ntsxaaígíí	鳥翼蝶
