ئافرىقا	非洲
ياپونىيە	日本
جەنۇبىي ئامېرىكا	南美洲
نورۋېگىيە	挪威
Shotlandiye	蘇格蘭
Wélsh	威爾士
ۋېنگرىيە	匈牙利
ئىسپانىيە	西班牙
ئامېرىكا قوشما شىتاتلىرى	美国
بېلگىيە	比利时
ليۇكسېمبۇرگ	卢森堡
يەر شارى	地球
گېئورگى ۋاشىنگتون	乔治·华盛顿
فىنلاندىيە	芬兰
شۋېتسىيە	瑞典
دانىيە	丹麦
لەھىستان	波兰
لىتۋا	立陶宛
ئىتالىيە	意大利
شۋېتسارىيە	瑞士
ئاۋستىرىيە	奥地利
گرېتسىيە	希腊
تۈركىيە جۇمھۇرىيىتى	土耳其
پورتۇگالىيە	葡萄牙
ياۋروپا	欧洲
ئاسىيا	亚洲
شىمالىي ئامېرىكا	北美洲
ۋىكىپېدىيە	维基百科
گوللاندىيە	荷兰
Nyu York Shehiri	纽约
ۋاشىنگتون	华盛顿哥伦比亚特区
San Fransisko	旧金山
Bérlin	柏林
Los Anjélés	洛杉矶
كومپيۇتېر	電子計算機
بېرن	伯尔尼
Jenwe	日内瓦
سيۇرىخ	苏黎世
خەلقارالىق تور	互联网
باراك ئوباما	贝拉克·奥巴马
ئۇرۇگۋاي	乌拉圭
London	伦敦
كايرو	开罗
ئالما	苹果
پارىژ	巴黎
مېكسىكا	墨西哥
Kaliforniye Shitati	加利福尼亚州
Boston	波士顿
مارس	火星
كېنىيە	肯尼亚
ئېفىئوپىيە	埃塞俄比亚
گانا جۇمھۇرىيىتى	加纳
شىر	狮
فرانسىيە	法国
ئېسپېرانتو	世界语
ئىت	犬
بۈيۈك بېرىتانىيە	英国
مۈشۈك	猫
جۇڭخۇا خەلق جۇمھۇرىيىتى	中华人民共和国
فرانسۇز تىلى	法语
برازىلىيە	巴西
روسىيە	俄罗斯
قارا دېڭىز	黑海
Toronto	多伦多
Alabama Shitati	亚拉巴马州
San Pawlo	聖保羅 (巴西)
Kwébék	魁北克
ۋىكىپېدىيە ۋەخپى	维基媒体基金会
جىمى ۋالىس	吉米·威爾斯
گېرمانىيە	德国
بېلورۇسسىيە	白俄罗斯
نېمىس تىلى	德语
ئىسلاندىيە	冰岛
ئېستونىيە	爱沙尼亚
ساتۇرن	土星
ئايروپىلان	固定翼飛機
جورج ۋولكېر بۇش	乔治·沃克·布什
لاتۋىيە	拉脫維亞
ئۇكرائىنا	乌克兰
چېخ جۇمھۇرىيەتى	捷克
سلوۋاكىيە	斯洛伐克
سلوۋېنىيە	斯洛文尼亚
مولدوۋا	摩尔多瓦
رۇمىنىيە	羅馬尼亞
بۇلغارىيە	保加利亚
Rim	罗马
ماكېدونىيە	馬其頓共和國
ئالبانىيە	阿尔巴尼亚
گرېنلاندىيە	格陵兰
كرودىيە	克罗地亚
بوسنىيە ۋە ھېرسېگوۋىنا	波斯尼亚和黑塞哥维那
ئەزەربەيجان	阿塞拜疆
ئاندوررا	安道尔
سىپرۇس	賽普勒斯
گرۇزىيە	格鲁吉亚
قازاقىستان	哈萨克斯坦
مالتا	马耳他
موناكو	摩纳哥
چېرنوگورىيە	蒙特內哥羅
ۋاتىكان شەھىرى	梵蒂冈
سان مارىنو	圣马力诺
Bryussél	布鲁塞尔-首都大区
كۇبا	古巴
بېلىز	伯利兹
باربادوس	巴巴多斯
ئاممىباپ ئاپتوموبىل	大众汽车
ھىندونېزىيە	印度尼西亚
Wolfgang Amadeus Mozart	沃尔夫冈·阿马德乌斯·莫扎特
بىتخوۋىن	路德维希·范·贝多芬
تۈرك تىلى	土耳其语
جەنۇبىي ئافرىقا	南非
ئالجىرىيە	阿尔及利亚
ئۆزبېكىستان	乌兹别克斯坦
Poznan	波茲南
Tashkent	塔什干
Warshawa	华沙
ياۋروۋىزىيون ناخشا مۇسابىقىسى	歐洲歌唱大賽
تېلېۋىزور	电视
ئىسلاندىيە تىلى	冰岛语
چىلى	智利
ئەيسا مەسىھ	耶稣
گالىلېي	伽利略·伽利莱
مېركۇرىي	水星
تارىخ	历史
ئالما شىركىتى	蘋果公司
ۋېنېرا	金星
مۇھاببەت	愛
يۇپىتېر	木星
سامان يولى سىستىمېسى	银河系
ئۇران (پلانىت)	天王星
نىكولا ساركوزى	尼古拉·萨科齐
نېپتۇن	海王星
ئاسترونومىيە	天文學
سىنگاپور	新加坡
پلۇتون	冥王星
Montréal	蒙特利尔
لىختېنشتېين	列支敦斯登
Kambrij	劍橋
Facebook	Facebook
بىرىنچى دۇنيا ئۇرۇشى	第一次世界大战
Kolon	科隆
سكوپليې	斯科普里
Shchétsin	什切青
لاتىن تىلى	拉丁语
بەھرېيىن	巴林
ئەرمېنىيە	亞美尼亞
سېربىيە	塞尔维亚
Istanbul	伊斯坦堡
ئاۋستىرالىيە	澳大利亚
فىزىكا	物理学
ئارگېنتىنا	阿根廷
پېرۇ	秘鲁
بىئولوگىيە	生物学
شىمالىي چاۋشيەن	朝鲜民主主义人民共和国
كامبوجا	柬埔寨
قۇرئان كەرىم	古兰经
دىنوزاۋر	恐龙
ئىسلام دىنى	伊斯兰教
ليۇبليانا	卢布尔雅那
Lion	里昂
ياۋروپا ئىتتىپاقى	欧洲联盟
سوفىيە	索菲亞
شېئىر	诗歌
Milan	米蘭
Turin	都灵
سوڭ	肛门
ئېۋېرېست	珠穆朗瑪峰
ﻧﺎﭘﻮﻟﯧﺌﻮﻥ ﺑﻮﻧﺎﭘﺎﺭﺕ	拿破仑一世
ۋېزۇۋىي	維蘇威火山
قۇياش	太阳
قۇياش سىستېمىسى	太阳系
ھىدروگېن	氢
گېلىي	氦
لىتىي	锂
بېرىللىي	铍
شەرقىي تىمور	东帝汶
ئوسلو	奥斯陆
Bonn	波恩
سېرېرا	穀神星
لىسبون	里斯本
ئېرىدا	阋神星
دۇبائى	杜拜
بور	硼
Wérsayl	凡爾賽鎮
كاربون	碳
ۋولگا دەرياسى	伏尔加河
ئازوت	氮
ئوكسىگېن	氧
مۇزىكا	音乐
Wénitsiye	威尼斯
Rénn Shehiri	雷恩 (伊勒-维莱讷省)
Lil	里尔
Moskwa	莫斯科
فىتور	氟
ئىتاليان تىلى	意大利语
نىئون گازى	氖
Sankt-Pétérburg	圣彼得堡
چاد	乍得
ناترىي	钠
ماگنىي	镁
ئاليۇمىن	铝
يېڭى زېلاندىيە	新西兰
ھىندىستان	印度
سىلىتسىي	硅
فرانسىي	钫
Tuwalu	圖瓦盧
فوسفور	磷
تۆمۈر	铁
Ton’ga	東加
گۈڭگۈرت	硫
ساموئا	萨摩亚
سولومون تاقىم ئاراللىرى	所罗门群岛
ۋانۇئاتۇ	瓦努阿图
خلور گازى	氯
پاپۇئا يېڭى گۋىنېيە	巴布亚新几内亚
پالاۋ	帛琉
ئارگون	氩
ناۋرۇ	諾魯
مىكرونېزىيە فېدېراتسىيىسى	密克罗尼西亚联邦
كالىي	钾
كالتىسىي	钙
قوغۇشۇن	铅
مارشال تاقىم ئاراللىرى	馬紹爾群島
كىرىباتى	基里巴斯
موڭغۇلىيە	蒙古国
فىجى	斐濟
سكاندىي	钪
تىتان	钛
ۋېنېسۇئېلا	委內瑞拉
چىڭگىزخان	成吉思汗
ۋانادىي	钒
Méané Shitati	缅因州
خروم	铬
ئات	马
ئامستېردام	阿姆斯特丹
ھايۋانات	动物
سۇرىنام	蘇利南
مانگان	锰
پاراگۋاي	巴拉圭
گايانا	圭亚那
ئېكۋادور	厄瓜多尔
رېنىي	铼
كولومبىيە	哥伦比亚
كوبالت	钴
ۋولفرام	钨
نىكېل	镍
بۇددا دىنى	佛教
بولىۋىيە	玻利維亞
مىس	铜
ترىنىداد ۋە توباگو	千里達及托巴哥
سېنت ۋىنسېنت ۋە گرېنادىن ئاراللىرى	圣文森特和格林纳丁斯
سىنك	锌
Yéngi Xampishir Shitati	新罕布什尔州
سېنت ليۇسىيە	圣卢西亚
داۋېىنچى	列奥纳多·达·芬奇
سېنت كىتس ۋە نېۋىس	聖克里斯多福與尼維斯
زەمبۇرۇغ	真菌
يامايكا	牙买加
گرېنادا	格林纳达
Massachuséts Shitati	麻薩諸塞州
گۋاتېمالا	危地马拉
باھاما	巴哈马
Konnéktikat Shitati	康乃狄克州
ئانتىگۇئا ۋە باربۇدا	安提瓜和巴布达
Haway Shitati	夏威夷州
ھوندۇراس	洪都拉斯
دومىنىكا	多米尼克
دومىنىكان جۇمھۇرىيەتى	多明尼加
ھايتى	海地
ئەل سالۋادور	萨尔瓦多
ئىران	伊朗
ئىراق	伊拉克
Alyaska Shitati	阿拉斯加州
كوستارىكا	哥斯达黎加
ئىسرائىلىيە	以色列
پاناما	巴拿马
يەمەن	也门
پولەك تىلى	波兰语
ئىئوردانىيە	约旦
نىكاراگۇئا	尼加拉瓜
Florida Shitati	佛罗里达州
قىرغىزىستان	吉尔吉斯斯坦
Arizona Shitati	亞利桑那州
كۇۋەيت	科威特
لائوس	老挝
لىۋان	黎巴嫩
Orégon Shitati	俄勒冈州
مالدىۋ ئاراللىرى	马尔代夫
ئامېرىكا قىتئەسى	美洲
Yuta Shitati	犹他州
مالايسىيا	马来西亚
بىرما	缅甸
نېپال	尼泊尔
ئومان	阿曼
پاكىستان	巴基斯坦
قاتار	卡塔尔
سەئۇدى ئەرەبىستان	沙特阿拉伯
سرىلانكا	斯里蘭卡
ستالىن	斯大林
سۇرىيە	叙利亚
بىراتۇ	柏拉图
گاللىي	镓
تاجىكىستان	塔吉克斯坦
تەيۋەن	中華民國
گېرمانىي	锗
تايلاند	泰国
ئارسېن	砷
تۈركمەنىستان	土库曼斯坦
سېلېن	硒
ئەرەب بىرلەشمە خەلىپىلىكى	阿拉伯联合酋长国
بروم	溴
Platina	铂
ۋيېتنام	越南
Nowosibirski	新西伯利亚
جەنۇبىي چاۋشيەن	大韩民国
كرىپتون	氪
ئافغانىستان	阿富汗
رۇبىدىي	铷
ئالتۇن	金
قازان	喀山
بانگلادېش	孟加拉国
مالى	马里共和国
ئانگولا	安哥拉
بۇتان	不丹
برۇنېي	文莱
تانزانىيە	坦桑尼亚
فىلىپپىن	菲律宾
ئوتتۇرا ئافرىقا جۇمھۇرىيىتى	中非共和國
جەنۇبى قۇتۇپ	南极
شىمالى قۇتۇپ	北极点
ئىسساك نيوتۇن	艾萨克·牛顿
ئالبېرىت ئېينىشتېين	阿尔伯特·爱因斯坦
سترونتسىي	锶
ئىتترىي	钇
ۋىسمۇت	铋
سېرىق رەڭ	黄色
توگو	多哥
تۇنىس	突尼西亞
زامبىيە	赞比亚
زىمبابۋې	辛巴威
بېيجىڭ شەھىرى	北京市
تۇۋا	图瓦共和国
بېنىن	贝宁
بوتسۋانا	波札那
بۇركىنا فاسو	布吉納法索
بۇرۇندى	蒲隆地
كومور ئاراللىرى	葛摩
كونگو جۇمھۇرىيىتى	刚果共和国
كونگو دېموكراتىك جۇمھۇرىيىتى	刚果民主共和国
San Antonio	圣安东尼奥 (得克萨斯州)
جىبۇتى	吉布提
پولونىي	钋
ئېكۋاتور گۋىنېيىسى	赤道几内亚
ئېرىترېيە	厄立特里亚
Yéngi Déhli	新德里
تبىلىسى	第比利斯
ئاستاتىن	砹
گابون	加蓬
گامبىيە	冈比亚
ۋىنېيە	几内亚
گۋىنېيە بىسسائۇ	幾內亞比索
پىل چىشى قىرغىغى	科特迪瓦
كامېرۇن	喀麦隆
يېشىل تۇمشۇق ئاراللىرى	佛得角
لېسوتو	莱索托
لىبېرىيە	利比里亚
لىۋىيە	利比亚
ماداگاسكار	马达加斯加
مالاۋى	马拉维
Shtutgart	斯图加特
ماۋرىتانىيە	毛里塔尼亚
ماۋرىتىئۇس	毛里求斯
ماراكەش	摩洛哥
موزامبىك	莫桑比克
نامىبىيە	纳米比亚
نىگېر	尼日尔
نىگېرىيە	奈及利亞
دارۋىن	查尔斯·达尔文
ئۇگاندا	乌干达
رۋاندا	卢旺达
سىركونىي	锆
San Tomé we Prinsipé	圣多美和普林西比
سېنېگال	塞内加尔
سېيشېل ئاراللىرى	塞舌尔
سيېررا لېئونې	塞拉利昂
سومالى	索马里
نىئوبىي	铌
جولیس سیزر	尤利烏斯·凱撒
سۇدان	苏丹共和国
سۋازىلېند	斯威士兰
مولبېدىن	钼
تېخېتىسىي	锝
Hamburg	汉堡
گۇجارات	古吉拉特邦
بىرلەشكەن دۆلەتلەر تەشكىلاتى	联合国
گېئولوگىيە	地质学
Exmetabad	艾哈迈达巴德
يۈرەك	心臟
تېرە	皮膚
پراگا	布拉格
كۆك رەڭ	藍色
كۈمۈش	銀
قەلەي	锡
ئۇران	鈾
سۈرمە	锑
پلوتونىي	钚
نېپتونىي	镎
كسېنون	氙
سېزىي	铯
پروتاكتىنىي	镤
بارىي	钡
تورىي	钍
گافنىي	铪
ئاكتىنىي	锕
تانتال	钽
بىل كلىنتون	比尔·克林顿
رادىي	镭
رادون	氡
Bombay	孟买
Michigan Shitati	密歇根州
پوئېرتو رىكو	波多黎各
Illinoyiz Shitati	伊利诺伊州
Shimaliy Dakota Shitati	北达科他州
لومبارد	伦巴第
Jenubiy Dakota Shitati	南达科他州
Montana Shitati	蒙大拿州
Wyoming Shitati	怀俄明州
قۇدس	耶路撒冷
Aydaxo Shitati	爱达荷州
Washin'giton Shitati	华盛顿州
رۇزېرفوردىي	鑪
Néwada shitati	内华达州
دۇبنىي	𨧀
سىبورگىي	𨭎
بوھرىي	𨨏
ھاسسىي	𨭆
مېيتنېرىي	䥑
Kolorado Shitati	科羅拉多州
دارمستادتىي	鐽
رۆنتگېنىي	錀
كوپېرنىي	鎶
تۈر:تۈرلەر يولباشچىسى	Category:頁面分類
ئاپېنىن تاغ تىزمىسى	亚平宁山脉
ئالپ تاغلىرى	阿尔卑斯山
پاسكال	布莱兹·帕斯卡
Gant	根特
Chikago	芝加哥
ئۇنۇنترىي	Uut
فلېروۋىي	鈇
ئۇنۇنپېنتىي	Uup
لىۋىرمورىي	鉝
ئۇنۇنسېپتىي	Uus
ئۇنۇنئوكتىي	Uuo
Arném	阿纳姆
ئىسپان تىلى	西班牙语
مونتېۋىدېئو	蒙得维的亚
Filadélfiye	費城
Kalkutta	加尔各答
Déhli	德里
داكا	达卡
Ban'galor	班加羅爾
Ömüchük	蜘蛛
ئىسلامئاباد	伊斯兰堡
ظاصتاص يئضةن مئؤة	果实
مايمۇن	猴
Wirginiye Shitati	弗吉尼亚州
غەربىي ۋىرگىنىيە شىتاتى	西維吉尼亞州
Nyuyork Shitati	纽约州
سېرىي	铈
پرازېئودىمىي	镨
Rodé Arili Shitati	羅德島州
نېئودىي	钕
Maryland Shitati	马里兰州
Délawiyer Shitati	特拉华州
يېۋروپىي	铕
Oxayo Shtati	俄亥俄州
Pénsilwaniye Shitati	宾夕法尼亚州
Yéngi Jérséy Shtati	新泽西州
فىنلاندىيە تىلى	芬兰语
Indiyanna Shitati	印第安纳州
ئاپتوموبىل	汽车
Giorgiye Shitati	喬治亞州
Zagréb	萨格勒布
Téksas Shitati	德克萨斯州
Jenubiy Karolina Shitati	南卡罗来纳州
سىتسىلىيە	西西里岛
مانىلا	马尼拉
ساردىنىيە ئارىلى	撒丁岛
Bordo	波尔多
Buénos Ayrés	布宜諾斯艾利斯
مېكسىكا شەھىرى	墨西哥城
توكيو	東京都
Barsélona	巴塞罗那
Missisipi Shitati	密西西比州
Ténnéssi Shitati	田纳西州
Astana	阿斯塔納
Yéngi Méksika Shitati	新墨西哥州
ئافېنا	雅典
Minnésota Shitati	明尼蘇達州
باغداد	巴格达
Karakas	卡拉卡斯
Wiskonsin Shitati	威斯康辛州
Puna	浦那
AC مىلان	AC米兰
Lowa Shitati	艾奥瓦州
Nébraska Shitati	內布拉斯加州
گۋاتېمالا شەھىرى	瓜地馬拉市
Kanzas Shitati	堪薩斯州
ھىندى تىلى	印地语
ماراتىچە	马拉地语
Missori Shitati	密蘇里州
Loyizanna Shitati	路易斯安那州
Kéntukki Shitati	肯塔基州
Arkanzas Shtati	阿肯色州
ئوردو تىلى	乌尔都语
Oklaxoma Shitati	奧克拉荷馬州
Potsdam	波茨坦
Hanofér	汉诺威
Myunxén	慕尼黑
Drézdén	德累斯顿
ۋالىبول	排球
Wyéna	維也納
Kopénhagén	哥本哈根
Stokgolm	斯德哥尔摩
Xélsinki	赫尔辛基
دۇبلىن	都柏林
رېيكياۋىك	雷克雅維克
Tallin	塔林
رىگا	里加
براتىسلاۋا	布拉迪斯拉发
Budapésht	布达佩斯
Danzig	格但斯克
Frankfort	美茵河畔法蘭克福
Wroklaw	弗罗茨瓦夫
لانتان	镧
جۈي	钷
چالغا	钐
گادولنىي	钆
تېربىي	铽
Katolik dini	天主教
ليۇكسېمبۇرگ شەھىرى	盧森堡市
دىسپروزىي	镝
ۋادۇز	瓦都茲
ئىنجىل	聖經
گولمىي	钬
ئېربىي	铒
فنوم پېن	金边
تۇلىي	铥
سايگون	胡志明市
ئىتتېربىي	镱
لۇتېتسىي	镥
خانوي	河內市
ھەقىقى ئەيسا چېركاۋى	真耶稣教会
ئىنگىلىز تىلى	英语
Bangkok	曼谷
ئاندوررا كەنتى	安道尔城
كۇئالالۇمپۇر	吉隆坡
تەيبېي شەھىرى	臺北市
ئامېرىتسىي	镅
كىيۇرىي	锔
Concepción, Chile	康塞普西翁 (智利)
بېركېلىي	锫
كالىفورنىي	锎
ئېينشتېينىي	锿
فېرمىي	镄
مېندېلېيېۋىي	钔
كىيېۋ	基輔
نوبېلىي	锘
لاۋرېنسىي	鐒
كارېلىيە	卡累利阿共和国
Ottawa	渥太華
Manitoba Ölkisi	曼尼托巴
Albérta	艾伯塔
Nowa Skotiye Ölkisi	新斯科舍
يېرېۋان	葉里溫
دارېسسالام	达累斯萨拉姆
خارتۇم	喀土穆
Yéngi Brunswik Ölkisi	新不倫瑞克
Britani Kolumbiye	不列颠哥伦比亚
Saskachéwan	薩斯喀徹溫
Néwfundland Ölkisi	紐芬蘭與拉布拉多
Gherbiy Shimal Rayoni	西北地区 (加拿大)
Yukon Rayoni	育空
Florénsa	佛罗伦萨
Ésén	埃森
كومى	科米共和国
Léypzig	莱比锡
Nyurnbérg	纽伦堡
Édmonton	埃德蒙顿
Man'géym	曼海姆
Wiktoriye, Britani Kolumbiye	維多利亞 (卑詩)
Winnipég	温尼伯
Halifaks	哈利法克斯
Kwébék Shehiri	魁北克市
ئېلېكترون	电子
Birmin'gxam	伯明翰
مىنىسكى	明斯克
مىكروسوفىت شىركىتى	微软
پروتون	質子
Kurow	库鲁夫
Naplés	那不勒斯
Braunshwéyg	不伦瑞克
Madrid	马德里
سۇ ئاستى كېمىسى	潛艇
مايكېل جېكسۇن	迈克尔·杰克逊
Bogota	波哥大
لىما	利馬
Santiyago	圣地亚哥-德智利
كىتو	基多
سۇكرې	苏克雷
ئاسۇنسىئون	亞松森
Öçke	家山羊
Héydélbérg	海德堡
كاتماندۇ	加德滿都
سان خوسې (كوستارىكا)	聖荷西 (哥斯大黎加)
سان سالۋادور	聖薩爾瓦多
Kanbérra	堪培拉
Sidnéy	悉尼
يېشىل رەڭ	綠色
Mélburn	墨尔本
قىزىل رەڭ	红色
ماناگۇئا	馬納瓜
رابات	拉巴特
قۇيرۇقلۇق يۇلتۇز	彗星
ئالجىر	阿爾及爾
تۇنىس شەھىرى	突尼斯市
ترىپولى	的黎波里
تېھران	德黑兰
جاكارتا	雅加达
Enqere	安卡拉
رىياد	利雅德
بېلگراد	贝尔格莱德
ئادىگېيە	阿迪格共和国
پرايا	培亞
دەمەشىق	大马士革
يامۇسسۇكرو	亚穆苏克罗
فرانسىيىگە قاراشلىق گۋىئانا	法屬圭亞那
لومې	洛美
ئاممان	安曼
بېيرۇت	贝鲁特
مۇسكات	马斯喀特
نىكوسىيە	尼科西亚
دوھا	多哈
نايروبى	奈洛比
لۇساكا	路沙卡
ئامازون	亞馬遜公司
قۇياش تۇتۇلۇشى	日食
كامپالا	坎帕拉
Mektep	学校
ھارارې	哈拉雷
Prétoriye	比勒陀利亞
Astiraxan	阿斯特拉罕
Tiktak top	乒乓球
Wikipedia:Sandbox	Wikipedia:沙盒
قالماقىستان	卡尔梅克共和国
Osasko	奥萨斯库
Glasgow	格拉斯哥
Kuritiba	庫里奇巴
Orman	森林
بوغاز كۆۋرۈكى	博斯普魯斯大橋
كۇڭزى	孔子
كوربين بيلو	柯賓·布魯
Surat	苏拉特
ياۋرۇ	欧元
ئامېرىكا دولىرى	美元
يەر ئوتتۇرا دېڭىزى	地中海
خاڭجۇ شەھىر	杭州市
مەسىھچىلىك	基督教
قېلىپ:ئاسىيا	Template:亞洲
Séatl	西雅圖
Baltimor	巴爾的摩
ئادېلايدې	阿德莱德
داغىستان	达吉斯坦共和国
Monzón	蒙宗
گۇجارات تىل	古吉拉特语
پورتۇگال تىلى	葡萄牙語
مۇستاپا كامال	穆斯塔法·凯末尔·阿塔蒂尔克
چېچېنىيە	车臣共和国
كۋېچۇئا تىلى	克丘亞語
ئىنگۇشېتىيە	印古什共和国
شىمالىي ئوسېتىيە	北奥塞梯-阿兰共和国
كاباردىنو-بالقارىستان	卡巴爾達-巴爾卡爾共和國
ئالماس	钻石
ياپون تىلى	日语
Énsklopédiye	百科全书
ئۇيغۇرچە ۋىكىپىدىيە	Wikipedia:首页
Latex	LaTeX
كوندېنساتور	电容器
قاراچاي-چېركېسىيە	卡拉恰伊-切尔克斯共和国
موردوۋىيە	莫尔多瓦共和国
ۋاسكېتبول	篮球
چاڭجياڭ دەرياسى	长江
ئۇدمۇرتىيە	乌德穆尔特共和国
مارى	马里埃尔共和国
ھىمالايا تاغ تىزمىسى	喜马拉雅山脉
ئاند تاغلىرى	安地斯山脈
قىيىلىق تاغلار	洛磯山脈
Kapétown	開普敦
چۇۋاشىيە	楚瓦什共和国
تەڭرىتاغ	天山山脉
كاۋكاز تاغ تىزمىسى	高加索山脉
تاتارىستان	鞑靼斯坦共和国
1279-يىلى	1279年
ۋېىنىست	文森特·梵高
باشقۇرتىستان	巴什科尔托斯坦共和国
Semerqend	撒馬爾罕
Buxara	布哈拉
بېتلېخېم	伯利恆
Andalusiye	安達魯西亞
كايمان تاقىم ئاراللىرى	開曼群島
Kordowa	科爾多瓦 (西班牙)
شىئەن شەھىرى	西安市
كابۇل	喀布尔
لاسا شەھىرى	拉萨市
غىلاپ	阴道
تامىل تىلى	泰米尔语
پەلسەپە	哲学
ئالەم ئايرۇپىلانى	航天
ئالتاي تاغ تىزمىسى	阿尔泰山脉
تۈر:Candidates for speedy deletion	Category:快速删除候选
ئالتاي	阿尔泰共和国
پىئانىنو	钢琴
Hebe Camargo	赫柏·卡马戈
Portland, Orégon	波特蘭 (俄勒岡州)
ئانارخىزم	无政府主义
لىبېرالىزىم	自由主义
فاشىسىت	法西斯主义
مىللەتچىلىك	民族主義
غەربىي ساھارا	西撒哈拉
ھىلاري كلىنتون	希拉里·罗德姆·克林顿
خاكاسىيە	哈卡斯共和国
Strasburg	斯特拉斯堡
ياكۇتىيە	萨哈共和国
كرودىيە تىلى	克罗地亚语
گائۇس	卡爾·弗里德里希·高斯
بۇرياتىيە	布里亞特共和國
جامىس جويىس	詹姆斯·乔伊斯
كاتالان تىلى	加泰罗尼亚语
Burχa	佛
دىنسىزلىق	无神论
لى بەي	李白
دۇنيا بانكىسى	世界银行
كونسېرۋاتىپ	保守主义
شىمالىي ئاتلانتىك ئەھدى تەشكىلاتى	北大西洋公约组织
نوبېل مۇكاپاتى	诺贝尔奖
چىن شىخۇاڭ	秦始皇
خەن سۇلالىسى	汉朝
فېمىنىزم	女性主義
ئىدېئولوگىيە	意識形態
پەي توپ	羽毛球
يۈەن سۇلالىسى	元朝
كولۇمبو	克里斯托弗·哥伦布
يەھۇدىلار	犹太人
سېرىق دەريا	黄河
قۇلاق	耳
بۇرۇن	鼻
كۆز	眼
مۇسكۇل	肌肉
Töge	骆驼
پىل	象
چۈمۈلە	蚂蚁
سۈي سۇلالىسى	隋朝
گوللاندىيە تىلى	荷蘭語
ماگرىت ساچىر	玛格丽特·撒切尔
ياڭ جىيەن	隋文帝
دېئوكسىرىبونۇكلېئىك كىسلاتا	脱氧核糖核酸
سۇڭ سۇلالىسى	宋朝
Çeyze	茄
رۇس تىلى	俄语
ساخالىن	库页岛
نېفىت ئېكىسپورت قىلغۇچى دۆلەتلەر تەشكىلاتى (OPEC)	石油输出国组织
خەلقئارا پۇل فوندى تەشكىلاتى	國際貨幣基金組織
دۇنيا سودا تەشكىلاتى	世界贸易组织
سۋاھىلىچە	斯瓦希里语
توكيو ئۇنىۋېرستېتى	东京大学
خەنزۇ تىلى	汉语
ئۆپكە	肺
نەپەسلىنىش سىستېمى	呼吸系統
رۇمىنىيە تىلى	羅馬尼亞語
بۇلغارىيە تىلى	保加利亚语
يەر تەۋرەش	地震
ماگادان	马加丹
تەبىئىي پەن	自然科学
فرانكلىن روزۋېلت	富兰克林·德拉诺·罗斯福
ﺋﯩﺒﯩﻦ ﺳﯩﻨﺎ	伊本·西那
نىلسۇن ماندىلا	纳尔逊·曼德拉
مارتىن لوتىر كىڭ	马丁·路德·金
Yanardag	火山
ئىسسىق بەلباغ سىكلونى	熱帶氣旋
تېلۇگۇ تىلى	泰卢固语
گرۇزىن تىلى	格鲁吉亚语
ئىقتىسادشۇناسلىق	经济学
يېن	日圓
قىزىل تۈلكە	赤狐
ئىسكىرىپكا	小提琴
چوڭ ئىسكىروپكا	大提琴
ئىسكەندەر زۇلقەرنەيىن	亚历山大大帝
ئۆمەر ئىبنى خەتتاب	欧麦尔·本·赫塔卜
ئامۇ دەرياسى	阿姆河
سۈت	乳
سۇن جۇڭشەن	孫中山
شياڭگاڭ	香港
Miami	迈阿密
كاراچى	卡拉奇
Rio dé Janéyro	里约热内卢
سوغۇق ئۇرۇش	冷战
شاڭخەي شەھىرى	上海市
Bilbaw	毕尔巴鄂
Séwéliye	塞维利亚
چىڭ سۇلالىسى	清朝
توماس ئىدىسون	爱迪生
ئالبان تىلى	阿尔巴尼亚语
باسكى تىلى	巴斯克語
ئاراگون تىلى	阿拉贡语
ئەرمەن تىلى	亚美尼亚语
ئۇكرائىن تىلى	乌克兰语
Walénsiye	巴倫西亞
Malaga	马拉加
شۋېتسىيە تىلى	瑞典語
دانىش تىلى	丹麦语
نورۋېگىيە تىلى	挪威语
ليۇكسېمبۇرگ تىلى	卢森堡语
چېخ تىلى	捷克语
سلوۋاك تىلى	斯洛伐克语
كارل ماركىس	卡尔·马克思
سلوۋېن تىلى	斯洛文尼亚语
ماجار تىلى	匈牙利语
ۋولتىر	伏爾泰
ئېستون تىلى	爱沙尼亚语
لاتۋىيە تىلى	拉脱维亚语
لىتۋا تىلى	立陶宛语
ھىندى دىنى	印度教
بېلورۇس تىل	白俄罗斯语
يېلىن	乳房
ئاتوم	原子
گرېك تىلى	希腊语
ئرېلاندىيە تىلى	愛爾蘭語
مالتا تىلى	马耳他语
پارس تىلى	波斯语
ئىسلام	宗教
كورىيەچە	朝鮮語
Injilning birinchi tomi	創世記
كانتونچە	广州话
ئېكسودۇس	出埃及記
ۋيېتنام تىلى	越南语
كخمېر تىلى	高棉语
لائوس تىلى	老挝语
تايلاندچە	泰语
بىرما تىلى	缅甸语
مالاي تىلى	马来语
ھىندونېزىيە تىلى	印尼语
موڭغۇل تىلى	蒙古语
Baku	巴库
قازاق تىلى	哈萨克语
قىرغىز تىلى	柯尔克孜语
تاجىك تىلى	塔吉克语
ئۆزبېك تىلى	乌孜别克语
تۈركمەن تىلى	土库曼语
يەھۇدى دىنى	犹太教
تىمپۇ	廷布
باندار سەرى بەگاۋان	斯里巴加湾市
ئىبرانى تىلى	希伯来语
ئەزەربەيجان تىلى	阿塞拜疆语
ماكېدون تىلى	马其顿语
سېرب تىلى	塞尔维亚语
سېربو-كرودىيىلىكلەر تىلى	塞尔维亚-克罗地亚语
بوسنىيە تىلى	波斯尼亚语
گالىسىيەچە	加利西亞語
ۋېلش تىلى	威尔士语
دىلى	帝力
شوتلاندىيە گائېل تىلى	苏格兰盖尔语
Wyéntyan	永珍
مالې	馬累
Bishkek	比什凯克
Düshenbe	杜尚别
جىگەر	肝臟
تلا	脾脏
بۆرەك	腎
دوۋساق	膀胱
نېرۋا سىستىمېسى	神经系统
ئوكيانىيە	洋
مۇھەممەد ئەلەيھىسسالام	穆罕默德
ئىمام ئەلغازالىي	安薩里
رىچارد نىكسون	理查德·尼克松
قورساق قىسم	腹
داۋجياۋ دىنى	道教
سوپىزم (تەسەۋۋۇپ)	蘇非主義
ۋېنا تومۇرى	静脉
بېنگال تىلى	孟加拉语
تىل	舌
پانكرېئاتىت	胰脏
بويۇن	頸
ئېغىز بوشلۇقى	口腔
بوغۇز	喉頭
فالكلاند تاقىم ئاراللىرى	福克兰群岛
سازاڭسىمان ئۆسۈكچە	阑尾
ئېلىزابېت II	伊丽莎白二世
تاڭ سۇلالىسى	唐朝
كېننېدى	约翰·肯尼迪
تاڭ تەيزوڭ	唐太宗
بالزاك	奥诺雷·德·巴尔扎克
مىڭ سۇلالىسى	明朝
جۇ يۈەنجاڭ	朱元璋
رېگان	罗纳德·里根
زۇلۇچە	祖鲁语
زازا تىلى	扎扎其語
پلازما	等离子体
رىم گىلادىئاتورلار مەيدانى	罗马斗兽场
Saragossa	萨拉戈萨
Bélfast	贝尔法斯特
ئېلېمېنتلارنىڭ دەۋرىي جەەدۋىلى	元素周期表
قۇرۇق ئۈزۈم	葡萄
ھەسەل	蜂蜜
شېكەر	食糖
روبوت	机器人
ماشىنىسازلىق	机械
ئايلىنىش سىستېمىسى	循环系统
ئىچكى ئاجراتما سىستېمىسى	內分泌系統
كىسلاتا	酸
سارايېۋو	塞拉耶佛
تۇز	食盐
فۇنكسىيە	函数
مولېكۇلا	分子
ئېنېرگىيە	能量
ئىنفرا قىزىل نۇر	红外线
ماسسا	质量
مېتال	金属
پولات	钢
نانو تېخنىكىسى	纳米技术
ئەينەك	玻璃
ۋاكۇئۇم	真空
ئېلېكترون ئىلمى	电子学
.توك (توك ئېقىمى)	电流
ئىككى پۇتلۇق لامپا	二極管
ئامېرىكىغا قاراشلىق ۋىرگىن تاقىم ئاراللىرى	美屬維爾京群島
شېنياڭ شەھىرى	沈阳市
چۇڭچىڭ شەھىرى	重庆市
تيەنجىن شەھىرى	天津市
Lahor	拉合爾
ۋۇخەن شەھىرى	武汉市
نۆۋەتتىكى ھادىسە	世界政區索引
ناگويا	名古屋市
تاش قورال دەۋرى	石器時代
ئېيىق	熊科
فوتوسىنتېز رولى	光合作用
برېتون تىلى	布列塔尼语
پىرېنېي تاغلىرى	比利牛斯山
Détroyt	底特律
بۇرج دۇبەي	哈里發塔
Sedichin Sépili	长城
ئاياسوڧيا	圣索菲亚大教堂
ئابباسىيلار خاندانلىقى	阿拔斯王朝
سەلىپنىڭ شەرققە يۈرۈش قىلىشى	十字軍東征
موڭغۇل ئىمپېرىيىسى	蒙古帝国
ئوسمان ئىمپېرىيىسى	奥斯曼帝国
ئىسپانىيە-ئامېرىكا ئۇرۇشى	美西战争
مىللى دارامەت	国内生产总值
ئېلېكتر	電
يادرو ئېنېرگىيىسى	核動力
ھور ماشىنىسى	蒸汽机
Antwérp	安特卫普
باش سۆڭىكى	颅骨
ئانار	石榴
ئاپېلسىن	橙
دۇنيا تىلى	罗曼什语
جۇاڭزۇ تىلى	壮语
شىبە تىلى	锡伯语
ئۇيغۇر تىلى	维吾尔语
سىنگال تىلى	僧伽罗语
ناخۇئاتل تىلى	納瓦特爾語
مونتسەررات	蒙塞拉特島
خارۋارد ئۇنىۋېرسىتېتى	哈佛大学
Pisa	比萨
باشقۇرتچە	巴什基尔语
قېلىپ:Location map Earth	Template:Location map Earth
باغلانغان ئۆردەك	鴨鳴報
ئەرەب تىلى	阿拉伯语
كيۇسيۇ ئارىلى	九州 (日本)
خونسيو ئارىلى	本州
شىكوكۇ	四國
كورسىكا ئارىلى	科西嘉岛
ئاڧرىقانچە	南非語
بۆرە بورسۇق	貂熊
ئاۋمېن	澳門
خۇ جىنتاۋ	胡锦涛
شى جىنپىڭ	习近平
زىراپە	长颈鹿
شېنجېن شەھىرى	深圳市
گۇئاڭدوڭ ئۆلكىسى	广东省
گۇاڭشى جۇاڭزۇ ئاپتونۇم رايونى	广西壮族自治区
سوۋېت ئىتتىپاقى	苏联
شياڭگاڭ ئۇنىۋېرستېتى	香港大學
شياڭگاڭ جۇڭگو تىللىرى ئۇنۋېرسىتېتى	香港中文大學
پۇت	脚
دولا	肩
قالقانبەز	甲状腺
قېلىپ:Link FA	Template:Link FA
Wikipedia:Tor Jamiyeti	Wikipedia:互助客栈
Wérmont Shitati	佛蒙特州
San Diyégo	聖地牙哥 (加利福尼亞州)
San Xosé	聖荷西 (加利福尼亞州)
Dénwér	丹佛
Hyuston	休斯敦
Féniks	鳳凰城 (亞利桑那州)
Dallas	達拉斯
Austin	奧斯汀
Mémfis, Ténnéssi	孟菲斯 (田納西州)
Sharlot	夏洛特 (北卡羅來納州)
Kolumbu, Oxéo	哥伦布 (俄亥俄州)
گۇاڭجۇ شەھىرى	广州市
جىياڭ جىشى	蔣中正
ۋېن جىياباۋ	温家宝
Guam Aril	關島
ئامېرىكىغا قاراشلىق ساموئا	美屬薩摩亞
شىمالىي مارىئانا فېدېراتسىيىسى	北马里亚纳群岛
نەنجىڭ شەھىرى	南京市
بېيجىڭ ئۇنىۋېرسىتېتى	北京大学
ئۈرۈمچى شەھىرى	乌鲁木齐市
جياڭسۇ ئۆلكىسى	江苏省
جېجياڭ ئۆلكىسى	浙江省
گۇئادەلوپە	瓜德罗普
مارتىنىكا	馬提尼克
شىزاڭ ئاپتونوم رايونى	西藏自治区
دالاي لاما	第十四世达赖喇嘛
تۆگىقۇش	鸵鸟
Sakraménto	沙加緬度
چاۋشيەن	朝鲜 (称谓)
لى كېچياڭ	李克强
Manchéstér	曼彻斯特
تۇركس ۋە كايكوس تاقىم ئاراللىرى	特克斯和凯科斯群岛
ۋىتامىن A	維生素A
ياۋروپا چىمپيونلۇق لوڭقىسى	欧洲冠军联赛
پالمىزارلىق ئىپار مۈشۈكى	椰子貓
Pyongyang	平壤
New Testament	新約聖經
ئادالەت ۋە تەرەققىيات پارتىيىسى	正义与发展党 (土耳其)
گۈللىنىش پارتىيىسى	共和人民黨 (土耳其)
مىللى دارامەت بويىچە دۆلەت تەرتىپى	各国国内生产总值列表 (国际汇率)
خېيلوڭجياڭ ئۆلكىسى	黑龙江省
ما يىنجىئۇ	馬英九
بۇخارېست	布加勒斯特
پوئىرتورىكان مۇستەقىللىق پارتىيىسى	波多黎各獨立黨
Tirana	地拉那
ئېشەك	驴
سىچۈەن ئۆلكىسى	四川省
مۇھەممەر قەززافى	穆阿迈尔·卡扎菲
بارس	虎
سامسۇڭ گۇرۇھى	三星集团
شىمالىي ياۋروپا	斯堪的纳维亚
كىشىنېۋ	基希讷乌
بیلگیسايار مۈھەندیسلیغی	计算机科学
Şalom	Şalom報
ئارۇبا	阿魯巴
خېبېي ئۆلكىسى	河北省
پرىنسېتون ئۇنىۋېرستېتى	普林斯顿大学
نېفىت	石油
پېنسىلۋانىيە نېمىس تىلى	賓夕法尼亞德語
پرژىۋالسكى ياۋا ئات	普氏野马
قوي	羊属
ئىرلاندىيە	爱尔兰岛
Chéshir	柴郡
Nortumbér Wilayiti	諾森伯蘭郡
Staffordshir	斯塔福德郡
ﻟﯘﺷﯜﻥ	鲁迅
Shimaliy Amptonshir	北安普敦郡
Bédfordshir	貝德福德郡
Kornwél	康沃爾郡
Bristol	布里斯托尔
Déwonshir	德文郡
خالتىلىق چاشقانلار ئائىلىسى	袋鼠科
Nashwil	纳什维尔
Xampishir	漢普郡
Bérkshir	伯克郡
Bukkinxamshir	白金汉郡
Ésséks	埃塞克斯郡
Ként	肯特郡
Ulanbatur	乌兰巴托
ئېرنېست ھېمىڭۋاي	欧内斯特·海明威
Idinburg	爱丁堡
ئاشخاباد	阿什哈巴德
پىياز	洋蔥
پەمىدۇر	番茄
جورج بۇش	乔治·赫伯特·沃克·布什
بالقانلار	巴尔干半岛
پروتېستانت دىنى	新教
سەلەنا	莎麗娜
Atlanta	亚特兰大
بېرمۇدا	百慕大
باش	头
ۋېللىنگتون	惠灵顿
روبوتلارنىڭ ئۈچ قانۇنى	机器人三定律
ئالفېرد نوبىل	阿尔弗雷德·诺贝尔
لیلا چڑھاو	利拉·唐斯
907-يىلى	907年
Wankuwér	溫哥華
Liwérpol	利物浦
Brémén	不来梅
يېڭى نورۋېگىيە تىلى	新挪威語
پوند ستېرلىڭ	英镑
ئانگۋىللا	安圭拉
فائېروس تىل	法罗语
مۈشۈك ئائىلىسى	猫科
ISO 3166-1	ISO 3166-1
تاتار تىلى	鞑靼语
ئەنگلىيىگە قاراشلىق ۋىرگىن تاقىم ئاراللىرى	英屬維爾京群島
كىچىك سېسىق كۈزەنى	伶鼬
فرىزانچە	弗里西语
ئاق ئاغمىخان	白鼬
قارشىلىق	电阻
ناۋاسسا ئاراللىرى	納弗沙島
سېنت بارتھېلەمي ئاراللىرى	聖巴泰勒米
شىمالىي گېرمانىيە دىئالېكتى	低地德语
ئاغمىخان ئائىلىسى	鼬科
ساينت مارتىن	圣马丁岛
بۆكەن	羚羊
قارا بۇلغۇن	紫貂
سۈنئىي ھەمراھ	人造衛星
قوتاز	牦牛
ب م ۋ	BMW
Kuk Taqim Aralliri	库克群岛
رەشىدە داتى	拉希妲·達狄
شەرقىي ئاسىيا	东亚
ئوتتۇرا ئاسىيا	中亚
ئاق تۆش بۇلغۇن	石貂
ياۋا ئات	野马
ئامخارا تىلى	阿姆哈拉语
Képinek	鱗翅目
چاچ	頭髮
ھىجرىيە كالېندارى	伊斯兰历
جيامۇسى شەھىرى	佳木斯市
كەبەك	怯别
دىرىخلې	約翰·彼得·古斯塔夫·勒熱納·狄利克雷
ئاستۇرىيە تىلى	阿斯图里亚斯语
خىتاي	中國
قاما	歐亞水獺
چېڭدۇ شەھىر	成都市
يىلپىز	雪豹
جېڭجۇ شەھىرى	郑州市
تېرېسا ئانا	真福加爾各答的德肋撒
DELL شىركىتى	戴爾
فرانسىيىگە قاراشلىق پولىنېزىيە	法屬玻里尼西亞
618-يىلى	618年
روژدېستۋو ئاراللىرى	圣诞岛
Krakow	克拉科夫
بېيجىڭ پايتەخت ئايروپورتى	北京首都国际机场
تىراختور	大不里士拖拉机足球俱乐部
ۋېنىسىيە تىلى	威尼斯語
تەيۋەن ئۇنۋېرسىتې	國立臺灣大學
جامى	清真寺
دۇڭشياڭ تىلى	东乡语
تۇڭگان تىلى	东干语
كورسىكا تىلى	科西嘉语
فىلىپىنچە	菲律賓語
چۇۋاش تىلى	楚瓦什語
قرىم تاتار تىلى	克里米亞韃靼語
ھايتى كرېئول تىلى	海地克里奧爾語
قارا قالپاق تىلى	卡拉卡尔帕克语
ياۋا تىلى	爪哇語
مۈشۈكئېيىق	大熊猫
قالماق تىلى	卡爾梅克衛拉特語
مانجۇ تىلى	满语
كانناداچە	卡纳达语
مۇڭغۇل تىللىرى	蒙古语族
پوچېركا	手
دۇفۇ	杜甫
يېڭى كالېدونىيە	新喀里多尼亞
ئورىياچە	奥里亚语
نېپال تىلى	尼泊尔语
نېئاپول تىلى	那不勒斯语
نورمان تىلى	諾曼語
تېئودور روزېۋېلت	西奥多·罗斯福
تېلاۋىف	特拉维夫
Nis	尼斯
سالار تىلى	撒拉语
سىتسىلىيە تىلى	西西里语
ساردىنىيە تىلى	薩丁尼亞語
ژىيۇل ۋېرن	儒勒·凡尔纳
سىندى تىلى	信德语
سۇندا تىلى	巽他語
Niué Arili	紐埃
تاگالوگ تىلى	他加祿語
تۈركى تىللار ئائىلىسى	突厥语族
تونگاچە	湯加語
ئۇرال تىللىرى	乌拉尔语系
تىگرىنىيەچە	提格利尼亞語
Oksford	牛津
غەربىي يۇغۇر تىلى	西部裕固语
تۇنگۇس مانجۇ تىللىرى	满－通古斯语族
زاڭزۇ تىلى	標準藏語
سارى ئۇغۇر	裕固族
ۋۇ تىلى	吴语
ۋىلسون	伍德罗·威尔逊
ياقۇت تىلى	雅库特语
يورۇباچە	约鲁巴语
سېسوتوچە	塞索托语
Rottérdam	鹿特丹
Yéngi Orléan	新奥尔良
فۇشەن شەھىر	佛山市
ئوكسفورد ئۇنىۋېرسىتېتى	牛津大学
ئەھمىدى نىجات	马哈茂德·艾哈迈迪内贾德
Saynt Xéléna Arili	圣赫勒拿岛
ساينت پىئېر ئارىلى ۋە مىكېلون تاقىم ئاراللىرى	圣皮埃尔和密克隆
ئون پەرھىز	十誡
Yohannésburg	约翰内斯堡
قاپلان	豹
Saltzburg	萨尔茨堡
X نۇرى	X射线
شىنجاڭ ئۇيغۇر ئاپتونوم رايونى	新疆维吾尔自治区
Albukwér kwé	阿布奎基 (新墨西哥州)
Oklaxoma Shehiri	奧克拉荷馬市
برىسبان	布里斯班
ئىسساك ئاسىموۋ	艾萨克·阿西莫夫
جەنۇبىي گىئورگىيە ۋە ساندۋىچ ئاراللىرى	南乔治亚和南桑威奇群岛
كۇۋائىت شەھىرى	科威特市
ئەرەبلەر	阿拉伯人
سۇمېرلار	苏美尔
كولومبو	可倫坡
ئالمۇتا	阿拉木圖
قانداغاي	駝鹿
ۋاللىس ۋە فۇتۇنا تاقىم ئاراللىرى	瓦利斯和富圖納
تاتار مىللىتى	鞑靼人
خوككايدو ئارىلى	北海道
ئۇرال تاغلىرى	乌拉尔山脉
ماددا	物质
ئوساكا	大阪市
كامبرىج ئۇنىۋېرستېتى	剑桥大学
ئاكا-ئۇكا رايتلار	莱特兄弟
گۇئارانچە	瓜拉尼語
شور دېڭىز	鹹海
ئىستانبۇل بوغازى	伊斯坦布尔海峡
Izmir	伊兹密尔
كەئەلىڭ كوكوس تاقىم ئاراللىرى	科科斯（基林）群島
مېرسېدېس - بېنز	梅賽德斯-賓士
كۋېنسلاند	昆士蘭州
Minnéapolis	明尼阿波利斯
دەرەخ خالتىلىق ئېيىقى	無尾熊
2011-يىلدىكى ياپونىيە يەر تەۋرەش ۋە دېڭىز تاشقىنى	2011年日本东北地方太平洋近海地震
لىنگالاچە	林加拉语
مالايالامچە	马拉雅拉姆语
يىپەك يولى	丝绸之路
Kalgari	卡尔加里
ئوستىيىن	简·奥斯汀
قوڭۇر ئېيىق	棕熊
كۇرد تىلى	庫爾德語
مولداۋىيە تىلى	摩爾多瓦語
يېڭى تاش قۇرال دەۋرى	新石器时代
مورېسبى پورتى	莫尔兹比港
خىمىيىلىك رېئاكسىيە	化学反应
لاھەي	海牙
جۇاڭزۇ مىللىتى	壮族
ئوسمانلى تۈركچىسى	奥斯曼土耳其语
يۇھاننا بايان قىلغان خۇش خەۋەر	約翰福音
توكېلاۋ تاقىم ئاراللىرى	托克劳
چاغاتاي ئۇيغۇر يېزىقى	察合台語
تۋىچە	契維語
چېڭلۇڭ	成龍
توخار تىلى	吐火罗语
ئېلان	廣告
Zeytun	橄欖 (木樨科)
ئاۋكلاند	奧克蘭都會區
سەككىز دۆلەت گۇرۇھى (G8)	八大工業國組織
ئاۋكادۇر	鳄梨
قىزىل قان دانىچىلىرى	红血球
ئوقۇتقۇچى	教师
تىز	膝
ئۆرۈك	杏
گلۇكوزا	葡萄糖
Sint-Truiden	圣特雷登
ئالتاي تىللىرى سىستېمىسى	阿尔泰语系
ناتالىيە پورتمەن	娜塔莉·波特曼
Ran'gon	仰光
ناگاساكى	长崎市
يوكوخاما	横滨市
ئادانا	阿达纳
لازېر نۇرى	激光
Lyuju shehiri	柳州市
خەلق پۇلى يۈەنى	人民币
Ritis	利兹
رەجەپ تاييىپ ئەردوغان	雷杰普·塔伊普·埃尔多安
قىزغۇچ سېرىق	橙色
شىمال بۇغىسى	驯鹿
لۇقا بايان قىلغان خۇش خەۋەر	路加福音
كونا تاش قۇرال دەۋرى	旧石器时代
ئانتاليا ۋىلايىتى	安塔利亚省
ھەزرىتى ئەيسا ئەلچىلىرىنىڭ پائالىيەتلىرى	使徒行传
پەرۋەز مۇشەررەڧ	佩尔韦兹·穆沙拉夫
ئادانا ۋىلايىتى	阿达纳省
تاشقا ئايلانغان جىسىم	化石
بۇرسا	布尔萨
ئۇرۇق	種子
ئەنخۇي ئۆلكىسى	安徽省
خەلقئارا ئولىمپىك كومىتىتى	国际奥林匹克委员会
ماڭلاي	前额
ئىچكى موڭغۇل ئاپتونوم رايونى	内蒙古自治区
Nottingxam	诺丁汉
راكېتا	火箭
كۇردىستان	庫爾德斯坦
ستانفورد ئۇنىۋېرستېتى	史丹佛大學
فۇجيەن ئۆلكىسى	福建省
Kanzas Shehiri, Missuri	堪薩斯城 (密蘇里州)
كىچىك مۈشۈكئېيىق	小熊猫
موڭغۇل مىللىتى	蒙古族
ۋەھىيلەر	启示录
Sirtlan	鬣狗科
كاسا	臀
خەينەن ئۆلكىسى	海南省
رىمان	波恩哈德·黎曼
گەنسۇ ئۆلكىسى	甘肃省
ئاق قان ھۈجەيرىسى	白血球
ئەنگلىيىلىكلەر	英格蘭人
ئاناتول فرانس	阿纳托尔·法郎士
ئوتلاق ياۋا مۈشۈكى	非洲野貓
جەينەك	肘
سۇجۇ شەھىرى	苏州市
جاڭگال مولۇنى	丛林猫
بېنگال مولۇنى تاغ مۈشۈكى	豹貓
Wénju shehiri	温州市
ۋۇشى شەھىرى	无锡市
Shawshin shehiri	绍兴市
خەنزۇ مىللىتى	汉族
نىڭبو شەھىرى	宁波市
ئابدۇللاھ گۈل	阿卜杜拉·居尔
نېمىسلار	德意志人
خاربىن شەھىرى	哈尔滨市
Orkéstr	管弦樂團
تۈرك قەھۋەسى	土耳其咖啡
قىزىل ياقۇت	红宝石
كەشمىر	克什米尔
كەۋىن رۇد	陆克文
يۈننەن ئۆلكىسى	云南省
مالكولم X	麥爾坎·X
مەۋلانا جالالىددىن رۇمى	鲁米
Plimowt	普利茅斯
شەندۇڭ ئۆلكىسى	山东省
قول	臂
Dérbi	德比 (英格蘭)
ياقۇت رەڭلىك	祖母綠
كىرىستال	晶体
خېنەن ئۆلكىسى	河南省
بۇرسا ۋىلايىتى	布尔萨省
ئارتۋىن ۋىلايىتى	阿尔特温省
كىندىك	肚脐
ئادىيامان ۋىلايىتى	阿德亚曼省
لياۋنىڭ ئۆلكىسى	辽宁省
خىمىيىلىك باغ	化学键
GNU	GNU
توچىگى ناھىيىسى	栃木縣
سېمونت	水泥
جىلىن ئۆلكىسى	吉林省
ئافيون قاراھىسار ۋىلايىتى	阿菲永卡拉希萨尔省
بېربېرلار	柏柏尔人
ئېچىتقۇ	酵母
خۇنەن ئۆلكىسى	湖南省
ھونلار	匈人
چىڭخەي ئۆلكىسى	青海省
ئۇيغۇر مىللىتى	维吾尔族
بىلەجىك ۋىلايىتى	比莱吉克省
خۇبېي ئۆلكىسى	湖北省
شەنشى ئۆلكىسى	山西省
يۈز	臉頰
قوڭۇر رەڭلىك	褐色
گۇيلىن ئۆلكىسى	贵州省
بالىكەسىر ۋىلايىتى	巴勒克埃西尔省
كيوتو كىلىشىمنامىسى	京都议定书
ئانىلار بايرىمى	母亲节
خەلقئارا ئىسلام كېڭىشى تەشكىلاتى	伊斯兰合作组织
چاناققالە ۋىلايىتى	恰纳卡莱省
مىياگى ناھىيىسى	宮城縣
Luknow	勒克瑙
شېنشى ئۆلكىسى	陕西省
رىملىقلارغا يېزىلغان خەت	羅馬書
ئوقۇغۇچى	学生
Kobe	神户市
ئىۋاتە ناھىيىسى	岩手县
كولۇمبىيە ئۇنىۋېرستېتى	哥伦比亚大学
بوستون ئۇنىۋېرستېتى	波士頓大學
يالې ئۇنىۋېرسىتېتى	耶鲁大学
پېنسىلۋانىيە ئۇنىۋېرستېتى	宾夕法尼亚大学
Portland, Méané	波特蘭 (緬因州)
نيۇيورك ئۇنىۋېرستېتى	纽约大学
ئىتاليانلار	義大利人
پارىژ مېتروسى	巴黎地鐵
پىرىت	黄铁矿
فىلىپىلىكلەرگە يېزىلغان خەت	腓立比書
ئېگىزلىك گېرمان تىلى	高地德语
قېلىپ:Taxobox	Template:Taxobox
قارا ئېقىم	黑潮
خەلق گېزىتى	人民日报
جياڭشى ئۆلكىسى	江西省
ئىلھام ئالىيېۋ	伊利哈姆·阿利耶夫
زاردارى	阿西夫·阿里·扎尔达里
نۇرسۇلتان نازاربايېۋ	努尔苏丹·纳扎尔巴耶夫
نىڭشيا خۇيزۇ ئاپتونۇم رايونى	宁夏回族自治区
ئىسلام كەرىموۋ	伊斯蘭·卡里莫夫
شۈجو شەھىرى	徐州市
Lyenyün'gang shehiri	连云港市
ساۋكات مىرزىيويەۋ	肖開提·米爾則亞耶夫
خۇەيئەن شەھىرى	淮安市
Yangjo shehiri	扬州市
Teyju shehiri, Jyangsu	泰州市
Nentung shehiri	南通市
جاڭجياڭ شەھىرى	镇江市
چاڭجو شەھىر	常州市
ئەھمەد داۋۇد ئوغلۇ	艾哈迈德·达武特奥卢
تەيجۇ شەھىرى	台州市
جۇشەن شەھىرى	舟山市
شىجياجۇاڭ شەھىرى	石家庄市
تاڭشەن شەھىرى	唐山市
Chinxuangdaw shehiri	秦皇岛市
خەندەن شەھىرى	邯郸市
Bawding shehiri	保定市
پەنجاب تىلى	旁遮普語
پاشتوچە	普什图语
ساڭجو شەھىرى	沧州市
Langfang shehiri	廊坊市
Juxey shehiri	珠海市
شەنتۇ شەھىرى	汕头市
Xuyjo shehiri	惠州市
Dongwen shehiri	东莞市
Jongshen shehiri	中山市
مىقدار سۆز	數詞
ئۆت خالتىسى	胆囊
Jaypur	齋浦爾
فۇجو شەھىرى	福州市
Nenping shehiri	南平市
Putyen shehiri	莆田市
Senming shehiri	三明市
Chüenju shehiri	泉州市
شيامېن شەھىرى	厦门市
Jyangju shehiri	漳州市
Longyen shehiri	龙岩市
Ningdé shehiri	宁德市
Shining shehiri	西宁市
تاغىل سېسىق كۈزەن	虎鼬
ئادەم ئەلەيھىسسالام	亞當
خۇئاڭشى شەھىرى	黄石市
ئائومورى ناھىيىسى	青森縣
فۇكۇشىما ناھىيىسى	福岛县
تەييۈەن شەھىرى	太原市
داتۇڭ شەھىر	大同市
داليەن شەھىرى	大连市
ئەنشەن شەھىرى	鞍山市
يىڭكۇ شەھىرى	营口市
لياۋياڭ شەھەر	辽阳市
يوزگات ۋىلايىتى	约兹加特省
چوڭ مېڭە پوستلاق ماددىسى	大脑皮质
ئوڭچى	右派
كارل ۋون دونىتىز	卡尔·邓尼茨
سۆسۈنە ياقۇت	紫水晶
بىنگۆل ۋىلايىتى	宾格尔省
تايغان بۇغا	欧洲马鹿
ئارداھان ۋىلايىتى	阿尔达汉省
ئايدىن ۋىلايىتى	艾登省
ئاماسيا ۋىلايىتى	阿马西亚省
قازاق مىللىتى	哈薩克族
ئاغرى ۋىلايىتى	阿勒省
بۇردۇر ۋىلايىتى	布尔杜尔省
كورىنتلىقلارغا يېزىلغان بىرىنچى خەت	哥林多前書
باتمان ۋىلايىتى	巴特曼省
كۇرىل ئاراللىرى	千島群島
يېڭى يەر	新地岛
Patna	巴特那
سۇلتان ئاخمەت جامىي	蘇丹艾哈邁德清真寺
ۋان ۋىلايىتى	凡城省
كونيا ۋىلايىتى	科尼亚省
ئاكىتا ناھىيىسى	秋田县
سېگولەن رويال	塞格琳·羅雅爾
بولۇ ۋىلايىتى	博卢省
دېنىزلى ۋىلايىتى	代尼兹利省
گىپىس	石膏
ئېڭەك	頷
ئامېرىكا ياۋا كالىسى	美洲野牛
Léyséstér	莱斯特
ساكاريا ۋىلايىتى	萨卡里亚省
ئاقساراي ۋىلايىتى	阿克萨赖省
قارس ۋىلايىتى	卡尔斯省
دىيارباقىر ۋىلايىتى	迪亚巴克尔省
مور	蕈類
تەيبېي 101	台北101
ئەدىرنە ۋىلايىتى	埃迪尔内省
ظوسذث	莴苣
بىتلىس ۋىلايىتى	比特利斯省
ئىباراكى ناھىيىسى	茨城縣
ھاتاي ۋىلايىتى	哈塔伊省
پان تۈركىزم	泛突厥主义
يۇگوسلاۋىيە سوتسىيالىست فېدېرال جۇمھۇرىيىتى	南斯拉夫社会主义联邦共和国
تۈرك	突厥人
بارتىن ۋىلايىتى	巴尔滕省
باش بارماق	拇指
كوجائەلى ۋىلايىتى	科贾埃利省
تۈرك خاقانلىقى	土耳其人
سازاڭسىمان مەددە	秀麗隱桿線蟲
چاڭچۈن شەھىرى	长春市
جىلىن شەھىرى	吉林市
ئېمۇ قۇشى	鸸鹋
خاككارى ۋىلايىتى	哈卡里省
راۋالپىندى	拉瓦尔品第
Emir Kusturica	艾米尔·库斯图里察
ماشىنىىسازلىق ئىنژىنىرلىقى	机械工程
ئاينۇ مىللىتى	阿伊努人
ئورانگوتان	猿
يېشىل ياقۇت	綠柱石
Markus bayan qilghan xush xewer	馬可福音
ئازۇرىت	蓝铜矿
بېلىز شەھىرى	伯利兹市
مارشال	元帅
Chuju shehiri	滁州市
Rékazé shehiri	桑珠孜区
قىرىم	克里米亞韃靼人
كىلون تېخنىكىسى	克隆
پروڧېسسور	教授
كورىنتلىقلارغا يېزىلغان ئىككىنچى خەت	哥林多後書
مۇغلا ۋىلايىتى	穆拉省
ئاسىيا قارا ئېيىق	亞洲黑熊
گۈلچىلىك	园艺
ئىغدىر ۋىلايىتى	厄德尔省
ياماگاتا ناھىيىسى	山形县
قاڭشارلىق بۆكەن	高鼻羚羊
كۈتاھيا ۋىلايىتى	屈塔希亚省
كۆك ياقۇت	蓝宝石
كۈرەشچى ئايروپىلان	战斗机
ئېرتىش دەرياسى	额尔齐斯河
ئىبرانىيلارغا يېزىلغان خەت	希伯來書
گالاتىيلىقلارغا يېزىلغان خەت	加拉太書
شاڭ سۇلالىسى	商朝
كىلىس ۋىلايىتى	基利斯省
تەكىرداغ ۋىلايىتى	泰基尔达省
سان	大腿
مانىسا ۋىلايىتى	马尼萨省
كىچىك مېڭە	小脑
كولوسىلىقلارغا يېزىلغان خەت	歌羅西書
ياقۇپ يازغان خەت	雅各書
يۇھاننا يازغان بىرىنچى خەت	約翰一書
فىلىمۇنغا يېزىلغان خەت	腓利門書
سالونىكىلىقلارغا يېزىلغان ئىككىنچى خەت	帖撒羅尼迦後書
پاۋىل كرۇگمەنن	保羅·克魯格曼
سالونىكىلىقلارغا يېزىلغان بىرىنچى خەت	帖撒罗尼迦前书
پېترۇس يازغان بىرىنچى خەت	彼得前書
پېترۇس يازغان ئىككىنچى خەت	彼得後書
تىموتىيغا يېزىلغان بىرىنچى خەت	提摩太前書
ئېسكىموسلار	爱斯基摩人
چىكاگو ئۇنىۋېرستېتى	芝加哥大学
ماردىن ۋىلايىتى	马尔丁省
مالاتيا ۋىلايىتى	马拉蒂亚省
مۇش ۋىلايىتى	穆什省
يۇھاننا يازغان ئىككىنچى خەت	約翰二書
يۇھاننا يازغان ئۈچىنچى خەت	約翰三書
يەھۇدا يازغان خەت	猶大書
تىموتىيغا يېزىلغان ئىككىنچى خەت	提摩太後書
تىتۇسغا يېزىلغان خەت	提多書
قىرقلارەلى ۋىلايىتى	克尔克拉雷利省
ئاليۇمىن ئوكسىدى	剛玉
مەرسىن ۋىلايىتى	梅尔辛省
ئوتتۇرا ئاسىيا ياۋا تۆگىسى	双峰骆驼
بۇشەھر ۋىلايىتى	布什爾省
تەكلىماكان قۇملۇقى	塔克拉玛干沙漠
پاچاق	腿
قاشقىئوغلاق	貉
ئاشمورە ۋە كارتىئەر ئاراللىرى	阿什莫尔和卡捷群岛
قىرشەھەر ۋىلايىتى	克尔谢希尔省
ئەردەبىل ۋىلايىتى	阿爾達比勒省
سىنوپ ۋىلايىتى	锡诺普省
Ajax	AJAX
ئاتىلار بايرىمى	父親節
شۆلگەي بېزى	唾腺
سېرىق قاشتېشى	黄玉
بىھارى تىلى	比哈尔语
Teynen shehiri	臺南市
ۋىتامىنE	维生素E
سۇلتان توغرۇلبەگ	图赫里勒·贝格
Xéngyang shehiri	衡阳市
مالاي ئېيىقى	马来熊
مانجۇ مىللىتى	满族
تېرەك	欧洲山杨
ھېيدېلبېرگ ئۇنىۋېرستېتى	海德堡大学
سۇلايمان دېمىرەل	苏莱曼·德米雷尔
ۋەيران بولۇش	破產
ج.ۋىللارد گىببس	约西亚·吉布斯
پۇت بارمىقى	腳趾
ياغاچچى	木匠
نىغدە ۋىلايىتى	尼代省
ئوتتۇرا ئاناتولىيە رايونى	中部安那托利亞地區
قارا دېڭىز رايونى	黑海地區
ئېگېي رايونى	爱琴海地区
لېيدېن ئۇنىۋېرستېتى	萊頓大學
مېڭە ئاستى بېزى	腦下垂體
تۈر:سىياسىي جۇغراپىيە	地缘政治学
مۇرادئۈچ	穆拉德三世
ئىدىنبۇرگ ئۇنىۋېرستېتى	爱丁堡大学
فارابى	法拉比
كۆك قۇتان	草鹭
گەۋدە	軀幹
ياپونىيىلىك	日本人
پامىر ئېگىزلىكى	帕米爾高原
تولۇق كۇرس	學士
تۆش بېزى	胸腺
دۆڭچە مېڭىنىڭ ئاستى	下丘脑
ئېلېكتر سىغىمى	電容
يېشىل تاش	孔雀石
سولچى	左派
چاناق قەلئە ئۇرۇشى	加里波利之战
بىريۇزا(ياقۇت)	绿松石
ئەخمەت نەدجەت سەزەر	阿赫迈特·内吉代特·塞泽尔
ۋيېنا ئۇنىۋېرسىتېتى	维也纳大学
توشقانسىمان سۈلەيسۈن	兔猻
ئافيون قاراھىسار	阿菲永卡拉希萨尔
ئوتتۇرا بارماق	中指
ئەبۇ مۇسا جابىر بىن ھەييام	贾比尔
ئوشۇق	腳踝
ئادىياما	阿德亚曼
تاغ ئۆچكىسى	羱羊
پەنجاب	旁遮普地区
شىيا سۇلالىسى	夏朝
جىنەن شەھىرى	济南市
يول بەلگىسى	道路交通標誌
چىڭداۋ شەھىرى	青岛市
كالسېدونىيە	玉髓
ئاسىيا تېنچ ئوكيان ئىقتىسادىي ھەمكارلىق تەشكىلاتى	亚洲太平洋经济合作组织
Glutséstér	格洛斯特
قەشقەر شەھرى	喀什市
ئىلام ۋىلايىتى	伊拉姆省
نەنچاڭ شەھىرى	南昌市
بېشىكتاش گىمناستىكا كۇلۇبى	贝西克塔斯体操俱乐部
تۈرك لىراسى	土耳其里拉
ئۆچكە	山羊屬
بورمودىلى	玻尔模型
ھەزىم يولى	食道
چاڭشا شەھىر	长沙市
ئۆكچە	踵
كېكىردەك	咽
ئۇيغقاشتېشى	玉
ۋىتامىن D	维生素D
قۇتۇبى ناھىيىسى	呼图壁县
2010 دۇنيا لوڭقىسى	2010年世界盃足球賽
نەسىرىدىن ئەپەندى	纳斯尔丁
سۇلايمانىيە جامىى	苏莱曼尼耶清真寺
كاۋاپ	卡博串
Wéstminstér Shehiri	西敏市
نەننىڭ شەھىرى	南宁市
Durham	達拉謨
تۇرغۇت ئۆزال	图尔古特·厄扎尔
ﮔﺎﮔﺎﯞﯗﺯ	加告茲人
بادام بەز	扁桃腺
مۇھەممەد خاتەمى	穆罕默德·哈塔米
تورونتو ئۇنىۋېرستېتى	多倫多大學
ساردونىكس	缟玛瑙
تروچكىزم	托洛茨基主义
ياڭ جىننىڭ	杨振宁
Gawshyung	高雄市
بىرىكمە ماتېرىيال	复合材料
مېڭە غولى	腦幹
تاموژنا	海关
كۈنمىڭ شەھىرى	昆明市
ۋىتامىنB	维生素B
ئىسمەت ئىنۆنۈ	伊斯麦特·伊诺努
مارگارېت ئاتۋود	瑪格麗特·愛特伍
خۇيزۇ مىللىتى	回族
لەنجۇ شەھىرى	兰州市
Halva	哈爾瓦甜食
لى جىڭداۋ	李政道
ماگىستىر	硕士
كۆرسەتكۈچ بارماق	示指
ئوتتۇرا مېڭە	中腦
ئۇپسالا ئۇنىۋېرستېتى	乌普萨拉大学
Multan	木爾坦
خېفېي شەھىر	合肥市
ھىيلە	腕
ئىپار مۈشۈك ئائىلىسى	灵猫科
ئارقار	盘羊
كوپېنھاگېن ئۇنىۋېرستېتى	哥本哈根大学
قارساق	沙狐
لوياڭ شەھىرى	洛阳市
كۇئېنلۇن تاغ تىزمىسى	昆仑山脉
تىبەت مىللىتى	藏族
لوندون ئىمپېرىيە ئىنستېتۇت	伦敦帝国学院
يىلىك	延髓
گۇيلىن شەھىرى	桂林市
گېئوتىت	针铁矿
Xeyko shehir	海口市
مولتىمىتىر	万用表
مەركىزىي مىللەتلەر ئۇنىۋېرسىتېتى	中央民族大学
چىپار بۇغا	梅花鹿
بەل	肢
يۇگوسلاۋىيە پادىشاھلىقى	南斯拉夫王國
ئېۋېنكى مىللىتى	鄂温克族
راھىبە	修女
سېرىق ياۋا مۈشۈك	金貓
گۇيياڭ شەھىرى	贵阳市
نامسىز بارماق	無名指
لىمبىك سىستېما	边缘系统
تۇرپان	吐鲁番市
ئىلى دەرياسى	伊犁河
مېڭە كۆۋرۈكى	橋腦
دەريا بۇغىسى	獐
ﺑﺎﻟﻘﺎﺭ ﻣﯩﻠﻠﯩﺘﻰ	巴尔卡尔人
ﻧﻮﻏﺎﻱ ﻣﯩﻠﻠﯩﺘﻰ	諾蓋人
كالا گۆشى	牛肉
گلاسگوۋ ئۇنىۋېرستېتى	格拉斯哥大學
توخارلار	吐火罗人
ئابادە	阿巴代
ئىستانبۇل ئۇنىۋېرسىتېتى	伊斯坦布尔大学
Tuwa	图瓦人
بۇرما مۈڭگۈزلۈك بۆكەن	羚牛
ئېلېكترون قەۋەت	電子層
مۇھەررىر	编辑
مىكروسكوپ	顯微鏡
كېمىنىڭ يان تىرەكلىرى	肋骨
جاڭ خىڭ	张衡
جاڭ چيەن	張騫
موڭغۇلكۈرە ناھىيىسى	昭苏县
Juko shehiri	周口市
جۇگىلىياڭ	诸葛亮
زىبو شەھىرى	淄博市
ۋىتامىن C	维生素C
گوللاندىيىلىكلەر	荷蘭人
مەن، ماشىنا ئادەم (كىنو)	機械公敵 (電影)
جۇڭخۇا خەلق جۇمھۇرىيىتىنىڭ ئاساسىي قانۇنى	中华人民共和国宪法
قاشتېشى	賈斯珀
تگرین اعظم	提格兰二世
كۆكمۇچ	辣椒属
چۆل مۈشۈكى	荒漠貓
جۇڭگو شىنخۇا ئاگېنتلىقى	新华社
Lankastér	蘭卡斯特 (蘭開夏郡)
لىجياڭ شەھىرى	丽江市
چىچىخار شەھىرى	齐齐哈尔市
گەبزە	蓋布澤
ئەلنى ئىدارە قىلىشقا پايدىلىق ئومۇمىي ئۆرنەكلەر	資治通鑒
ئۇزۇن قۇيرۇق بۇغا	麋鹿
سېرىق تەنلىكلەر	蒙古人種
Keyféng shehiri	开封市
پارىژ ئۇنىۋېرسىتىتى	巴黎大学
مياۋزۇ مىللىتى	苗族
بېيخەي شەھىرى	北海市
يەنتەي شەھىرى	烟台市
ﻗﯘﻣﯩﻖ	庫梅克人
يىنچۈئەن شەھىرى	银川市
سەئىد قۇتوب	赛义德·库特布
ئېيقسىمان ئىپار مۈشۈك	熊狸
ئامستېردام ئۇنىۋېرستېتى	阿姆斯特丹大学
ماتېرىيال	材料
دۇڭزۇ مىللىتى	侗族
تارىم ئويمانلىقى	塔里木盆地
بۈيۈك ئويۇن	大博弈
لازۇرىت	青金石
قاراماي يۇقىر سۇرئەتلىك يولى	喀喇昆仑公路
داغۇر مىللىتى	达斡尔族
ساكاريا دەرياسى	萨卡里亚河
ﺭﺍﺩﯨﺸﺸﯧﯟ	亚历山大·尼古拉耶维奇·拉季舍夫
ئوۋتېز	乔伊斯·卡罗尔·欧茨
مۇدەنجياڭ شەھىرى	牡丹江市
ناشى مىللىتى	纳西族
ۋاشىنگتون ئۇنىۋېرستېتى	華盛頓大學
زونگۇلداق ۋىلايىتى	宗古尔达克省
سېرىق بوغۇز بولغۇن	黃喉貂
شىزاڭ ياۋا ئېشىكى	西藏野驴
بىرمىنگام ئۇنىۋېرستېتى	伯明翰大学
چىمەلتەك	小指
بىلەك	前臂
ماتېرىيال ئىلمى	材料科学
ھەنبەلىي مەزھىبى	哈乃斐派
سەي لۇن	蔡伦
قوڭۇر بۇغا	水鹿
مىچىگان ئۇنىۋېرستېتى	密歇根大学
ئىرۇسالىمغا قايتىش ھەركىتى	传回耶路撒冷运动
ﺋﺎﻗﺴﺎﻱ ﭼﯩﻦ	阿克赛钦
مانچېستېر ئۇنىۋېرستېتى	曼彻斯特大学
تارپان	歐洲野馬
ئاق تەنلىكلەر	白人
تارىم دەرياسى	塔里木河
مىننېسوتا ئۇنىۋېرستېتى	明尼苏达大学
فۇكاڭ شەھىرى	阜康市
ئورخان پامۇك	奥尔汗·帕穆克
ئەرتۇغرۇل غازى	埃尔图鲁尔加齐
ﻗﺎﺭﺍ ﭼﺎﻱ ﻣﯩﻠﻠﯩﺘﻰ	卡拉恰伊人
ﺋﺎﻟﺘﺎﻱ مىللىتى	阿爾泰人
Teyjong shehiri	臺中市
ﻛﺎﺷﻜﺎﻱ	卡什加人
مىللەتچى ھەركەت پارتىيىسى	民族主义行动党
ﭼﯘﯞﺍﺵ ﻣﯩﻠﻠﯩﺘﻰ	楚瓦什人
گيېموسخۇس بۇغىسى	水鼷鹿屬
ئىسپارتا ۋىلايىتى	伊斯帕尔塔省
قوڭۇر يىلپىز	雲豹屬
چىقچىق	姬田鸡
سېرىق ئاغمىخان	黄鼬
شىزاڭ بۆكىن	藏羚羊
چانقىرى ۋىلايىتى	昌克勒省
چورۇم ۋىلايىتى	乔鲁姆省
ئىران ئەزەربەيجان	伊朗阿塞拜疆
تۈركىيە بۈيۈك مىللەت مەجلىسى	土耳其大国民议会
بەيزۇ مىللىتى	白族
ﻗﺎﺭﺍ ﻗﺎﻟﭙﺎﻕ ﻣﯩﻠﻠﯩﺘﻰ	卡拉卡尔帕克人
ئوسمانىيە ۋىلايىتى	奧斯曼尼耶省
تۇرپان ئويمانلىغى	吐鲁番盆地
1.خاتىرەمدىكى ئامېرىكا	ABC新聞
Putbol	足球 (消歧義)
رابىيە قادىر	热比娅·卡德尔
ۋەن مارۋىجىك	伯特·范马尔维克
Hidayet Türkoghli	希達耶特·特克魯
داچىڭ شەھىر	大庆市
لىزۇ مىللىتى	黎族
مەھمەت ئەلىي تالات	麥赫邁特·阿里·塔拉特
مېلبۇرن ئۇنىۋېرستېتى	墨尔本大学
Dünxuang Shehiri	敦煌市
لوپنۇر	罗布泊
Senya shehiri	三亚市
Dostum	阿布都·拉希德·杜斯塔姆
تاغ بورسۇقى	鼬獾
ئۈرۈمچى ناھىيىسى	乌鲁木齐县
سالار مىللىتى	撒拉族
كيوتو ئۇنىۋېرستېتى	京都大学
بادام؛بادام؛بادام	杏仁核
ئىزمىر ۋىلايىتى	伊兹密尔省
ئاد قەۋمى	阿德人
بۇغدىيەك	喉结
بېڭبۇ شەھەرى	蚌埠市
خۇەينەن شەھىرى	淮南市
مائەنشەن شەھىرى	马鞍山市
ئەنچىڭ شەھىرى	安庆市
ياۋزۇ مىللىتى	瑶族
ئەرزۇرۇم ۋىلايىتى	埃尔祖鲁姆省
روبوتلار ۋە ئىمپىرىيە	機器人與帝國
بىلگە قاغان	毗伽可汗
باتۇر تەڭرىقۇت	冒顿
پرژىۋالسكى بۆكىنى	普氏原羚
يېڭى تاڭنامە	新唐书
سۇلتان بەكيارۇق	巴爾基雅魯克
شانلى ئۇرفا ۋىلايىتى	尚勒乌尔法省
ترابزون ۋىلايىتى	特拉布宗省
برىتانى كولۇمبىيە ئۇنىۋېرستېتى	不列顛哥倫比亞大學
Metta bayan qilghan xush xewer	馬太福音
ئەلبورز ۋىلايىتى	厄尔布尔士省
خوجا ئەھمەد يەسەۋى	阿赫馬德·阿薩維
Tekshi choqqiliq tagh shehiri	平顶山市
شىنشياڭ شەھىرى	新乡市
Nenyang shehiri	南阳市
Shinyang shehiri	信阳市
ئەفەسلىكلەرگە يېزىلغان خەت	以弗所書
زەمچە	明矾
ﺋﯩﻜﻜﯩﻨﭽﻰ ﻗﯩﺘﯩﻤﻠﯩﻖ ﯬﭘﻴﯘﻥ ﯰﺭﯗﺷﻰ	第二次鸦片战争
ئاقچى ناھىيىسى	阿合奇县
بۇغا	鹿
ئاقسۇ ۋىلايىتى	阿克苏地区
ئاقسۇ شەھىرى	阿克苏市
ئاقسۇ دەرياسى	阿克苏河
تېتراپىررول	四吡咯
ئاقتو ناھىيىسى	阿克陶县
ميەنياڭ شەھىرى	绵阳市
ھلا رەڭ	粉红色
نەۋشەھەر ۋىلايىتى	内夫谢希尔省
نازارې	拿撒勒
سۇماترا بۆكىنى	鬣羚
دۈزجە ۋىلايىتى	迪兹杰省
ئالتاي شەھىرى	阿勒泰市
سۈبھىدىكى روبوتلار	曙光中的機器人
قۇندۇز ئۇرۇقدىشى	水獺屬
برىستول ئۇنىۋېرستېتى	布里斯托尔大学
ئاق بوغۇز بۆكەن	鹅喉羚
يىزۇ مىللىتى	彝族
روزا ھېيت	開齋節
كۆكمەت	岩羊
شېڭ شىسەي	盛世才
يالىڭاچ قۇياش	裸陽
نوتتىڭخام ئۇنىۋېرستېتى	諾汀罕大學
تايلاندلىقلار	泰国人
تۈركىيە جۇمھۇريىتى باش مىنىستىرى	土耳其总理列表
نەمەنگان ۋىلايىتى	納曼干州
ھانى مىللىتى	哈尼族
پولات قەلئەلەر	鋼穴
گىرەسۇن ۋىلايىتى	吉雷松省
گۈمۈشخانە ۋىلايىتى	居米什哈内省
سىئىرت ۋىلايىتى	锡尔特省
قاھرامان ماراش ۋىلايىتى	卡赫拉曼马拉什省
ئومۇرتقا	脊椎
قارامان ۋىلايىتى	卡拉曼省
سامسۇن ۋىلايىتى	萨姆松省
ئۆزبېك مىللىتى	乌孜别克族
ئەسكىشەھەر ۋىلايىتى	埃斯基谢希尔省
بايبۇرت ۋىلايىتى	巴伊布尔特省
ئۇشاق ۋىلايىتى	乌沙克省
يالوۋا ۋىلايىتى	亚洛瓦省
ئەلازىغ ۋىلايىتى	埃拉泽省
سىۋاس ۋىلايىتى	錫瓦斯省
غازى ئانتەپ ۋىلايىتى	加济安泰普省
قارابۈك ۋىلايىتى	卡拉比克省
ئەرزىنجان ۋىلايىتى	埃尔津詹省
ئوردۇ ۋىلايىتى	奥尔杜省
كاستامونۇ ۋىلايىتى	卡斯塔莫努省
توقات ۋىلايىتى	托卡特省
نورۇز بايرىمى	纳吾肉孜节
كايسەرى ۋىلايىتى	开塞利省
رىزە ۋىلايىتى	里泽省
تاجىك مىللىتى	塔吉克族
مۇھەممەد ئىقبال	穆罕默德·伊克巴勒
پارسلار	波斯人
قاراقالپاقىستان	卡拉卡爾帕克斯坦共和國
قىرىققالە ۋىلايىتى	克勒克卡莱省
قىرغىز مىللىتى	柯尔克孜族
شاڭخەي ھەمكارلىق تەشكىلاتى	上海合作组织
تۈركىيە دەرىجىدىن تاشقىرى ئايلانمىسى	土耳其足球超级联赛
ﻳﺎﻗﯘﺕ ﻣﯩﻠﻠﯩﺘﻰ	雅库特人
فەرغانە ئويمانلىقى	费尔干纳盆地
فەرغانە	费尔干纳
Kanzas Shehiri, Kanzas	堪薩斯城 (堪薩斯州)
پەرغانە ۋىلايىتى	費爾干納州
بۇخارا ۋىلايىتى	布哈拉州
ئەنجان ۋىلايىتى	安集延州
سەمەرقەنت ۋىلايىتى	撒馬爾罕州
سۇرخاندەريا ۋىلايىتى	蘇爾漢河州
چاغاتاي خان	察合台
سىردەريا ۋىلايىتى	錫爾河州
سىدنېي ئۇنىۋېرستېتى	悉尼大學
خارەزىم ۋىلايىتى	花拉子模州
نەۋايى ۋىلايىتى	納沃伊州
قاشقادەريا ۋىلايىتى	卡什卡達里亞州
تاشكەنت ۋىلايىتى	塔什干州
ئانا ۋەتەن پارتىيىسى	土耳其祖国党
جىزاق ۋىلايىتى	吉扎克州
ئاۋكلاند ئۇنىۋېرستېتى	奧克蘭大學
قاراخانىيلار خانلىقى	喀喇汗国
چىپار بۆكەن	斑羚
ئوغۇزلار	烏古斯人
كۆمۈرچەك	软骨
ئەلشىر ناۋائى	阿里希尔·纳沃伊
جەنۋە ئۇنىۋېرستېتى	日内瓦大学
قىزىل تاغ	火焰山
تارىم توشقىنى	塔里木兔
قۇربان ھېيت	古尔邦节
تىمساھ	短吻鱷
ئىستانبۇل ۋىلايىتى	伊斯坦堡省
Kökxot shehiri	呼和浩特市
ياقۇب بەگ	阿古柏
يەكەن دەرياسى	叶尔羌河
مەھمۇد قەشقىرى	麻赫穆德·喀什噶里
باۋتۇ شەھىر	包头市
كۈنەس ناھىيىسى	新源县
رومبىسىمان كرىستال كاتەكچىسى	三方晶系
تۇجيا مىللىتى	土家族
توقسۇن ناھىيىسى	托克逊县
تېھران ۋىلايىتى	德黑蘭省
تۆش	胸
موناش ئۇنىۋېرستېتى	蒙纳士大学
كىچىك مونتياك	黑麂
ئۇلترا ئۆتكۈزگۈچ	超导材料
بوکان	布坎
رېگان ئىقتىسادشۇناسلىقى	雷根經濟學
ئۆركەش دۆلەت	吾尔开希
ئۇلۇغچات ناھىيىسى	乌恰县
دۇلۇڭ مىللىتى	独龙族
تۇنجەلى ۋىلايىتى	通杰利省
ئارال شەھرى	阿拉尔市
خوتەن دەرياسى	和田河
چىپار يۈز قوڭغارچا	果子狸
ئارا تۈرۈك ناھىيىسى	伊吾县
مۇز تاغ ئاتا	慕士塔格峰
قابا ناھىيىسى	哈巴河县
ئالبېرتا ئۇنىۋېرستېتى	阿爾伯塔大學
قوي گۆشى	羊肉
چەرچەن ناھىيىسى	且末县
تارباغاتاي ۋىلايىتى	塔城地区
قوڭۇر تاغ	公格尔峰
خەينە بۇغىسى	坡鹿
شىرناق ۋىلايىتى	舍尔纳克省
چۆچەك شەھىرى	塔城市
قالقانسىمان يان بەز	副甲狀腺
قۇمۇل شەھىرى	哈密市
ئوساكا ئۇنىۋېرستېتى	大阪大学
ﺗﻮﻓﺎ ﻣﯩﻠﻠﯩﺘﻰ	圖法拉爾人
قاراماي شەھىرى	克拉玛依市
ئاتۇش شەھىرى	阿图什市
ئارىشاڭ ناھىيىسى	温泉县
بۇيى مىللىت	布依族
سۈلەيسۈن	猞猁屬
تارماشىرىن	答儿麻失里
نان	馕
سېرىق مۇنتجاك بۇغىسى	山羌
دۇنيا ئۇيغۇر قۇرۇلتىيى	世界維吾爾代表大會
بۆرەك ئۈستى بېزى	腎上腺
لىمفا ئىشلەپچىقىرىدىغان	淋巴系統
يانپاش	骨盆
ISO 639-1	ISO 639-1
چوسون مىللىتى	中國朝鮮族
تەيۋەن بۆكىنى	台灣長鬃山羊
جاڭ چۈنشيەن	张春贤
ۋاڭ لېچۈەن	王乐泉
ISO 639-2	ISO 639-2
يۇڭ تاجلىق بۇغا	毛冠鹿
ھىمالايا چۇپۇرلۇق قويى	喜瑪拉雅塔爾羊
ئاق تۇمشۇق بۇغا	白唇鹿
ئۇرال - ئالتاي تىللىرى سېستىمىسى	乌拉尔-阿尔泰语系
شېزۇ مىللىتى	畲族
ﺗۈﺭﻛﯩﻲ ﺗﯩﻠﻼﺭ ﺩﯨﯟﺍﻧﻰ	突厥语大词典
قەشقەر ۋىلايىتى	喀什地区
تىن تىننىڭ سەرگۈزەشتىلىرى	丁丁歷險記
يوپۇرغا ناھىيىسى	岳普湖县
دۇڭشياڭ مىللىتى	东乡族
لاخۇ مىللىتى	拉祜族
بازا	基地 (小說)
قارىقۇيرۇق	黄羊
چوڭ ئىپار مۈشۈك	大靈貓
مەكىت ناھىيىسى	麦盖提县
ئۈرۈمچى دىۋوپۇ خەلقئارا ئايروپورتى	乌鲁木齐地窝堡国际机场
ئالتاي ۋىلايىتى	阿勒泰地区
نەگۈبەئى	聂古伯
ۋۇجياچۈ شەھىرى	五家渠市
ئاۋات ناھىيىسى	阿瓦提县
ئايدىڭكۆل	艾丁湖
بابۇر	巴卑尔
جەرەنبۇلاق رايونى	白碱滩区
باركۆل قازاق ئاپتونوم ناھىيىسى	巴里坤哈萨克自治县
باي ناھىيىس	拜城县
بايىنغولىن موڭغۇل ئاپتونوم ئوبلاستى	巴音郭楞蒙古自治州
بونان مىللىتى	保安族
قارا تەنلىكلەر	黑人
ئورخۇن ئۇيغۇر خانلىقى	回鹘
بورىس ۋاسىلىيىۋ	鲍里斯·利沃维奇·瓦西里耶夫
كورلا شەھىرى	库尔勒市
بازا ۋە ئىمپىرىيە	基地與帝國
دەيزۇ مىللىتى	傣族
مېنبا مىللىتى	门巴族
شەرقىي تۈركىستان	东突厥斯坦
چياڭزۇ مىللىتى	羌族
ۋازۇ مىللىتى	佤族
5-ئىيۇل ۋەقەسى	乌鲁木齐七五事件
تاجىسىمان يۇرەك قان تومۇر كېسىلى	冠狀動脈疾病
ISO 639-3	ISO 639-3
شىمالىي ئامېرىكىلىق	美國人
ئىلى قازاق ئاپتونوم ۋىلايىتى	伊犁哈萨克自治州
شىخەنزە شەھىرى	石河子市
ئاچاڭ مىللىتى	阿昌族
تۇزۇ مىللىتى	土族
ئېگىز تاغ بۆكىنى	藏原羚
ئىككىنچى بازا	第二基地
لوبا مىللىتى	珞巴族
يەكەن ناھىيىسى	莎车县
لىسۇ مىللىتى	傈僳族
QQ	腾讯QQ
تېڭشۈن شىركىتى	腾讯
قىزىلسۇ قىرغىز ئاپتونوم ئوبلاستى	克孜勒苏柯尔克孜自治州
بىلكەنت ئۇنىۋېستېتى	畢爾肯大學
كۋېنسلاند ئۇنىۋېرستېتى	昆士兰大学
غۇلجا شەھىرى	伊宁市
نۇزۇ مىللىتى	怒族
مۇلاۋ مىللىتى	仫佬族
تۇرپان ۋىلايىتى	吐鲁番地区
Néwkastl Undérlim	紐卡斯爾安德萊姆
تۇڭگان مىللىتى	东干族
بورتالا موڭغۇل ئاپتونوم ئوبلاستى	博尔塔拉蒙古自治州
ﺷﻮﺭ ﻣﯩﻠﻠﯩﺘﻰ	索尔人
پۇمى مىللىتى	普米族
قئارئاهوجئا	高昌
布朗族	布朗族
باغراش ناھىيىسى	博湖县
بورتالا شەھىرى	博乐市
جىمىسار ناھىيىسى	吉木萨尔县
تاشقۇرقان تاجىك ئاپتونوم ناھىيىسى	塔什库尔干塔吉克自治县
روبوت چاتما رومانى	機器人系列
قىزىل بۆكەن	红斑羚
ياردەم:ياردەم	Help:目录
خوتەن ناھىيىسى	和田县
لوپ ناھىيىسى	洛浦县
بازىنىڭ چېتى	基地邊緣
ئورقۇ رايونى	乌尔禾区
تاشقۇرغان	塔什库尔干镇
شىنجاڭ ئۇنىۋېرستېتى	新疆大学
چوڭ تەخسە توخۇ قورۇمىسى	大盘鸡
ئىپارخان	容妃 (乾隆帝)
لاتىن ھەرپلىرى ئاساسىدىكى ئۇيغۇر يېڭى يېزىقى	拉丁维文
لۇتپۇللا مۇتەللىپ	鲁特甫拉·穆塔里甫
شەرقى تۈركىستان جۇمھۇرىيىتى	东突厥斯坦第一共和国
تۇمشۇق شەھىرى	图木舒克市
خوتەن ۋىلايىتى	和田地区
قۇمۇل ۋىلايىتى	哈密地区
سانجى خۇيزۇ ئاپتونوم ئوبلاستى	昌吉回族自治州
كۈيتۇن شەھىرى	奎屯市
سانجى شەھىرى	昌吉市
چاپچال شىبە ئاپتونوم يېزىسى	察布查尔锡伯自治县
فارس ۋىلايىتى	法爾斯省
بۇرچىن ناھىيىسى	布尔津县
بۇرۇلتوقاي ناھىيىسى	福海县
يېڭىسار ناھىيىسى	英吉沙县
ۋۇسۇ شەھىرى	乌苏市
دۆربىلجىن ناھىيىسى	额敏县
پوسكام ناھىيىسى	泽普县
گۇچۇڭ ناھىيىسى	奇台县
قورغاس ناھىيىسى	霍城县
يەنجى خۇيزۇ ئاپتونوم ناھىيىسى	焉耆回族自治县
لوپنۇر ناھىيىسى	尉犁县
كوكتوقاي ناھىيىسى	富蕴县
قوبۇقسار موڭغۇل ئاپتونوم ناھىيىسى	和布克赛尔蒙古自治县
قەشقەر كونا شەھەر ناھىيىسى	疏附县
ساۋەن ناھىيىسى	沙湾县
قاغىلىق ناھىيىسى	叶城县
خېجىڭ ناھىيىسى	和静县
چاغانتوقاي ناھىيىسى	裕民县
پىچان ناھىيىسى	鄯善县
كۇچار ناھىيىسى	库车县
مايتاغ رايونى	独山子区
چاقىلىق ناھىيىسى	若羌县
بۈگۈر ناھىيىسى	轮台县
قەشقەر يېڭىشەھەر ناھىيىسى	疏勒县
شايار ناھىيىسى	沙雅县
مارالبېشى ناھىيىسى	巴楚县
ماناس ناھىيىسى	玛纳斯县
ئونسۇ ناھىيىسى	温宿县
چىڭگىل ناھىيىسى	青河县
پەيزاۋات ناھىيىسى	伽师县
مورى قازاق ئاپتونوم ناھىيىسى	木垒哈萨克自治县
تولى ناھىيىسى	托里县
خوشۇت ناھىيىسى	和硕县
يېڭىشەھەر رايونى	新市区 (乌鲁木齐市)
تۇدۇڭخابا رايونى	头屯河区
ئىفايلۇت تەڭرىقۇت	伊伐於慮鞮單于
تەڭرىتاغ رايونى	天山区
داۋانچىڭ رايونى	达坂城区
گۇما ناھىيىسى	皮山县
سايباغ رايونى	沙依巴克区
ئاشقازان	胃
يەسۇن تۆمۇرخان	也孙帖木儿
چاڭشى	敞失
ئېلىك	狍
شىبە مىللىتى	锡伯族
كىنو مىللىتى	基诺族
كروران قەدىمكى شەهىرى	楼兰
ئورۇنچون مىللىتى	鄂伦春族
ئەنقەرە ئۇنىۋېرسىتېتى	安卡拉大学
غەربىي خەن سۇلالىسى	西汉
ئىكول تىل مەكتىپى	阿高尔语言学校
مەمتىمىن ھوشۇر	买买提明·吾守尔
پېشاۋار	白沙瓦
دۇڭسەن رايونى	东山区 (乌鲁木齐市)
دۇتار	都塔尔
كونا تاڭنامە	旧唐书
تاڭ سۇلالىسىگە دائىر مۇھىم خاتىرىلەر	唐会要
جۇڭغار ئويمانلىقى	准噶尔盆地
قاراشەھەر بازىرى	焉耆
سۈينامە	隋书
سەئىدىيە خانلىقى	葉爾羌汗國
شىمالىي سۇلالىلەرنىڭ تارىخى	北史
باش تومۇز	小暑
تۇغلۇق تۆمۇرخان	禿忽魯帖木兒
چەتئەلگە چىقىپ ئوقۇش	留学
قارا ھۈلەگۈ	哈剌旭烈
ئۇچتۇرپان ناھىيىسى	乌什县
چىرا ناھىيىسى	策勒县
كەلپىن ناھىيىسى	柯坪县
قاراقاش ناھىيىسى	墨玉县
جىڭ ناھىيىسى	精河县
نىيە ناھىيىسى	民丰县
غۇلجا ناھىيىسى	伊宁县
شۇيموگۇ رايونى	水磨沟区
كېرىيە ناھىيىسى	于田县
تۇخۇم نەيچىسى	输卵管
شىنجاڭ ئىشلەپچىقىرىش - قۇرۇلۇش بىڭتۇەنى	新疆生产建设兵团
قەشقەر ھېيتگاھ مەسچىتى	艾提尕尔清真寺
شياڭگاڭ پەن ـ تېخنىكا ئۇنىۋېرسىتېتى	香港科技大學
كونا بەش دەۋر تارىخى	旧五代史
دۇۋا	笃哇
باراق	八剌
ﻣﯧﯔ ﺟىيەنﺠﯘ	孟建柱
جېمىنەي ناھىيىسى	吉木乃县
توققۇزتارا ناھىيىسى	巩留县
قاراماي رايونى	克拉玛依区
نىلقا ناھىيىسى	尼勒克县
مۇرات ناسىروۋ	木拉提·纳斯洛夫
رۇس مىللىتى	中国俄罗斯族
تېكەس ناھىيىسى	特克斯县
توقسۇ ناھىيىسى	新和县
ئېسفەھان ۋىلايىتى	伊斯法罕省
تۈر:تۈركىيە	Category:土耳其
تۈر:ئۆسۈملۈك	Category:植物
تۈر:فىزىكا	Category:物理学
تۈر:تەبىئىي پەن	Category:自然科学
تۈر:Geografia	Category:地理
قەشقەر دەرياسى	喀什噶尔河
كۆكتوقاي بازىرى	可可托海镇
لەغمەن	拉面
ماخۇاتېڭ	马化腾
قۇتادغۇبىلىك	福乐智慧
شەيدۇللا	赛图拉镇
تۈر:خرىستىئان دىنى	Category:基督教
بارلاس قەبىلىسى	巴魯剌思氏
قەدىمكى ئۇيغۇر يېزىقى	回鹘字母
جىڭزۇ مىللىتى	越僑
ئەنقەرە ۋىلايىتى	安卡拉省
قاراقاش دەرياسى	喀拉喀什河
يورۇڭقاش دەرياسى	玉龙喀什河
جۇڭغار قۇلانى	蒙古野驢
ئەرەب ھەرپلىرى ئاساسىدىكى ئۇيغۇر يېزىقى	老维文
چەرچەن دەرياسى	车尔臣河
تۇنيۇقۇق	暾欲谷
ئىراق ۋە شام ئىسلام دۆلىتى	伊斯兰国
ماجيەن	馬堅
بۇزان	不赞
پۇشتۇ مىللىتى	普什圖人
يەسۈ مۆڭكە	也速蒙哥
تارانچى	塔蘭奇
مەشرەپ	麦西热甫
شىخەنزە ئۇنىۋېرسىتېتى	石河子大学
قەشقەر ئايىرپورت	喀什机场
مۇقام	维吾尔木卡姆
ئابدۇخالىق ئۇيغۇر	阿布都哈力克·维吾尔
ئەخمەتجان ﻗﺎﺳﯩﻤﻰ	阿合买提江·哈斯木
ئەلجىگىدەي	燕只吉台
گېئورگى بۇچنېر ئەدەبىيات مۇكاپاتى	格奥尔格·毕希纳奖
تىيىندورىشۇتى تەڭرىقۇت	亭獨尸逐侯鞮單于
شىتۇڭشىجۇ قۇت تەڭرىقۇت	䤈僮尸逐侯鞮單于
شولان شىسۇقۇتى تەڭرىقۇت	休兰尸逐侯鞮单于
كىئۇچۇ گۇيلىنت تەڭرىقۇت	丘除車林鞮單于
ئەنگور تەڭرىقۇت	安國 (單于)
كىئۇفۇيۇتى تەڭرىقۇت	丘浮尤鞮單于
غۇيەشى سۇقۇتى تەڭرىقۇت	湖邪尸逐侯鞮单于
مۇباراك شاھ	木八剌沙
كۆنچەك	宽阇
ئابدۇرېھىم ئۆتكۈر	阿布都热依穆·乌提库尔
سۇلتان سەئىدخان	赛德
دۇۋا تۆمۇرخان	都来帖木儿
قوغشار تەڭرىقۇت	䤈落尸逐鞮單于
تالىقۇ	塔里忽
نۇر بەكرى	努尔·白克力
ﺩﯨﻠﺒﻪﺭ ﻳﯘﻧﯘﺱ	迪里拜尔
سۇلتان سۇتۇق بۇغراخان	萨图克·博格拉汗
بىنەپشە رەڭ	紫色
سەيپىدىن ئەزىزى	赛福鼎·艾则孜
ئەركىن ئابدۇللا	艾尔肯·阿布杜拉
تەمبۈر	弹拨尔
Ördek	鸭
قېلىپ:Tl	Template:Tl
قېلىپ:Userbox	Template:Userbox
ئۇخاۋچۈ يېزىسى	五号渠乡
Wikipedia:Administrators	Wikipedia:管理员
تۈر:جۇڭخۇا مىللەتلىرى	Category:中华民族
مىسىر	埃及
قېلىپ:Bot	Template:Bot
كانادا	加拿大
Wikipedia:ھەققىدە	Wikipedia:关于
قېلىپ:Flagicon	Template:Flagicon
قېلىپ:Documentation	Template:Documentation
Sung Jae-gi	成在基
ئايكۆل يېزىسى	阿依库勒乡
تۇرغۇن ئالماس	吐爾洪阿力馬斯
قېلىپ:Softredirect	Template:軟重定向
قېلىپ:Delete	Template:Delete
بېيداچۈ يېزىسى	北大渠乡
بورقاي يېزىسى	包尔海乡
تۈر:تىل	Category:语言
Wikipedia:General disclaimer	Wikipedia:免责声明
قېلىپ:Navbox	Template:Navbox
ئورقۇن-يېنسەي يېزىقى	突厥文
خالتىلىق چاشقان	袋鼠
ئالاتاۋ ئېغىزى	阿拉山口市
ئىسمايىل تىلىۋالدى	司马义·铁力瓦尔地
قېلىپ:Tnavbar	Template:Navbar
قېلىپ:Babel	Template:Babel
قېلىپ:Commons	Template:Commons
قېلىپ:Reflist	Template:Reflist
قېلىپ:Stub	Template:Stub
قېلىپ:User az	Template:User az
قېلىپ:User de	Template:User de
قېلىپ:User de-1	Template:User de-1
قېلىپ:User es	Template:User es
قېلىپ:User de-3	Template:User de-3
قېلىپ:User en-3	Template:User en-3
قېلىپ:User en-1	Template:User en-1
قېلىپ:User en-2	Template:User en-2
قېلىپ:User en-4	Template:User en-4
قېلىپ:User en	Template:User en
قېلىپ:User de-2	Template:User de-2
قېلىپ:User es-1	Template:User es-1
قېلىپ:User fr-1	Template:User fr-1
قېلىپ:User ja-4	Template:User ja-4
قېلىپ:User sk	Template:User sk
قېلىپ:User tr-2	Template:User tr-2
قېلىپ:User tr	Template:User tr
قېلىپ:User ja	Template:User ja
قېلىپ:User ja-1	Template:User ja-1
قېلىپ:User fr	Template:User fr
قېلىپ:Location map/Info	Template:Location map/Info
قېلىپ:Mod	Template:Mod
قېلىپ:Welcome	Template:Welcome
تۈر:كىشلىك ئالاقە	Category:人際溝通
تۈر:User fr-1	Category:Fr-1 使用者
قېلىپ:Country showdata	Template:Country showdata
قېلىپ:Category handler	Template:Category handler
قېلىپ:ئافرىقا	Template:Africa
قېلىپ:Country data NEP	Template:Country data Nepal
قېلىپ:Documentation/docname	Template:Documentation/docname
تۈر:User en-4	Category:En-4 使用者
تۈر:User en	Category:En 使用者
تۈر:User zh	Category:Zh 使用者
تۈر:User zh-N	Category:Zh 母语使用者
تۈر:User en-2	Category:En-2 使用者
قېلىپ:Infobox	Template:Infobox
قېلىپ:User zh	Template:User zh
قېلىپ:Legend	Template:Legend
قېلىپ:Ombox	Template:Ombox
قېلىپ:Country data	Template:Country data
قېلىپ:Pp-template	Template:Pp-template
قېلىپ:User ru	Template:User ru
قېلىپ:IPA	Template:IPA
قېلىپ:ئىنجىل	Template:新约圣经目录
قېلىپ:ئوكيانىيە	Template:Oceania
Wikipedia:Nospam	Wikipedia:被保护的标题
قېلىپ:Unreferenced	Category:缺少来源的条目
قېلىپ:جۇڭخۇا خەلق جۇمھۇرىيىتى	Template:中华人民共和国省级行政区
شىنجاڭ تىببى ئۇنىۋېرسىتېتى	新疆医科大学
قېلىپ:ياپونىيە	Template:日本一级行政区
زۇنۇن قادىرى	祖农·哈迪尔
تۈر:User ja-N	Category:Ja 母语使用者
تۈر:سانائەت	Category:产业
قېلىپ:Tick	Template:Tick
قېلىپ:رۇسىيە	Template:俄羅斯行政區劃
قېلىپ:Infobox person	Template:Infobox person
قېلىپ:Country data PRC	Template:Country data People's Republic of China
قېلىپ:ياۋروپا	Template:Europe
تۈر:User az	Category:Az 使用者
تۈر:User sk	Category:Sk 使用者
تۈر:User fr	Category:Fr 使用者
تۈر:User ja	Category:Ja 使用者
تۈر:User mn	Category:Mn 使用者
تۈر:User az-3	Category:Az-3 使用者
تۈر:User fr-3	Category:Fr-3 使用者
تۈر:User ja-3	Category:Ja-3 使用者
تۈر:User tr-3	Category:Tr-3 使用者
تۈر:User tr-1	Category:Tr-1 使用者
تۈر:User fr-4	Category:Fr-4 使用者
تۈر:User fr-2	Category:Fr-2 使用者
تۈر:User ja-2	Category:Ja-2 使用者
تۈر:User tr-2	Category:Tr-2 使用者
تۈر:User ko-N	Category:Ko 母語使用者
تۈر:User fr-N	Category:Fr 母語使用者
تۈر:User ru-N	Category:Ru 母語使用者
تۈر:Articles with hCards	Category:含有hCards的条目
تۈر:User az-1	Category:Az-1 使用者
تۈر:User az-2	Category:Az-2 使用者
تۈر:User az-4	Category:Az-4 使用者
تۈر:User az-N	Category:Az 母語使用者
تۈر:User sk-N	Category:Sk 母語使用者
تۈر:User de	Category:De 使用者
تۈر:User de-2	Category:De-2 使用者
تۈر:User de-3	Category:De-3 使用者
تۈر:User de-4	Category:De-4 使用者
تۈر:User de-N	Category:De 母語使用者
شىراز	設拉子
تۈر:User en-3	Category:En-3 使用者
تۈر:User en-N	Category:En 母语使用者
تۈر:User es	Category:Es 使用者
تۈر:User es-1	Category:Es-1 使用者
تۈر:User es-N	Category:Es 母语使用者
تۈر:Articles with microformats	Category:有微格式的条目
تۈر:User ja-1	Category:Ja-1 使用者
تۈر:User kk	Category:Kk 使用者
تۈر:User kk-3	Category:Kk-3 使用者
تۈر:User ko	Category:Ko 使用者
تۈر:User ko-3	Category:Ko-3 使用者
تۈر:User ky	Category:Ky 使用者
جۇڭخۇا خةلق جۇمھۇرىيتىنىڭ ئةمگةك توختام قانۇنى	中华人民共和国劳动法
تۈر:User ru-1	Category:Ru-1 使用者
تۈر:User mn-1	Category:Mn-1 使用者
قېلىپ:Table Greekletters	Template:Greek alphabet sidebar
تۈر:ئىقتىساد	Category:经济
باشقۇرغۇچى مەشغۇلات قوللانمىسى	Help:管理員操作手冊
تۈر:User zh-min-nan	Category:Nan 使用者
تۈر:User zh-min-nan-3	Category:Nan-3 使用者
قېلىپ:Sockpuppet	Template:Sockpuppet
قېلىپ:User ru-2	Template:User ru-2
تۈر:User ru	Category:Ru 使用者
تۈر:User tk	Category:Tk 使用者
تۈر:User tr	Category:Tr 使用者
تۈر:User tr-4	Category:Tr-4 使用者
تۈر:User tr-N	Category:Tr 母語使用者
تۈر:User ug	Category:Ug 使用者
تۈر:User ug-1	Category:Ug-1 使用者
تۈر:User ug-2	Category:Ug-2 使用者
تۈر:User ug-N	Category:Ug 母語使用者
تۈر:User uz	Category:Uz 使用者
ۋىكىپېدىيە:ھۆججەت ئىشلىتىش پىرىنسىپى	Wikipedia:文件使用守则
گاۋشەن مىللىتى	高山族
ئۇيغۇر سىرىل يېزىقى	西里尔维文
بىلگە كۆل قادىرخان	阙毗伽·卡迪尔汗
مېتال ماتېرىياللار	金属材料
قېلىپ:Infobox City Japan	Template:日本都市
ساتار	萨塔尔琴
تۈر:ۋىتامىنلار	Category:维生素
قەشقەر پىداگوگىكا ئىنستىتۇتى	喀什师范学院
دولان	刀郎
قىزىلبۇيى	克孜勒博依乡
قېلىپ:User ru-1	Template:User ru-1
قېلىپ:User tr-1	Template:User tr-1
قېلىپ:User tr-3	Template:User tr-3
قېلىپ:User zh-1	Template:User zh-1
قېلىپ:User zh-2	Template:User zh-2
قېلىپ:User zh-3	Template:User zh-3
قېلىپ:User zh-4	Template:User zh-4
تۈر:شىنجاڭ ئۇيغۇر ئاپتونوم رايونىدىكى ئالى مەكتەپلەر	Category:新疆高等院校
تۈر:User zh-1	Category:Zh-1 使用者
تۈر:User zh-4	Category:Zh-4 使用者
تۈر:User zh-3	Category:Zh-3 使用者
تۈر:User zh-2	Category:Zh-2 使用者
تۈر:خىمىيىۋى ئېلېمېنت	Category:化学元素
تۈر:لېكسىكولوگىيە	Category:詞彙學
تۈر:ئۆزبېكىستان	Category:烏茲別克
تۈر:جەمئىيەت مەسلىسى	Category:社会问题
تۈر:ئاتوم يادرو فىزىكىسى	Category:原子核物理学
ئەينەك تالا	玻璃钢
سەۋزە	胡萝卜
تاشقى پېرېۋوت	外汇
چاغانچېكە يېزىسى	查汗采开乡
تۈر:قەشقەر	Category:喀什
تۈر:جۇڭخۇا خەلق جۇمھۇرىيىتى	Category:中华人民共和国
تۈر:ئېتمولوگىيە	Category:語源學
قېلىپ:Flag	Template:Flag
قېلىپ:User ug-1	Template:User ug-1
شىنجاڭ يېزائېگىلىك ئۇنىۋېرسىتېتى	新疆农业大学
شىنجاڭ سەنئەت ئىنىستىتۇتى	新疆艺术学院
شىنجاڭ مالىيە-ئىقتىساد ئۇنىۋېرسىتېتى	新疆财经大学
قېلىپ:جۇڭگودىكى مىللەتلەر	Template:中华民族
قېلىپ:User ug	Template:User ug
قېلىپ:User mn-1	Template:User mn-1
قېلىپ:UF-hcard-geo	Template:UF-hcard-geo
تۈر:بىيولوگ	Category:生物学家
تراگۇلۇس بۇغىسى	鼷鹿科
تۈر:خاس ئات ئىلمى	Category:專名學
تۈر:مەسلە	Category:问题
تۈر:Uyghur tili	Category:维吾尔语
تۈر:User en-1	Category:En-1 使用者
تۈر:User de-1	Category:De-1 使用者
تۈر:شىنجاڭ ئىشلەپچىقىرىش - قۇرۇلۇش بىڭتۇەنى	Category:新疆生产建设兵团
قېلىپ:ئانتروپوتومىيە	Template:人体解剖学
قېلىپ:User zh-min-nan-3	Template:User nan-3
قېلىپ:User ug-2	Template:User ug-2
چوشقا قۇيرۇق بۇغا	豚鹿
ﻗﺎﺭﺍ ﭘﺎﭘﺎﻕ ﻣﯩﻠﻠﯩﺘﻰ	卡拉帕帕赫人
قېلىپ:شىنجاڭ	Template:新疆行政区划
شىنجاڭ ئۇيغۇر ئاپتونوم رايونىدىكى ئالى مەكتەپلەر	新疆维吾尔自治区高等学校列表
سېسىق قوزان	麝貓
بۇقا تۆمۇرخان	秃里帖木儿
كۆكتۈرك خانلىقى	突厥汗国
خوتەن شەھىرى	和田市
ئالاھىدە:RecentChanges	Special:最近更改
تۈر:User ja-4	Category:Ja-4 使用者
خارۇكو ئوبوكاتا	小保方晴子
مەخسۇت مۇھىتى	马合苏提·穆依提
ئىلھام سابىر	伊力哈木·沙比尔
