非洲	非洲
日本	日本
南美洲	南美洲
挪威	挪威
英格兰	英格兰
苏格兰	蘇格蘭
匈牙利	匈牙利
西班牙	西班牙
美国	美国
比利时	比利时
卢森堡	卢森堡
地球	地球
人	人
欢喜	快樂
芬兰	芬兰
瑞典	瑞典
波兰	波兰
立陶宛	立陶宛
意大利	意大利
瑞士	瑞士
奥地利	奥地利
希腊	希腊
土耳其	土耳其
啤酒	啤酒
葡萄牙	葡萄牙
欧洲	欧洲
亚洲	亚洲
维基百科	维基百科
尼德兰	荷兰
PHP	PHP
纽约市	纽约
旧金山	旧金山
洛杉矶	洛杉矶
计算机	電子計算機
办合纳	伯尔尼
极乃伐	日内瓦
苏黎世	苏黎世
巴拉克·奥巴马	贝拉克·奥巴马
乌拉圭	乌拉圭
白才尔	巴塞尔
打印机	打印机
伦敦	伦敦
开罗	开罗
苹果	苹果
墨西哥	墨西哥
大西洋	大西洋
太平洋	太平洋
加利福尼亚	加利福尼亚州
波士顿	波士顿
礼拜一	星期一
火星	火星
肯尼亚	肯尼亚
礼拜两	星期二
礼拜三	星期三
礼拜四	星期四
礼拜五	星期五
礼拜六	星期六
礼拜天	星期日
法国	法国
世界语	世界语
狗	犬
英国	英国
貓	猫
中华人民共和国	中华人民共和国
法文	法语
鱼	鱼
巴西	巴西
俄罗斯	俄罗斯
大海	海
圓周率	圓周率
Π	Π
聖保羅	聖保羅 (巴西)
该办克	魁北克
德国	德国
白俄罗斯	白俄罗斯
德语	德语
冰岛	冰岛
愛沙尼亞	爱沙尼亚
土星	土星
巧克力	巧克力
飞机	固定翼飛機
打仗	战争
拉脱维亚	拉脫維亞
乌克兰	乌克兰
捷克	捷克
斯洛伐克	斯洛伐克
斯洛文尼亚	斯洛文尼亚
摩尔多瓦	摩尔多瓦
罗马尼亚	羅馬尼亞
保加利亚	保加利亚
罗马	罗马
马其顿	馬其頓共和國
阿爾巴尼亞	阿尔巴尼亚
格陵兰	格陵兰
克罗地亚	克罗地亚
波黑	波斯尼亚和黑塞哥维那
阿塞拜疆	阿塞拜疆
安道尔	安道尔
塞浦路斯	賽普勒斯
格鲁吉亚	格鲁吉亚
哈萨克斯坦	哈萨克斯坦
马耳他	马耳他
摩纳哥	摩纳哥
黑山共和国	蒙特內哥羅
梵蒂冈	梵蒂冈
圣马力诺	圣马力诺
布鲁塞尔	布鲁塞尔
古巴	古巴
大众汽车	大众汽车
Java	Java
印度尼西亚	印度尼西亚
南非	南非
阿尔及利亚	阿尔及利亚
乌兹别克斯坦	乌兹别克斯坦
欧罗维竞唱歌比赛	歐洲歌唱大賽
水	水
木	木材
电视机	电视
冰岛文	冰岛语
智利	智利
耶稣	耶稣
語言	語言
英语维基百科	英语维基百科
尼古拉·萨科齐	尼古拉·萨科齐
新加坡	新加坡
科学	科学
自由軟件	自由软件
列支敦士登	列支敦斯登
希特拉	阿道夫·希特勒
WikiLeaks	維基解密
第二次世界大战	第二次世界大战
科隆	科隆
Linux	Linux
数学	数学
拉丁文	拉丁语
巴林	巴林
亚美尼亚	亞美尼亞
塞尔维亚	塞尔维亚
月球	月球
澳大利亚	澳大利亚
物理学	物理学
阿根廷	阿根廷
秘鲁	秘鲁
朝鲜民主主义人民共和国	朝鲜民主主义人民共和国
柬埔寨	柬埔寨
恐龙	恐龙
回教	伊斯兰教
里昂	里昂
欧洲联盟	欧洲联盟
女性	女性
诗	诗歌
米蘭	米蘭
屁眼	肛门
古高尔	古高爾
珠穆朗玛峰	珠穆朗瑪峰
城市	城市
巴斯德	路易·巴斯德
村	村
大洋洲	大洋洲
太阳系	太阳系
氢	氢
维基共享	维基共享资源
揚聲器	揚聲器
东帝汶	东帝汶
维嘞合朋纳	维勒班
学纳河	罗纳河
迪拜	杜拜
瀑瑶兰葡萄酒	薄酒萊葡萄酒
哥白尼	尼古拉·哥白尼
碳	碳
音乐	音乐
圣皮得斯堡	圣彼得堡
北	北
新西兰	新西兰
南	南
印度	印度
西	西
氯气	氯
铅	铅
蒙古国	蒙古国
委内瑞拉	委內瑞拉
国际象棋	國際象棋
缅因	缅因州
苏里南	蘇利南
巴拉圭	巴拉圭
圭亚那	圭亚那
艺术	艺术
厄瓜多尔	厄瓜多尔
哥伦比亚	哥伦比亚
佛教	佛教
玻利维亚	玻利維亞
特里尼达搭仔多巴哥	千里達及托巴哥
新罕布什爾	新罕布什尔州
马萨诸塞	麻薩諸塞州
康涅狄格	康乃狄克州
鸡	鸡
澤西島	澤西
猪猡	家豬
伊朗	伊朗
伊拉克	伊拉克
阿拉斯加	阿拉斯加州
以色列	以色列
巴拿马	巴拿马
也門	也门
约旦	约旦
佛罗里达州	佛罗里达州
吉尔吉斯斯坦	吉尔吉斯斯坦
科威特	科威特
老挝	老挝
黎巴嫩	黎巴嫩
俄勒冈	俄勒冈州
马尔代芙	马尔代夫
马来西亚	马来西亚
缅甸	缅甸
尼泊尔	尼泊尔
阿曼	阿曼
巴基斯坦	巴基斯坦
卡塔尔	卡塔尔
沙特阿拉伯	沙特阿拉伯
斯里兰卡	斯里蘭卡
史太林	斯大林
叙利亚	叙利亚
塔吉克斯坦	塔吉克斯坦
口袋妖怪	口袋妖怪系列
中华民国	中華民國
泰国	泰国
火车	鐵路列車
土库曼斯坦	土库曼斯坦
阿拉伯联合酋长国	阿拉伯联合酋长国
越南	越南
新西伯利亚	新西伯利亚
大韩民国	大韩民国
阿富汗	阿富汗
金	金
喀山	喀山
孟加拉	孟加拉国
马里	马里共和国
安哥拉	安哥拉
不丹	不丹
文莱	文莱
菲律宾	菲律宾
牛顿	艾萨克·牛顿
OpenStreetMap	開放街圖
量子力学	量子力学
突尼斯	突尼西亞
赞比亚	赞比亚
津巴布韦	辛巴威
北京	北京市
贝宁	贝宁
博茨瓦纳	波札那
布隆迪	蒲隆地
刚果共和国	刚果共和国
刚果民主共和国	刚果民主共和国
甘地	圣雄甘地
连环画	漫画
冈比亚	冈比亚
科特迪瓦	科特迪瓦
喀麦隆	喀麦隆
尼日利亚	奈及利亞
索马里	索马里
铌	铌
凱撒	尤利烏斯·凱撒
苏丹	苏丹共和国
汉堡	汉堡
联合国	联合国
唐担	但丁·阿利吉耶里
艾哈迈德堡	艾哈迈达巴德
锡	锡
克林顿总统	比尔·克林顿
孟买	孟买
波多黎各	波多黎各
卡纳塔克邦	卡纳塔克邦
列农	约翰·列侬
爱达荷州	爱达荷州
华盛顿州	华盛顿州
科索沃	科索沃
潘基文	潘基文
Kofi Annan	科菲·安南
分类:页面分类	Category:頁面分類
多特蒙德	多特蒙德
冬天	冬季
西班牙语	西班牙语
匹兹堡	匹兹堡
费城	費城
金奈	金奈
班加罗尔	班加羅爾
钞票	貨幣
纽约州	纽约州
罗德岛	羅德島州
昆虫	昆虫
宾夕法尼亚	宾夕法尼亚州
Uetersen	于特森
奧古斯都	奥古斯都
微软视窗	Microsoft Windows
直布罗陀	直布罗陀
布宜诺斯艾利斯	布宜諾斯艾利斯
东京都	東京都
爱荷华州	艾奥瓦州
里昂地铁	里昂地铁
印地语	印地语
艾迪托·比娅呋	艾迪特·皮雅芙
因斯孛鲁克	因斯布鲁克
都柏林	都柏林
法兰克福	美茵河畔法蘭克福
天主教	天主教
圣经	聖經
金边	金边
胡志明市	胡志明市
河內市	河內市
真耶稣教会	真耶稣教会
英语	英语
曼谷	曼谷
臺北市	臺北市
同海市	同海市
Końskowola	孔斯科沃拉
达累斯萨拉姆	达累斯萨拉姆
Al-Khartoum	喀土穆
1月11号	1月11日
明斯克	明斯克
微软公司	微软
库鲁夫	库鲁夫
化学	化學
2月19号	2月19日
Visual Basic	Visual Basic
本笃十六世	本篤十六世
12月25号	12月25日
8月4号	8月4日
8月31号	8月31日
迈克尔·杰克逊	迈克尔·杰克逊
巴西利亞	巴西利亚
圣地牙哥	圣地亚哥-德智利
坎培拉	堪培拉
悉尼	悉尼
墨尔本	墨尔本
木卫三	木卫三
珀斯	珀斯
西澳大利亚州	西澳大利亚州
北领地 (澳大利亚)	北領地
苏门答腊岛	蘇門答臘
突尼斯市	突尼斯市
德黑兰	德黑兰
亚的斯亚贝巴	亚的斯亚贝巴
安卡拉	安卡拉
贝尔格莱德	贝尔格莱德
分类:维基百科模板	Category:維基百科模板
爪哇岛	爪哇岛
法属圭亚娜	法屬圭亞那
安曼	安曼
贝鲁特	贝鲁特
分类:国家模板	Category:国家模板
内罗毕	奈洛比
分类:地理模板	Category:地理模板
学堂	学校
大学	大學
Wikipedia:沙盘	Wikipedia:沙盒
屋	住宅
卡尔梅克共和国	卡尔梅克共和国
金头公园	金头公园
地图	地图
奥萨斯库	奥萨斯库
弗杭歇维嘞（学纳）	弗朗舍维尔 (罗讷省)
同海机场	同海機場
里昂祭光节	里昂灯光节
分类:日本历史	Category:日本历史
孔子	孔子
分类:数学	Category:数学
法罗群岛	法罗群岛
分类:印度历史	Category:印度歷史
分类:泰国历史	Category:泰國歷史
巴厘岛	巴厘岛
分类:缅甸历史	Category:緬甸歷史
欧元	欧元
美元	美元
地中海	地中海
威尼斯共和国	威尼斯共和国
杭州市	杭州市
基督教	基督教
模板:亚洲行政区划	Template:亞洲
模板:Support	Template:Support
金国	金朝
洲	洲
模板:ALA	Template:ALA
阿德来得	阿德莱德
首都	首都
葡萄牙语	葡萄牙語
模板:Portal	Template:Portal
公元1949年	1949年
阿嘞玛桑	艾爾瑪善鎮
黄现璠	黄现璠
日语	日语
百科全书	百科全书
封面	Wikipedia:首页
路由器	路由器
棒球	棒球
奧林匹克运动会	奥林匹克运动会
长江	长江
里海	裏海
拉斐尔	拉斐尔·圣齐奥
电车	有軌電車
加泰罗尼亚	加泰罗尼亚
毛泽东	毛泽东
西安	西安市
拉萨市	拉萨市
性行为	性交
加夫列尔·加西亚·马尔克斯	加夫列尔·加西亚·马尔克斯
分类:快速删除候选	Category:快速删除候选
马可·波罗	马可·波罗
共产主义	共产主义
1368年	1368年
國家	国家
Joe Biden	乔·拜登
希拉里·克林顿	希拉里·罗德姆·克林顿
Yelena Isinbayeva	叶莲娜·伊辛巴耶娃
大英博物馆	大英博物馆
蒙彼利埃	蒙彼利埃
分类:天文学	Category:天文学
汉堡包	漢堡 (食物)
班合比让	佩皮尼昂
标致汽车	標緻汽車
李白	李白
图书馆	图书馆
世界银行	世界银行
汉武帝	汉武帝
女权主义	女性主義
元朝	元朝
库克船长	詹姆斯·庫克
郑和	鄭和
黃河	黄河
蚂蚁	蚂蚁
宋朝	宋朝
宋高宗	宋高宗
落苏	茄
龙	龙 (西方)
姆妈	母親
隆波岛	龙目岛
小人	儿童
俄语	俄语
人家	家
普京	弗拉基米尔·弗拉基米罗维奇·普京
东南亚国家联盟	东南亚国家联盟
面包	麵包
国际货币基金组织	國際貨幣基金組織
联合国教育科学文化组织	联合国教科文组织
联合国卫生组织	世界卫生组织
漢語	汉语
雨	雨
全球暖化	全球变暖
纳尔逊·曼德拉	纳尔逊·曼德拉
马丁·路德·金	马丁·路德·金
蛋白质	蛋白质
天灾	自然灾害
海啸	海啸
云	云
电视	电视机
几何学	几何学
日圆	日圓
单词	單詞
漢字	汉字
希腊字母	希腊字母
諺文	諺文
分类:法国	Category:法国
分类:音乐	Category:音乐
红楼梦	红楼梦
漫画	日本漫画
狐狸	狐
哈利波特	哈利·波特
小提琴	小提琴
肛交	肛交
教育	教育
男性	男性
婚姻	婚姻
法语维基百科	法語維基百科
咖啡	咖啡
果汁	果汁
山	山
第29届奧林匹克运动会	2008年夏季奥林匹克运动会
孙中山	孫中山
香港	香港
首尔	首爾
上海	上海市
伦敦 海斯楼 飞机场	倫敦希斯路機場
清朝	清朝
越南战争	越南战争
巴斯克语	巴斯克語
阿拉贡语	阿拉贡语
瓦伦西亚	巴倫西亞
玛丽咏·高帝娅	瑪莉安·歌迪雅
麦克斯韦	詹姆斯·克拉克·麦克斯韦
原子	原子
光	光
罗鲍斯	戴龙·罗伯斯
韩语	朝鮮語
官話	官话
高棉文	高棉语
弗洛伊德	西格蒙德·弗洛伊德
泰语	泰语
马来语	马来语
蒙古语	蒙古语
犹太教	犹太教
万象	永珍
莫白桑	居伊·德·莫泊桑
司马迁	司馬遷
朱熹	朱熹
廷巴克图	廷巴克图
伦理学	伦理学
沙·卢克·康	沙·魯克·罕
什叶派	什叶派
道教	道教
子宫	子宫
颈	頸
富克朗特群岛	福克兰群岛
马恩岛	曼島
戴安娜王妃	威爾斯王妃戴安娜
唐玄宗	唐玄宗
Α	Α
Ω	Ω
Μ	Μ
明朝	明朝
朱元璋	朱元璋
Φ	Φ
朱由检	崇禎帝
Laura Robson	勞拉·羅布森
2008年欧罗维竞唱歌比赛	2008年歐洲歌唱大賽
里昂有轨电车	里昂電車
强·马凯恩	約翰·麥凱恩
金正日	金正日
元素周期表	元素周期表
罗別脫 姆格比	羅伯·穆加貝
自杀	自殺
爬蟲類	爬行动物
Λ	Λ
伍老虎	老虎伍茲
洋山芋	马铃薯
三宝垄	三寶瓏
报纸	報紙
电话	电话
?	问号
美国空军	美国空军
菲德尔·卡斯特罗	菲德尔·卡斯特罗
元素单子	化學元素
广域网	广域网
围棋	围棋
电影	电影
气体	气体
液体	液体
固体	固体
脚踏车	自行車
农业	农业
温度	温度
面积	面积
数	数
玛丽亚·莎拉波娃	玛丽亚·莎拉波娃
重慶	重庆市
天津市	天津市
武汉	武汉市
世界地理索引	世界政區索引
玫瑰人生 (歌)	玫瑰人生
担桑身	妊娠
Google地图	Google地图
癌	癌症
残疾人	身心障礙
抗生素	抗细菌药
青霉素	青霉素
肺炎	肺炎
克来普	可麗餅
麻将	麻将
运河	运河
坝	水坝
牛顿 (单位)	牛頓 (單位)
世界报 (法国)	世界报 (法国)
万里长城	长城
可再生能源	可再生能源
电	電
核武器	核武器
Joomla!	Joomla!
吉卜赛语	罗姆语
壮语	壮语
自由人报 (法国)	解放报
安吉丽娜	安吉丽娜·朱莉
阿拉伯语	阿拉伯语
马多符	伯納·馬多夫
扬马延岛	揚馬延
弗	元 (貨幣)
科西嘉岛	科西嘉岛
奥克语	奥克语
克里斯蒂娜 艾伐脱	克里斯·埃弗特
李明博	李明博
Β	Β
Γ	Γ
Δ	Δ
Ε	Ε
Ζ	Ζ
Η	Η
Θ	Θ
Ι	Ι
Κ	Κ
Ν	Ν
Ξ	Ξ
Ο	Ο
Ρ	Ρ
Σ	Σ
Τ	Τ
Υ	Υ
Χ	Χ
Ψ	Ψ
复活节岛	復活節島
澳门	澳門
联想计算机公司	联想集团
梁振英	梁振英
董建华	董建華
胡锦涛	胡锦涛
习近平	习近平
深圳市	深圳市
廣東省	广东省
广西壮族自治区	广西壮族自治区
国际金融中心 (香港)	國際金融中心 (香港)
南澳大学	南澳大学
鹿儿岛县	鹿儿岛县
C语言	C语言
手铐	手銬
艾米·麦克唐纳 (歌手)	艾米·麦克唐纳
Wikipedia:Featured articles	Wikipedia:特色条目
模板:Link FA	Template:Link FA
Wikipedia:红茶坊	Wikipedia:互助客栈
釜山广域市	釜山廣域市
佛蒙特	佛蒙特州
广州	广州市
蔣中正	蔣中正
江泽民	江泽民
温家宝	温家宝
南京市	南京市
刘德华	劉德華
张学友	张学友
郭富城	郭富城
同济大学	同济大学
首都圈电铁	韓國首都圈電鐵
上海市南洋模范中学	上海市南洋模范中学
北京大学	北京大学
清華大學	清华大学
江苏省	江苏省
浙江省	浙江省
邓小平	邓小平
琶兰那克	帕拉納克市
菲律宾比索	菲律賓披索
西藏	西藏自治区
圆	圆
同性婚姻	同性婚姻
Francesc Fàbregas	塞斯克·法比加斯
手机	移动电话
太平山 (香港)	太平山 (香港)
欧洲杯足球赛	欧洲冠军联赛
马来亚半岛	马来半岛
平壤市	平壤
奥斯卡奖	奥斯卡金像奖
各经济实体国内生产总值列表	各国国内生产总值列表 (国际汇率)
司徒华	司徒華
黑龍江省	黑龙江省
芽庄市	芽莊市
教皇	教宗
波多黎各独立党	波多黎各獨立黨
钱塘江	钱塘江
四川省	四川省
蔡元培	蔡元培
圣诞	圣诞节
闰年	闰年
大田广域市	大田广域市
大邱广域市	大邱廣域市
仁川国际机场	仁川國際機場
仁川广域市	仁川廣域市
京畿道	京畿道
计算机科学	计算机科学
阿鲁巴	阿魯巴
国际音标	國際音標
河北省	河北省
GNU自由文档许可证	GNU自由文档许可证
陈水扁	陳水扁
台湾	臺灣
纽约	紐約 (消歧義)
2012年欧洲足球冠军赛	2012年欧洲足球锦标赛
路由	路由
人口密度	人口密度
爱尔兰	爱尔兰岛
南京航空航天大学	南京航空航天大学
鲁迅	鲁迅
有利大楼	有利大楼
湖	湖泊
黄瓜	黄瓜
南奥赛西亚	南奥塞梯
阿什哈巴德	阿什哈巴德
岛屿	島嶼
马赛	马赛
风牙己榜国家公园	峰牙－己榜國家公園
广平省	廣平省
赤道	赤道
字典	詞典
北塞浦路斯	北賽普勒斯土耳其共和國
沪剧	沪剧
死海	死海
英镑	英镑
金兰国际机场	金蘭國際機場
荷属安地列斯	荷属安的列斯
根西岛	根西
斯瓦尔巴群岛	斯瓦尔巴
Benetice	贝内蒂采
摄氏温标	摄氏温标
大叻市	大叻市
岘港市	岘港市
Washington	华盛顿
甴巴子	蟑螂
鱷魚	鳄目
中国工商银行	中国工商银行
朝鮮正祖	朝鮮正祖
人造卫星	人造衛星
太原省 (越南)	太原省
杀人鲸	虎鯨
印科软件	Infosys
苏岩礁	苏岩礁
日本海	日本海
东亚	东亚
北亚	北亚
南欧	南欧
东欧	东欧
北欧	北歐
西欧	西欧
中欧	中欧
辛基得语	特林吉特語
琉球国	琉球国
扶余国	扶餘國
县	县
氨基糖苷类抗生素	氨基糖苷类抗生素
伊斯兰历	伊斯兰历
柳京饭店	柳京飯店
霍顿汽车	霍顿汽车
市长	市长
中文维基百科	中文维基百科
总统	總統
满洲国	满洲国
安娜·伊凡诺维琪	安娜·伊萬諾維奇
圣诞岛	圣诞岛
明绞拉	明戈拉
黄宗羲	黄宗羲
臺灣省	臺灣省
拳击	拳击
樟宜国际机场	新加坡樟宜机场
大西洋处女	維珍航空
快达航空	澳洲航空
国立台湾大学	國立臺灣大學
斑马	斑馬
同奈省	同奈省
广义省	廣義省
金瓯省	金甌省
广南省 (越南)	廣南省
槟椥省	檳椥省
庆和省	慶和省
客家语	客家语
北宁省	北寧省
优八克	國際純粹與應用化學聯合會
赣语	贛語
海地克里奥耳语	海地克里奧爾語
大熊猫	大熊猫
孤立語言	孤立语言
卡纳达语	卡纳达语
杜甫	杜甫
瓦尔帕莱索	瓦尔帕莱索
演员	演員
分类:程序编制言话	Category:程序设计语言
瓦哈卡	瓦哈卡州
侗台语	壯侗語族
白脱	黄油
尼亚加拉瀑布	尼亚加拉瀑布
吴语	吴语
塔斯马尼亚	塔斯馬尼亞州
贝拉齐尔‧布托	贝娜齐尔·布托
费利佩二世 (西班牙)	腓力二世 (西班牙)
牛津大学	牛津大学
基地 (恐怖组织)	基地组织
英吉利海峡	英吉利海峡
柴尔兹孛格	萨尔茨堡
秦国	秦国
半岛	半岛
新疆維吾爾自治區	新疆维吾尔自治区
布里司班	布里斯班
东正教	正教會
各国首都列表	各国首都列表
平面镜	鏡子
锡金语	锡金语
孛拉特 皮此	畢·彼特
欧洲足球联合会	歐洲足球協會聯盟
美国个州	美国州份
议会	议会
大阪市	大阪市
集韵	集韻
剑桥大学	剑桥大学
牙膏	潔齒劑
通货膨胀	通货膨胀
艾美 羅森	艾美·羅森
竹	竹
刚果	刚果
马失拉地	瑪莎拉蒂
科科斯群岛	科科斯（基林）群島
昆士兰州	昆士蘭州
明尼阿波利斯	明尼阿波利斯
顺化市	順化市
马拉雅南语	马拉雅拉姆语
逻辑语	逻辑语
北江省	北江省
耶稣会	耶稣会
承天顺化省	承天順化省
北𣴓省	北𣴓省
阿伯丁	阿伯丁
莱州省	萊州省
河南省 (越南)	河南省 (越南)
上海浦东国际机场	上海浦东国际机场
政治學	政治学
闽东语	閩東語
闽南语	闽南语
安江省	安江省
茶荣省	茶榮省
Tycho Brahe	第谷·布拉赫
薄辽省	薄遼省
嘉莱省	嘉萊省
平福省	平福省
同塔省	同塔省
约旦河西岸	約旦河西岸地區
河江省	河江省
维克多利亚州	維多利亞州
多乐省	多樂省
平定省	平定省
上海言话	上海话
得农省	得農省
水晶之夜	水晶之夜
潮州话	潮州话
台语	臺灣話
门	門 (建築部件)
猪流感	豬流感
高平省	高平省
平阳省	平陽省
平顺省	平順省
巴地头顿省	巴地頭頓省
奠边省	奠邊省
三船敏郎	三船敏郎
印度电影观众奖	印度電影觀眾獎
AK-47	AK-47突击步枪
八国集团	八大工業國組織
孙武	孙武
国际商用机器公司	IBM
互聯網電影數據庫	互联网电影数据库
贝克特	萨缪尔·贝克特
达赖喇嘛	达赖喇嘛
邮政编码	邮政编码
Nicole Kidman	妮可·基嫚
联合国安理会	联合国安全理事会
洋火棒儿	火柴
雹	冰雹
南海	南海
肯波拉圣吉奥瓦尼	肯波拉圣吉奥瓦尼
朝鮮世宗	朝鮮世宗
奥克兰格兰玛学校	奧克蘭文法學校
电冰箱	冰箱
黄海	黄海
大仲马	大仲马
黄果树瀑布	黄果树瀑布
孟加拉湾	孟加拉灣
哈马斯	哈马斯
阿斯旺水坝	阿斯旺水坝
人民币	人民币
富士山	富士山
小鼠	小鼠属
索契	索契
迈克尔·菲尔普斯	迈克尔·菲尔普斯
卡地马党	前進黨 (以色列)
加沙地带	加沙地带
霍巴特	荷巴特
金草莓奖	金酸莓獎
律师	律師
相扑	相撲
希斯·莱杰	希斯·萊傑
安徽省	安徽省
江原道	江原道 (朝鮮八道)
内蒙古自治区	内蒙古自治区
金日成	金日成
全罗北道	全羅北道
济州特别自治道	濟州特別自治道
郁陵岛	鬱陵島
湄公河	湄公河
索尼	索尼
巴別塔	巴別塔
力学	力学
南半球	南半球
蔚山广域市	蔚山广域市
光州广域市	光州廣域市
温室效应	温室效应
Julia Gillard	朱莉亞·吉拉德
华国锋	华国锋
福建省	福建省
克拉耿富合脱	克拉根福
小熊猫	小熊猫
大溪地	大溪地
安东市	安东市
海南省	海南省
汉语拼音	汉语拼音
远东	遠東
西班牙国家足球队	西班牙國家足球隊
华氏温标	华氏温标
海峡群岛	海峡群岛
甘肃省	甘肃省
苏州市	苏州市
无锡市	无锡市
湖州市	湖州市
绍兴市	绍兴市
汉族	汉族
昆山	昆山市
宁波市	宁波市
ETA (民族组织)	埃塔
隆城国际机场	隆城國際機場
数据	数据
迪马 皮郎	季马·比兰
记者	記者
基本粒子	基本粒子
陆克文	陆克文
沙菲娅 劳塔露	索菲亚·罗塔璐
些拉·班琳	莎拉·佩林
云南省	云南省
苏丹 (称谓)	苏丹 (称谓)
德国国家足球队	德國國家足球隊
国立虎尾科技大学	國立虎尾科技大學
山东省	山东省
福楼拜	古斯塔夫·福樓拜
英属印度洋领地	英屬印度洋領地
地质年代	地质年代
河南省	河南省
乃堂雅虎	本雅明·内塔尼亚胡
护照	护照
遼寧省	辽宁省
件西卡 阿尔白	潔西卡·艾巴
桑•班	西恩·潘
GNOME	GNOME
台湾桃园国际机场	臺灣桃園國際機場
色子	骰子
吉林省	吉林省
东海	东海
2008年美国总统选举	2008年美国总统选举
苏州地铁1号线	苏州轨道交通1号线
沙吞区	沙吞县
阿南德	维斯瓦纳坦·阿南德
湖南省	湖南省
水族馆	水族箱
青海省	青海省
柏威夏寺	柏威夏寺
豪納省	羅納省
金一葉	金一葉
陸龜	陸龜
話筒	麦克风
山西省	山西省
魔方	魔方
尼德兰国家足球队	荷蘭國家足球隊
谜子	謎語
艾西瓦娅·巴克罕	艾西瓦娅·巴克罕
贵州省	贵州省
Warren Buffett	沃伦·巴菲特
蹔𧉆	蟋蟀
纸币	紙幣
加沙城	加薩
白斯克	巴斯克地區
安达曼海	安达曼海
胡适	胡適
穆斯林	穆斯林
孛路內 (Blu-Ray)	藍光光碟
法国国家足球队	法國國家足球隊
后现代	后现代主义
宮城县	宮城縣
帕荔斯 希尔顿	芭黎絲·希爾頓
陕西省	陕西省
模板:Commonscat	Template:Commons category
岩手县	岩手县
死人	屍體
莱纳斯·鲍林	萊納斯·鮑林
Patrick Swayze	派屈克·史威茲
嫦娥1号	嫦娥一号
刘裕	宋武帝
水彩画	水彩画
李舜臣	李舜臣 (朝鮮)
香港政区	香港行政區劃
南洞区	南洞區
富平区	富平區
巴黎地铁	巴黎地鐵
陈方安生	陳方安生
釜山地铁	釜山都市鐵道
清迈	清邁
对马海峽	對馬海峽
珍珠港事件	珍珠港事件
分类:化学模板	Category:化学模板
模板:Taxobox	Template:Taxobox
松下电器	松下電器
丰田汽车	丰田汽车
田鸡	无尾目
艾奇亚	宜家家居
火车站	鐵路車站
洛东江	洛東江
模板:中国历史	Template:中国历史
金正恩	金正恩
豪萨语	豪萨语
闽语	闽语
莆仙语	莆仙語
徐汇区	徐汇区
江西省	江西省
台湾省 (中华人民共和国)	台湾省 (中华人民共和国)
纳姆耶尔·旺楚克 (不丹国王)	吉格梅·凯萨尔·纳姆耶尔·旺楚克
阮明哲	阮明哲
宁夏回族自治区	宁夏回族自治区
拿督阿都拉萨	纳吉·阿都拉萨
吉格梅·廷礼	吉莫·廷禮
约翰·菲利普·凯伊	约翰·基
宿迁市	宿迁市
扬州市	扬州市
泰州	泰州市
南通	南通市
镇江市	镇江市
常州市	常州市
嘉兴市	嘉兴市
金华市	金华市
衢州	衢州市
台州市	台州市
舟山市	舟山市
迪斯科	迪斯科
沧浪区	沧浪区
阉	閹割
老虫	鼠
以色列国防军	以色列國防軍
寿春机场	壽春機場
嘟嘟車	嘟嘟車
海蒂·克鲁姆	海迪·克林
阿拉伯文数字	阿拉伯文数字
空军	空军
周庄镇 (昆山)	周庄镇 (昆山市)
大名	大名 (称谓)
太仓	太仓市
劳莱士表	劳力士
数码照相机	数码相机
数词	數詞
哈里发	哈里发
汇率	汇率
青森县	青森縣
福岛县	福岛县
梁思成	梁思成
青蛙	蛙屬
海防市	海防市
斯堪的纳维亚半岛	斯堪的纳维亚半岛
里尔克	莱纳·玛利亚·里尔克
排列组合	组合数学
鲍林标度	电负性
街道	街道
Wikipedia:新闻发布	Wikipedia:宣告
机器翻译	机器翻译
阿根廷国家足球队	阿根廷國家足球隊
面向对象程式编制	面向对象程序设计
千叶县	千葉縣
定积分	积分
故宫	故宫
泰米尔猛虎解放组织	泰米尔伊拉姆猛虎解放组织
印度卢比	印度盧比
Microsoft Outlook	Microsoft Outlook
早饭	早餐
自动银行出纳机	自動櫃員機
秋田县	秋田县
乌克兰元	乌克兰格里夫纳
Ségolène Royal	塞格琳·羅雅爾
通用汽车	通用汽车
1998年个中国水灾	1998年中国水灾
差头	出租車
乌赛	地区
雷 (天气)	雷
滇池	滇池
拿塔莎 康埔西	娜塔莎·坎普希
新浪微博	新浪微博
模板:Cite book	Template:Cite book
香农 (计算数学家)	克劳德·香农
宝莱坞	宝莱坞
三角函数	三角函数
2009年甲型H1N1流感疫情	2009年H1N1流感大流行
草	野草
文瑾莹	文瑾瑩
2004年欧洲足球冠军赛	2004年歐洲足球錦標賽
严重急性呼吸道综合症	嚴重急性呼吸系統綜合症
Flickr	Flickr
John C. Mather	约翰·马瑟
索尔·珀尔马特	索尔·珀尔马特
希腊数字	希腊数字
人民力量党 (泰国)	人民力量黨
俞正声	俞正声
克里米亚鞑靼人	克里米亞韃靼人
伊斯兰圣战组织 (巴勒斯坦)	巴勒斯坦伊斯兰圣战组织
2011年亚洲杯足球比赛入围赛	2011年亞洲盃外圍賽
爱媛县	爱媛县
圣灰星期三	大齋首日
邻舍	近鄰社區
沙地	干草原
鸡窠生凤凰 (电影)	貧民百萬富翁
浦东新区	浦东新区
天坛	天坛
外滩	外滩
山形县	山形县
基呒湖	基伏湖
东野圭吾	東野圭吾
电子工程	电子工程
台湾海峡	台灣海峽
神奈川县	神奈川縣
中国地区	中国地方
长野县	长野县
埼玉县	埼玉縣
笼	籠
英属印度	英属印度
法国高速铁路	法国高速列车
Ϝ	Ϝ
群马县	群馬縣
Ϙ	Ϙ
Hugh Jackman	休·傑克曼
兵库县	兵库县
2004年东南亚大地震搭海啸	2004年印度洋大地震
李准基	李準基
安娜·库妮可娃	安娜·庫妮可娃
天线	天线
泰国湾	泰國灣
2000年欧洲足球冠军赛	2000年歐洲足球錦標賽
Ϛ	Ϛ
兵房	營房
石川县	石川縣
妓院	妓院
国际单位制词头	国际单位制词头
静冈县	靜岡縣
对话	对话
Ͳ	Ͳ
农民	農夫
葡蛮郎	回力镖
渧拉米酥	提拉米蘇
Ϻ	Ϻ
毛巾	毛巾
钱包	錢包
春节	春節
麻生太郎	麻生太郎
无产阶级	无产阶级
弥撒	弥撒
Naomi Watts	妮奥米·瓦兹
座头鲸	座头鲸
冈山县	岡山縣
赌场	賭場
撒旦教	撒旦教
彰化县	彰化縣
农历	農曆
克罗地亚国家足球队	克羅地亞國家足球隊
巴尔喀什湖	巴尔喀什湖
丹尼·波尔	丹尼·鮑伊
泰国旗	泰国国旗
希腊国家足球队	希臘國家足球隊
峨眉山	峨眉山
Zip	ZIP格式
冰壶	冰壺
巴拉同 斯里恰乓	帕拉东·斯里查潘
台风	颱風
台南市	臺南市
太湖	太湖
研究生	研究生
加蒂诺市 (魁北克)	加蒂諾
针	針
加合拉·孛何妮	卡拉·布鲁尼
北仑区	北仑区
欧楂	歐楂
袁枚	袁枚
卡哟儿	卡約兒·德烏根
魔幻现实主义	魔幻現實主義
潘玉良	潘玉良
勒	马辔
义和团	义和团运动
李芙妮	齐皮·利夫尼
列宁搿拉德围城搭仔保卫战	列寧格勒圍城戰
1988年欧洲足球冠军赛	1988年欧洲足球锦标赛
皇家夜总会 (电影)	007大战皇家赌场
薯条	馬鈴薯條
吉赛尔·邦臣	吉赛尔·邦辰
塔塔拿挪	塔塔纳努
特强气旋风暴纳尔吉斯	特强气旋风暴纳尔吉斯
2008年希腊街头骚乱	2008年希腊骚乱
半岛战争	半岛战争
日本杯	日本盃
利奧波德咖啡馆	利奧波德咖啡館
丽水县	麗水縣 (越南)
锅	锅
Bipasha Basu	比帕莎·巴蘇
纳吉丝	納吉絲 (印度演員)
英国电视电影艺术学院奖	英国电影和电视艺术学院
毛纳洛火山	冒纳罗亚火山
荷兰东印度公司	荷兰东印度公司
富牌国际机场	富牌國際機場
铁路轨道	鐵路軌道
斷背山	斷背山
雀巢公司	雀巢
环球小姐	环球小姐
ADSL	ADSL
1992年欧洲足球冠军赛	1992年欧洲足球锦标赛
奥斯区亚国家足球队	奧地利國家足球隊
伦敦德里城	德里 (北愛爾蘭)
新干线	新幹線
达新	達新·欽那瓦
Olga Kurylenko	歐嘉·柯瑞蘭寇
瑞士国家足球队	瑞士國家足球隊
莲姜国际机场	莲姜国际机场
金泳三	金泳三
星海爭霸	星际争霸
波兰国家足球队	波蘭國家足球隊
瑞穗银行	瑞穗金融集團
姑蘇區	姑苏区
祖父母	祖父母
环球影视城	环球影业
罗马尼亚国家足球队	羅馬尼亞國家足球隊
唐宁街10号	唐寧街10號
小仲马	小仲马
芹苴机场	芹苴國際機場
罗杰·科恩伯格	罗杰·科恩伯格
2008年末─2009年初加沙地带大规模军事行动	加沙戰爭
利息	利息
直接民主制	直接民主制
橡胶擦子	橡皮擦
幽老猫	捉迷藏
ت	Taw
萨丽	莎丽
1960年欧洲足球国家杯	1960年歐洲國家盃
几何原本	几何原本
خ	خ
数码信号处理	数字信号处理
解热镇痛药	镇痛药
木版画	木刻版畫
世界小姐	世界小姐
长沙市	长沙市
阿披实	阿披实·威差奇瓦
越南国家航空公司	越南國家航空
伦敦政治经济学院	倫敦政治經濟學院
油画	油画
达乃 乌同秋克	达赖·午东措克
Portal:历史	Portal:历史
泥石流	泥石流
洲际弹道飞弹	洲際彈道飛彈
物流	物流
遗传转录	转录
繁体字	繁体中文
宦官	宦官
虱误	程序错误
阿歷克山德拉·柯倫泰	亚历山德拉·米哈伊洛芙娜·柯伦泰
George F. Smoot	乔治·斯穆特
Ϸ	Ϸ
锡克金庙	哈曼迪爾寺
酋长航空公司	阿联酋航空
1996年欧洲足球冠军赛	1996年欧洲足球锦标赛
消费者物价指数	消費者物價指數
国际足球联合会世界排名表	國際足總世界排名
卡本塔里亚湾	卡奔塔利亞灣
超级市场	超級市場
章子怡	章子怡
Heineken	喜力
威尔士国家足球队	威爾斯足球代表隊
千分比	千分比
高雄市	高雄市
病人	患者
基拉尼湖	基拉尼湖
1980年欧洲足球冠军赛	1980年欧洲足球锦标赛
1968年欧洲足球冠军赛	1968年欧洲足球锦标赛
1964年欧洲足球国家杯	1964年歐洲國家盃
印第安纳琼斯 —— 水晶骷髅王国	印地安納瓊斯：水晶骷髏王國
1972年欧洲足球冠军赛	1972年欧洲足球锦标赛
Bayes定理	贝叶斯定理
美人魚	人魚
普吉府	普吉府
1984年欧洲足球冠军赛	1984年欧洲足球锦标赛
亚历山大	亞歷山德里亞
昆明	昆明市
老呒所依	險路勿近
东京铁塔	东京铁塔
兰州市	兰州市
佛來崮	勒皮
头趟公开募股	首次公开募股
羅迪尼亞	羅迪尼亞大陸
欧里维娅	奧莉維亞·紐頓-約翰
Knol	Knol
Ͱ	Ͱ
法国航空447号班机	法國航空447號班機空難
共享软件	共享軟體
简化字	简化字
Mike Myers	麥克·邁爾斯
文雅信使	文雅信使
薄拉特 (电影)	波拉特 (电影)
張勉	张勉
耳機	耳機
利库德党	利库德党
洛阳	洛阳市
淞河	索恩河
白鳍豚	白鱀豚
1976年欧洲足球冠军赛	1976年欧洲足球锦标赛
平昌郡	平昌郡
藤球	藤球
亚洲开发银行	亞洲開發銀行
奖学金	獎學金
矮马	果下馬
匈奴编年史	匈奴
孟子	孟子
帝国理工	伦敦帝国学院
曾国藩	曾国藩
卫生	公共卫生
桂林	桂林市
雪兰莪州	雪蘭莪
海口市	海口市
海拔	海拔
挪威广播公司	挪威廣播公司
中原地区	中原
第一趟鸦片战争	第一次鸦片战争
声调	聲調
基督山伯爵	基度山恩仇記
玛丽女王2号	瑪麗皇后二號
法国总统	法国总统
尹潽善	尹潽善
伊顿公学	伊顿公学
越盾	越南盾
解剖学治疗学及化学分类系统	解剖学治疗学及化学分类系统
尹致昊	尹致昊
终结者3	终结者3：机器的崛起
北卡罗莱纳大学教堂山分校	北卡罗来纳大学教堂山分校
我有一只梦	我有一个梦想
上海世博会	中國2010年上海世界博覽會
梦工厂	梦工厂
谢列梅捷沃国际机场	谢列梅捷沃国际机场
麵	面条
瑞联银行	瑞银集团
观世音	觀世音菩薩
新曼谷国际机场	素万那普机场
闸北区	闸北区
张爱玲	張愛玲
章太炎	章太炎
张道陵	张道陵
张居正	張居正
张家港	张家港市
浙江大学	浙江大学
郑洁	郑洁
正阳门	正阳门
镇海区	镇海区 (宁波市)
月饼	月饼
周迅	周迅
朱家角	朱家角镇
诸暨	诸暨市
株洲市	株洲市
澎湖县	澎湖縣
壯學	壮学
中国人民解放军	中国人民解放军
辛格·旺楚克 (不丹国王)	吉格梅·辛格·旺楚克
利尿药	利尿劑
毕升	毕昇
华南虎	华南虎
巴黎大区高速铁路C线	大区快铁C线
精神疾病诊断搭仔统计手冊	精神疾病診斷與統計手冊
米尔克 (电影)	米尔克 (电影)
高棉帝国	高棉帝国
狙击手	狙擊手
鼻衄	流鼻血
开脱•文斯莱脱	凱特·溫斯蕾
富国机场	富國機場
李商隐	李商隐
曹操	曹操
火山湖	火山口湖
水粉画	水粉画
拨人忽视个真相	难以忽视的真相
Isaac Hayes	艾萨克·海耶斯
春武里府	春武里府
武夷山	武夷山脉
塔麻可吉电子小鸡	他媽哥池
泰王国国歌	泰國國歌
二氧化氮	二氧化氮
冬至	冬至
风月俏佳人	麻雀變鳳凰
新台币	新臺幣
混成词	混成詞
法国省份一览表	行省 (法国)
BOINC	BOINC
袁世凯	袁世凯
袋鼠岛	坎加鲁岛
泰拉 蕾	泰拉·蕾
氯化氢	氯化氢
刘翔	刘翔
蒙古人民共和国	蒙古人民共和国
DTD	文件类型描述
开脱•末斯	姬·摩絲
娜塔莎·李察遜	娜塔莎·李察遜
三聚氰胺	三聚氰胺
高隆皮亚国家足球队	哥倫比亞國家足球隊
莫尼卡-莱温斯基	莫尼卡·莱文斯基
雷曼兄弟公司	雷曼兄弟
大使馆	外交代表機構
喫	進食
金奎植	金奎植
IPod Shuffle	IPod shuffle
泼水节	泼水节
7-Zip	7-Zip
洋油盏	煤油燈
南沙群岛	南沙群岛
湘潭市	湘潭市
费加罗报 (法国)	费加罗报
汽车旅馆	汽車旅館
垃圾桶	垃圾桶
金刚 (电影)	金剛 (怪獸)
泻药	泻药
海龜	海龟
老鼠会	龐茲騙局
赌城风云 (电影)	賭城風雲 (1995年電影)
化学品登记、评估、准许搭限制法规	关于化学品注册、评估、许可和限制法案
学科	學科列表
性用品商店	成人用品店
ISO/IEC 8859	ISO/IEC 8859
关公	关羽
龟	龜
东方明珠	东方明珠广播电视塔
国际足联世界冠军俱乐部杯赛	國際足協世界冠軍球會盃
卢旺达旅馆	卢旺达饭店
苹果 (消歧义)	苹果 (消歧义)
非洲国家列表	非洲国家和地区列表
Isla Fisher	艾絲拉·費雪
石泰凡妮 莱斯	史蒂芬妮·賴斯
印度空间研究组织	印度空间研究组织
臺灣 (消歧義)	臺灣 (消歧義)
酱油	酱油
新山	新山
MT	MT
国富论	國富論
清迈府	清邁府
蔡英文	蔡英文
宋卡府	宋卡府
平年	平年
玫瑰人生 (2007年电影)	玫瑰人生 (電影)
沙吞府	沙敦府
泰文字母表	泰文字
清莱府	清萊府
拉廊府	拉廊府
披集府	披集府
We Are the Champions	我们是冠军
九龙	九龍
末尔悬岩	莫赫悬崖
IT狂人	IT狂人
北榄坡府	北攬坡府
碧差汶府	碧差汶府
普吉国际机场	布吉國際機場
抗心律失常药	抗心律失常药
陈艳青	陈艳青
2008年欧洲足球冠军赛	2008年欧洲足球锦标赛
五代十国	五代十国
森理世	森理世
QED	QED
索马里内战	索马里内战
沙马	沙马·顺达卫
金砖国家	金砖国家
安纳乍能府	安納乍能府
董里府	董里府
博他仑府	博他侖府
纳戈尔诺-卡拉巴赫	纳戈尔诺-卡拉巴赫共和国
血色将至	黑金企業
乌泰他尼府	烏泰他尼府
新北市	新北市
臺中市	臺中市
真爱个火焰 (印度电影)	胭脂淚
中国地铁	中国城市轨道交通系统
堂前	祠
和谐社会	和谐社会
口令伍德澳式足球队	哥寧伍澳式足球會
新竹市	新竹市
王力宏	王力宏
轰炸机澳洲式足球队	阿辛頓澳式足球會
鹅	鹅
年号	年号
高丽航空	高麗航空
环球银行金融电信协会	环球银行金融电信协会
Motorola	摩托罗拉
赛义巴巴	舍地·賽·巴巴
欧洲足球冠军赛	欧洲足球锦标赛
汽水	碳酸水
天狼星号油轮	天狼星号油轮
三沙市	三沙市
保合多伽勒国家足球队	葡萄牙國家足球隊
车路	公路
苏梅岛	苏梅岛
爱尔兰镑	愛爾蘭鎊
陈冯富珍	陳馮富珍
中岛美嘉	中島美嘉
安娜 米亚里斯	安娜·米雷斯
Prapawadee Jaroenrattanatarakoon	巴帕瓦迪·乍伦拉达那达拉恭
邓亚萍	邓亚萍
里斯班斯 齐凯脱	莉比·特里克特
西跋榭滴	希爾柏·謝迪
Melissa Etheridge	梅莉莎·埃瑟里奇
陈冲	陈冲 (演员)
林心如	林心如
陈若琳 (运动员)	陈若琳
Jennifer Hawkins	珍妮弗·霍金斯
张柏芝	張栢芝
挪威公主阿斯特丽德	阿斯特丽公主
莱索尔 强斯	莱塞尔·琼斯
汤唯	汤唯
陈慧琳	陳慧琳
诗丽黛玮	詩麗黛瑋·阿雅潘
郭晶晶	郭晶晶
陈燮霞	陈燮霞
头孢菌素	頭孢菌素
沙没巴干府	北欖府
呵叻府	呵叻府
藏羚羊	藏羚羊
浮罗交怡	浮罗交怡
攀牙府	攀牙府
馅饼统计图	饼图
抗酸剂	抗酸药
早稻田大学	早稻田大学
吴 (三国)	孫吳
氯霉素	氯霉素
猜也贲府	猜也奔府
泰华农民银行	開泰銀行
英特尔砂桥	Sandy Bridge微架構
马肖·米切姆	马修·米查姆
耶莲娜	耶莱娜·多基奇
重组DNA	重組DNA
海宁市	海宁市
硫酸镁	硫酸镁
拉喇·杜打	拉腊·杜塔
汽车租赁	汽車租賃
澳大利亚搭新西兰军团纪念日	澳新军团日
ANZ大球场	澳大利亞體育場
杨玉环	杨贵妃
素拉育	素拉育·朱拉暖
颂猜·旺沙瓦	颂猜·旺沙瓦
地帕·漫它	迪帕·梅赫塔
拍凤裕庭 (泰国将军)	披耶帕凤·丰派育哈色纳
奥特莱•导都	奧黛莉·朵杜
Β－内酰胺类抗生素	Β-内酰胺类抗生素
APM	Apm (香港)
金城武	金城武
周星驰	周星馳
多尼尔228	多尼爾228
孙权	孙权
蒋经国	蔣經國
墨尔本胜利	墨尔本胜利足球俱乐部
纳维语	納美語
神舟七号飞船	神舟七号
鬼勒耳朵边头讲	靈感應
Grant George Hackett	格兰特·哈克特
松浦晃一郎	松浦晃一郎
茄特 艾勒麦勒	蓋得·艾馬勒
韩愈	韩愈
梁朝伟	梁朝偉
丁俊晖	丁俊晖
澳大利亚总理	澳大利亞總理
王安石	王安石
投资银行	投资银行
徐載弼	徐載弼
阿宾拿夫 宾德拉	阿比纳夫·宾德拉
窃听器	窃听器
巴真府	巴真府
精工表	精工
杭州灣大橋	杭州湾跨海大桥
武里喃府	武里南府
坤敬府	坤敬府
德国无线通信	T-Mobile
廊开府	廊開府
基斯孔哈拉斯	基什孔豪洛什
日本中央银行	日本银行
李自成	李自成
哈桑式火箭弹	卡桑火箭
林语堂	林语堂
朴憲永	朴宪永
金枓捧	金枓奉
龙仔厝府	龍仔厝府
信武里府	信武里府
包拯	包拯
大雪	大雪
武昌起义	武昌起义
同心隆安足球俱乐部	隆安同心足球俱樂部
Ad-hoc On-demand Distance Vector	AODV
教堂山	教堂山
VOC	VOC
阿德来德联队	阿德莱德联足球俱乐部
芜湖市	芜湖市
安庆市	安庆市
亳州市	亳州市
上饶	上饶市
冯玉祥	冯玉祥
佛历	佛曆
银河处女	維珍銀河
2007年加沙地带争夺战	加沙之戰 (2007年)
新兴工业国家	新興工業化國家
崇明岛	崇明岛
李鸿章	李鴻章
中秋节	中秋节
元均	元均 (朝鲜)
浅野忠信	淺野忠信
炳·廷素拉暖	炳·廷素拉暖
陈冠希	陳冠希
以蒙 苏里房	埃蒙·沙利文
雷锋	雷锋
梁启超	梁启超
多尔衮	多爾袞
素可泰府	素可泰府
彭德怀	彭德怀
依善	依善地区
紫峰大厦	紫峰大厦
姚文元	姚文元
海上花 (电影)	海上花 (1998年电影)
宁国	宁国市
应召女郎个秘密日记	应召女郎的秘密日记
斯瓦特县	斯瓦特县
悉尼晨锋报	雪梨晨鋒報
The quick brown fox jumps over the lazy dog	The quick brown fox jumps over the lazy dog
TCL	TCL
静安寺	静安寺
金牌	金牌
亚洲航空	亞洲航空
台南	臺南
白鹿洞书院	白鹿洞书院
秋叶原	秋葉原
徐光启	徐光启
林可酰胺类抗生素	林可酰胺类抗生素
强心苷	强心苷
SDS	十二烷基硫酸钠
四环素类抗生素	四环素类抗生素
大环内酯类抗生素	大環內酯
恒生指数	恒生指數
喹诺酮	喹诺酮
维基百科编辑手册	维基百科编辑手册
靖江	靖江市
通州	通州
新苏格兰银行	加拿大豐業銀行
Моа	恐鳥
掸邦	掸邦
1976年河北唐山大地震	唐山大地震
上海地铁	上海地铁
以色列空军	以色列空军
玩转身前事	一路玩到掛
秋瑾	秋瑾
崇礼门	崇禮門
保琳汉生	寶琳·韓森
伍丽群	伍丽群
許貞淑	許貞淑
嫦娥	嫦娥
孛里盎妮 高尔	布里奥妮·科尔
羅蕙錫	羅蕙錫
钟欣桐	鍾欣潼
吴三桂	吴三桂
孙休	孫休
許政	许政
孙皓	孙皓
孙亮	孫亮
韩寒	韩寒
滑水	滑水
泰国人	泰国人
亚罗士打	亚罗士打
挽腊茫郡	挽腊茫郡
湄赛边关	美塞
國際馬術聯合會	國際馬術總會
世界佛教徒聯誼會	世界佛教徒聯誼會
新山一国际机场	新山一國際機場
宏碁电脑	宏碁
运动场	體育場
朝鲜半岛	朝鲜半岛
圣保罗地铁	圣保罗地铁
亚运会	亚洲运动会
捷克国家足球队	捷克國家足球隊
朝鲜族	朝鲜族
吕克·贝松	吕克·贝松
俞吉濬	兪吉濬
丁岩礁	丁岩礁
Tesco	乐购
萨尔浒之战	薩爾滸之戰
傲游浏览器	傲游浏览器
供应链管理	供应链管理
金庾信	金庾信
金明淳	金明淳
李爱情	李愛情
长今之梦	大長今 (動畫)
武烈王	武烈王
文武王	文武王 (新羅)
朴仁德	朴仁德
金来沅	金来沅
复旦大学	复旦大学
仁川地铁	仁川都市鐵道
李光洙	李光洙
朴重陽	朴重陽
六方会谈	六方会谈
超级跑跑	HiYo衝天跑
金润玉	金潤玉
奶粉	奶粉
班地戈 (维克多利亚)	本迪戈
朝鲜核问题	朝鲜的大规模杀伤性武器
韩国放送公社	韓國放送公社
莎阿南	莎阿南
玉山	玉山
雜合子	異型合子
泰文数字	泰文数字
西湖	西湖
澳大利亚日	澳大利亞日
大屿山	大嶼山
60秒惊天动地	驚天動地60秒
伊斯兰祈愿团	回教祈禱團
冈片山	格蘭坪國家公園
中庸	中庸
饭	米飯
德文语法	德语语法
温岭	温岭市
上海交通大學	上海交通大学
输入法	输入法
托忒蒙古文	托忒蒙古文
卡卡	卡卡
南印度	印度南部
2009年枪击斯里兰卡板球队事件	斯里兰卡板球队遇袭事件
许冠杰	許冠傑
柏林宣言	柏林宣言
安吉	安吉县
视力	視力
星期四岛	星期四岛
陈英雄	陳英雄
徐志摩	徐志摩
趙元任	赵元任
蒙古简介	蒙古高原
沈约	沈约
我个小新娘子	幼齒老婆
巴彦淖尔	巴彦淖尔市
稷下學宮	稷下學宮
抗糖尿病药	抗糖尿病药
抗高血压药	抗高血压药
抗真菌药	抗真菌药
岳庙	杭州岳王庙
南京路	南京路 (上海)
意大利杂菜汤	意大利雜菜湯
算筹	算筹
花岗岩岛 (澳大利亚)	花岗岩岛 (澳大利亚)
海峡两岸关系	海峽兩岸關係
萧山	萧山区
琅琴表	浪琴錶
醴陵市	醴陵市
奠边府战役	奠邊府戰役
帕克斯 (新南威尔士州)	帕克斯 (新南威尔士州)
窝同搿 (维克多利亚)	沃东加
如东	如东县
正大集团	正大集团
List of Thailand cities	泰国城市列表
甲米机场	甲米機場
西非国家中央银行	西非国家中央银行
依夫城堡	伊夫堡
皮蛋	皮蛋
庐山	庐山
首尔地下铁	首尔地下铁
必和必拓矿业公司	必和必拓
西海大桥	西海大桥
零假设	零假设
电脑语言	计算机语言
世纪报	世纪报
霍元甲 (电影)	霍元甲 (2006年電影)
布鲁塞尔皇宫	布魯塞爾王宮
饺子	饺子
乃米湖	内米湖
原子彈	原子弹
黄浦区	黄浦区
长宁区	长宁区
广州地铁	广州地铁
静安区	静安区
普陀區	普陀区
普陀区 (上海)	普陀区 (上海市)
虹口区	虹口区
杨浦区	杨浦区
闵行区	闵行区
宝山区 (上海)	宝山区 (上海市)
嘉定区	嘉定区
金山区 (上海市)	金山区 (上海市)
松江区	松江区
青浦区	青浦区
奉贤区	奉贤区
性旅游者	性旅遊
卡里平	加勒比地区
教堂山 (北卡罗来纳州)	教堂山 (北卡罗来纳州)
启德机场	啟德機場
昆剧	昆曲
意大利国家足球队	意大利國家足球隊
国际先驱论坛报	國際紐約時報
流亡政府	流亡政府
海门市	海门市
日本色情业	日本色情业
中文数字大写	中文数字
南京大學	南京大学
輔仁大學	輔仁大學
鹰式教练机	鹰式教练机
快门	快門
国产凌凌漆	國產凌凌漆
金刚	金剛
谥号	谥号
吴佩孚	吴佩孚
徐温	徐溫
吴敬梓	吴敬梓
四庫全書	四庫全書
李茂贞	李茂貞
杭州湾	杭州湾
刘心悠	劉心悠
刘濞	劉濞
魏忠贤	魏忠贤
市区	市区
小笼馒头	小籠包
张士诚	張士誠
叶永烈	叶永烈
网球王子	网球王子
段祺瑞	段祺瑞
中国医药大学	中國醫藥大學
中法战争	中法战争
梁咏琪	梁詠琪
台湾高速铁路	台灣高速鐵路
Twins	Twins
庙号	庙号
张岱	張岱 (明朝)
刘嘉玲	劉嘉玲
潘迪华	潘迪華
言承旭	言承旭
李未	李未
台湾问题	台灣問題
香港惠康超级市场	惠康
汤恩伯	湯恩伯
清云科技大学	健行科技大學
东京爱情故事	東京愛情故事
张謇	张謇
钱穆	錢穆
王晶	王晶 (導演)
林妙可	林妙可
罗慧娟	羅慧娟
李定国	李定国
许雅涵	許雅涵
王定宇	王定宇
陈仪	陳儀
溫州話	温州话
启东	启东市
奉化市	奉化市
西德	西德
油条	油条
蔡卓妍	蔡卓妍
陈良宇	陈良宇
亚洲国家列表	亚洲国家和地区列表
春卷	春卷
袁崇焕	袁崇焕
张献忠	张献忠
还珠格格	還珠格格
金塘岛	金塘岛
李金华	李金华 (审计长)
春晓气油田	春晓油气田
卫诗	衛詩
王菀之	王菀之
杨采妮	楊采妮
台湾土地银行	臺灣土地銀行
林世荣	林世榮
徐熙娣	徐熙娣
台湾个银行一览表	臺灣銀行列表
林明达	林明達
澎湖跨海大桥	澎湖跨海大橋
贡丸	貢丸
沼蛙	沼蛙
郑欣宜	鄭欣宜
林凤娇	林鳳嬌
攀牙湾	攀牙灣
品冠	品冠
陈叔宝	陈后主
陈霸先	陈霸先
中华大学	中華大學
色，戒	色，戒 (電影)
鲸体爆炸事件	鯨魚爆炸
中子彈	中子弹
澳大利亚电信公司	Telstra
金坛	金坛市
上海申花足球俱乐部	上海绿地申花足球俱乐部
俄罗斯国家足球队	俄羅斯國家足球隊
计程车(1998年电影)	的士速递
XUL	XUL
蓝天处女	維珍澳洲航空
現代標準漢語	現代標準漢語
金边粉	金邊粉
薛福成	薛福成
圆仁	圆仁
中国国家图书馆	中国国家图书馆
墨尔本机场。	墨爾本機場
TCL集团	TCL集团
西昌卫星发射中心	西昌卫星发射中心
镇	行政建制镇
2008年欧洲足球冠军赛资格赛C组	2008年歐洲國家盃外圍賽 (C組)
鲁国	鲁国
捧景配启 (拳手)	蓬金鐵
神户机场	神戶機場
巴黎大区高速铁路A线	大区快铁A线
泰国人妖	泰國變性女性
丢勒个犀牛	丟勒的犀牛
泰国北部	泰國北部地區
凯山丰威汉市	凯山丰威汉市
高分子化学	高分子化学
苏州码子	苏州码子
文子	文子 (书籍)
克里米亚共和国	克里米亚自治共和国
ISO/IEC 646	ISO/IEC 646
捷星航空	捷星航空
暖武里市	暖武里
素叻国际机场	素叻国际机场
亭曼岛	刁曼岛
岘港国际机场	峴港國際機場
百越	百越
西塘镇	西塘镇 (嘉善县)
Jászszentlászló	亚斯森特拉斯洛
舟山跨海大桥	甬舟高速公路
崇明县	崇明县
国王岛	金岛
宋卡市	宋卡
巴卡西半岛	巴卡西半島
盘谷银行	盤谷銀行
马来西亚国家银行	马来西亚国家银行
爱尔兰银行	爱尔兰银行
泰国国家银行	泰国银行
应召女郎	應召女郎
北塘区	北塘区
赤壁(2008年电影)	赤壁 (电影)
黑人	黑人
五公祠	五公祠
普腾汽车	寶騰
码头	碼頭
购物	購物
省会	省会
苏州言话	苏州话
热干面	热干面
金磚四國	金砖四国
富通银行	富通集團
崇祯	崇祯
秦淮河	秦淮河
南极星中文文书处理系统	南极星软件公司
越王勾践剑	越王勾践剑
远古侵略	史前逃龍
白云山 (广州)	白云山 (广州)
国防科学技术工业委员会	中华人民共和国国防科学技术工业委员会
宰予	宰予
韶山市	韶山市
Schweppes	玉泉汽水
傣族	傣族
东突厥斯坦	东突厥斯坦
香港邮政总局	香港郵政總局
上海中学	上海市上海中学
坚尼地道	堅尼地道
通假字	通假字
欧冶子	欧冶子
內排国际机场	內排國際機場
普吉市	普吉市
F-15雷暴式战斗机	F-15E打擊鷹式戰鬥轟炸機
抗病毒药	抗病毒药物
史弥远	史彌遠
國際語音學學會	国际语音学学会
闽东语维基百科	Wikipedia:閩東語維基百科
维基百科孵化器	Wikipedia:維基孵育場
火锅	火鍋
银牌	银牌
干将莫邪	干將莫邪
阿嘞白拿湖	阿尔巴诺湖
午马	午馬
冠军	冠軍
印度行政区人口列表	印度行政区人口列表
性工作者	性工作者
越捷航空	越捷航空
巴乃到乃	意大利麵包
拉玛九世	普密蓬·阿杜德
外国口音综合症	外国口音综合症
卡嘞吞澳式足球俱乐部	卡爾頓澳式足球會
流浪者 (印度电影)	流浪者 (印度電影)
嫦娥工程	中国探月工程
日落大道	日落大道
科索沃宣布独立事件（2008年）	科索沃宣佈獨立事件
东南亚国家杯足球比赛	東盟足球錦標賽
公主	Princess
薄扶林道	薄扶林道
漆咸道	漆咸道
年宵	年宵市場
毕打街	畢打街
摩士公园	摩士公園
大坑道	大坑道
四面佛	四面佛
最爱女人购物狂	最愛女人購物狂
滨湖区	滨湖区
苏丹航空公司	苏丹航空
南翔镇	南翔镇
石头城	石头城
苏梅国际机场	蘇梅國際機場
那空沙旺府教区	天主教那空沙旺教區
阴蒂	陰蒂
三清山	三清山
铜牌	铜牌
胡志明纪念堂	胡志明纪念堂
喃字	喃字
性奴隶	性奴隸
天主教上海教区	天主教上海教区
坤敬市	孔敬
粥	粥
巴亭郡	巴亭郡
2006年印度孟买火车大爆炸	2006年孟買火車連環爆炸案
钱元瓘	錢元瓘
孛拉先拿湖	布拉恰诺湖
统万城	统万城
金瓯机场	金甌機場
十国春秋	十国春秋
Debian自由软件指导方针	Debian自由软件指导方针
文艺春秋 (出版社)	文藝春秋
叶麂	叶麂
外蒙古	外蒙古
天目山	天目山
挥发性有机化合物	挥发性有机物
2009年以色列国会大选	2009年以色列议会选举
动力大厦 (迪拜)	動感摩天樓 (杜拜)
吴国	吴国
合艾国际机场	合艾国际机场
南美洲国家列表	南美洲国家和地区列表
苏州地铁	苏州轨道交通
帮助:目录	Help:目录
Wikipedia:Tutorial	Wikipedia:新手入門/參與
龙虎山	龙虎山
澎湖列岛	澎湖群島
中国画	中国画
申報	申报
奶茶	奶茶
盖代拉	盖代拉
龙游县	龙游县
澳大利亚国家气象局	澳洲氣象局
支气管扩张剂	支气管扩张药
京津城际铁路	京津城际铁路
琼语	海南话
哥打丁宜	哥打丁宜縣
莱 (泰国)	莱 (泰国)
周曙光	周曙光
弗林德斯岛 (塔斯曼尼亚)	弗林德斯岛
吴中区	吴中区
印度储备银行	印度储备银行
2007年友谊快线大爆炸	2007年友誼快線爆炸案
泰国王家军队	泰国皇家军队
河姆渡文化	河姆渡文化
曼谷大桥	曼谷大橋
阿根廷，勿要为奴哭泣	阿根廷，别为我哭泣
福布斯	福布斯
马拉浦南	马拉普兰
塔斯马尼亚州立大学	塔斯馬尼亞大學
泰京银行 (泰国)	泰京銀行
星野亚希	星野亞希
解放日	解放日
清莱国际机场	清莱国际机场
上海迪斯尼	上海迪士尼度假區
德天瀑布	板约瀑布
石龙军路	石龍軍路
翁同龢	翁同龢
上海道	苏松太道
寿臣山	壽臣山
街道办事处	街道办事处
相城区	相城区
破坏之王 (电影)	破壞之王
钱乃荣	錢乃榮
港岛线	港島綫
宁波地铁	宁波轨道交通
草原	草原
金球奖	金球獎
Wikipedia:WikiProject Spoken Wikipedia	Wikipedia:有聲維基百科專題
比拉伊	皮拉伊
宜兴市	宜兴市
维克多港	维克多港
常熟	常熟市
江阴	江阴市
卢湾区	卢湾区
乍都节区	乍都节县
一个人的奥林匹克	一個人的奧林匹克
许怀欣	許懷欣
佩蒂翁维尔学校倒塌事故	佩蒂翁维尔学校倒塌事故
桓伊	桓伊
崇启大桥	崇启大桥
常州言话	常州话
Gaysorn Plaza	姬紗芭莎
琼山	琼山区
廷素拉暖大桥	廷素拉暖大桥
天长	天长市
如皋市	如皋市
江山市	江山市
浏阳市	浏阳市
海曙区	海曙区
同里镇	同里镇
新昌	新昌县
吴兴区	吴兴区
新都区	新都区
阿拉善右旗	阿拉善右旗
蛟	蛟
年夜饭	年夜飯
仓颉码	倉頡輸入法
香港航空	香港航空
钱俶	钱俶
龙虾	海螯蝦
豪格	豪格
子贡	子贡
奇摩国际学校	澳洲楷模国际中学
苏州新区	苏州高新技术产业开发区
龚自珍	龚自珍
橋玄	橋玄
中毒债务	垃圾債券
苏州地铁2号线	苏州轨道交通2号线
常山县	常山县
后金	后金
大报恩寺（南京）	大报恩寺 (南京)
南京中国近代史遗址博物馆	南京中国近代史遗址博物馆
宋国	宋国
清迈国际机场	清邁國際機場
泰鸟航空公司	飛鳥航空
O'Reilly Media	歐萊禮
后羿	羿 (唐堯)
颂圣歌	頌聖歌
泰国民族党	泰國國民黨
2008年欧洲足球冠军赛资格赛A组	2008年歐洲國家盃外圍賽 (A組)
2008年欧洲足球冠军赛资格赛E组	2008年歐洲國家盃外圍賽 (E組)
龙井茶	龙井茶
泰国南部	泰国南部地区
灵隐寺	灵隐寺
清迈大学	清邁大學
越南南方共和国	南越南共和國
西汉	西汉
中国国家博物馆	中国国家博物馆
东林党	东林党
钱镠	钱镠
崇安区	崇安区
崇川区	崇川区
Club Méd	地中海會
拙政园	拙政园
入唐求法巡礼行记	入唐求法巡礼行记
河西省	河西省
2008年欧洲足球冠军赛资格赛B组	2008年歐洲國家盃外圍賽 (B組)
崇德	崇德
AV女优	AV女優
手写体	手写体
宋慧教	宋慧喬
海南岛	海南岛
烂泥模模	惠山泥人
人民民主联盟 (泰国)	人民民主聯盟
武汉大学	武汉大学
吴语维基百科	Wikipedia:吳語維基百科
开饭喇 (杂志)	開飯喇
希淡山	黑木山
熊田曜子	熊田曜子
圣地尼尔中学	圣地尼尔中学
黃大仙祠 (香港)	黃大仙祠 (香港)
韓國 (消歧義)	韩国 (消歧义)
迪拜大商场	杜拜購物中心
婚礼歌手	婚禮歌手
文蛤	文蛤
异食癖	异食癖
本田爵士 (汽车)	本田飞度
盛宣怀	盛宣怀
天聪	天聪
越国	越國
桓玄	桓玄
为泰党 (泰国)	为泰党
香港人	香港人
吕良伟	呂良偉
巩金瓯	鞏金甌
澳大利亚邮政局	澳大利亞郵政
大中华地区	大中華地區
科廷科技大学	科廷大學
中华人民共和国国庆节	中华人民共和国国庆节
天台山 (浙江)	天台山 (浙江)
南宋	南宋
子思	孔伋
2008年欧洲足球冠军赛资格赛G组	2008年歐洲國家盃外圍賽 (G組)
2008年欧洲足球冠军赛资格赛F组	2008年歐洲國家盃外圍賽 (F組)
2008年欧洲足球冠军赛资格赛D组	2008年歐洲國家盃外圍賽 (D組)
孛相	玩耍
佛统大塔寺	佛统大塔
1931年个江淮大水	1931年江淮大水
陕西历史博物馆	陕西历史博物馆
还剑湖	还剑湖
愛科蘭舞	光之美少女
泾县	泾县
惠山区	惠山区
阿含经	阿含經
西施	西施
岱山县	岱山县
当涂县	当涂县
侬	你
蒙古	蒙古
法国人口	法國人口
言話	話
梅林	梅林传奇
泰国民主党	民主黨 (泰國)
西湖 (河内)	西湖 (河内)
周海媚	周海媚
粤文维基百科	粵文維基百科
白露	白露
东亚运动会	東亞運動會
吴越国	吴越国
爱田由	愛田由
越剧	越剧
荃湾线	荃灣綫
长江三角洲	长江三角洲
杭州萧山国际机场	杭州萧山国际机场
繁昌县	繁昌县
射雕英雄传	射鵰英雄傳
全椒县	全椒县
郎溪	郎溪县
广德	广德县
南明	南明
无为县	无为县
饭岛爱	飯島愛
良渚文化	良渚文化
湘乡市	湘乡市
金山区	金山区
泰国国立法政大学	泰國國立法政大學
定海区	定海区
机场	機場
世界大桥长度排名	世界大桥列表
男妓	男妓
南汇区	南汇区
千字文	千字文
僚	僚 (吴国)
勾践	勾践
伍子胥	伍子胥
夫差	夫差
新西兰护照	新西兰护照
澳大利亚护照	澳大利亚护照
街妓	街头妓女
朱温	朱温
牌九	推牌九
阖闾	阖闾
星	星
墨尔本杯	墨爾本盃
果敢	果敢
办酒窠	过家家
泰叻报	泰國日報
京滨急行电铁	京濱急行電鐵
泰国人民反独裁民主联盟	反獨裁民主聯盟
寶貝計劃	宝贝计划
乔石	乔石
井冈山	井冈山
汉服	汉服
南潯區	南浔区
南湖区	南湖区
嵊泗縣	嵊泗县
衢江区	衢江区
衡山县	衡山县
中山陵	中山陵
Nowra (新南威尔士)	諾拉 (新南威爾斯州)
我个父亲甘地	我的父親甘地
平江区	平江区
澳大利亚偶像唱歌比赛	澳洲偶像
金阊区	金阊区
上海大学	上海大学
通州市	通州区 (南通市)
彭世洛机场	彭世洛機場
港闸区	港闸区
素坤逸路21巷 (曼谷)	牛仔街
巴黎大区高速铁路B线	大區快鐵B線
罗皇节	藏历新年
富劳里友半岛	弗勒里厄半岛
马来亚银行	馬來亞銀行
江南	江南
开县	开县
扬中市	扬中市
锡山区	锡山区
乌镇	乌镇镇
松岭区	松岭区
开化县	开化县
吴江区	吴江区
西密朗群岛	西密兰群岛
海安县	海安县
玉环县	玉环县
乌达抛飞机场 (泰国)	乌塔保国际机场
柯城区	柯城区
路桥	路桥区
南长区	南长区
陈育嬬	陳冠希裸照事件
钟嘉欣	鍾嘉欣
宁乡县	宁乡县
范蠡	范蠡
湘潭县	湘潭县
Wikipedia:维基大典	Wikipedia:文言文維基百科
荣毅仁	荣毅仁
Simon Crean	西蒙·克林
空堤区 (曼谷)	空堤縣
分类:德国	Category:德国
分类:意大利	Category:意大利
分类:美国	Category:美国
分类:俄罗斯	Category:俄罗斯
分类:英国	Category:英国
分类:西班牙	Category:西班牙
分类:中国	Category:中国
分类:日本	Category:日本
分类:澳大利亚	Category:澳大利亚
分类:墨西哥	Category:墨西哥
分类:印度	Category:印度
分类:阿根廷	Category:阿根廷
毛宁吞半岛	莫宁顿半岛
门牌号码	門牌號碼
富国国际机场	富國國際機場
巴黎大区高速铁路D线	大區快鐵D線
吉碑国际机场	吉碑國際機場
水灯节 (东南亚)	水燈節 (東南亞)
苏勒当阿孛杜勒机场	苏丹阿都阿兹沙机场
楠府机场	楠府機場
鸟汶机场	烏汶機場
分类:印度尼西亚	Category:印尼
分类:乃特朗特	Category:荷兰
分类:新加坡	Category:新加坡
分类:韩国	Category:大韓民國
分类:泰国	Category:泰國
分类:越南	Category:越南
分类:哺乳动物	Category:哺乳類
分类:植物	Category:植物
分类:物理	Category:物理学
分类:生物学	Category:生物学
分类:化学	Category:化学
分类:历史	Category:历史
分类:地理	Category:地理
分类:社会	Category:社会
分类:宗教	Category:宗教
分类:体育运动	Category:体育
分类:科学	Category:科学
分类:电影	Category:电影
分类:建筑物	Category:建築物
澳洲人报	澳洲人報
泰国银行	泰国银行列表
拉脱卜大学	拉筹伯大学
维曼默宫	維曼默宮
中国宗教	中国宗教
寄畅园	寄畅园
乡	乡级行政区
西芳寺	西芳寺
素岳寺	素贴寺
姚华乐路	耀華力路
玄妙观	玄妙观 (苏州市)
普吉大佛	普吉大佛
匹嘉声路	碧甲盛路
眼鏡娘	眼鏡娘
韓國 (戰國)	韩国 (战国)
变调	變調
昂船洲大桥	昂船洲大橋
汉堡 (消歧义)	汉堡 (消歧义)
IPCC第4趟评价报告书	政府间气候变化专门委员会第四次评估报告
苏州中学	江苏省苏州中学
苏州大学	苏州大学
华欣	华欣
澳大利亚国家档案库	澳洲國家檔案館
幸福航空	幸福航空
上水	上水
宋卡湖	宋卡湖
制片公司	制片公司
舟山岛	舟山岛
小珊瑚岛 (泰国)	小珊瑚島
涂改液	修正液
七阶魔方	七阶魔方
翁美玲	翁美玲
樟宜	樟宜
Vibhavadi Rangsit Road	威拍哇麗蘭室路
神舟十号	神舟十号
韦伯斯特大字典	韦氏词典
西雾延岛	锡布延岛
越南语音系	越南語音系
囚犯	囚犯
巴士底獄	巴士底狱
泰国足球联赛	泰国足球超级联赛
上海市第一百货商店	上海市第一百货商店
七宝镇	七宝镇
朗娜伐拉	洛纳瓦拉
官恩娜	官恩娜
乍都节公园	乍都節公園
皇汉	大汉族主义
清迈夜市	夜市
定向圖	定向地圖
生肖	生肖
中国人口	中国大陆人口
分类:消歧义	Category:消歧义
分类:佛教	Category:佛教
分类:基督教	Category:基督教
分类:伊斯兰教	Category:伊斯兰教
蓝星行动 (印度)	藍星行動
江孜	江孜镇
萨斯系统	統計分析系統
包恩滴 娜去隆佳诺克	蓬蝶普·娜矶朗嘉诺克
邪恶圣经	邪恶圣经
华东师范大学	华东师范大学
岳麓书院	岳麓书院
泰国商业银行	泰國商業銀行
前童镇	前童镇
拍凤裕庭公路	拍鳳裕庭路
运动员	运动员
表字	表字
澳大利亚人口	澳大利亚人口
Poise	泊 (單位)
香港站	香港站
印度语言及方言	印度语言列表
外白渡桥	外白渡桥
江淮官话	江淮官话
曼谷枪手 1	無聲火
十月围城	十月围城
吴	吴
太平天国忠王府	太平天国忠王府
艾士菲 (新南威尔士州)	艾士菲 (新南威尔士州)
担	石 (质量单位)
汪明荃	汪明荃
廣韻	廣韻
女阴	女陰
越南国家银行	越南國家銀行
巴亭广场	巴亭广场
容祖儿	容祖兒
悉尼天鹅队 (澳式足球)	悉尼天鵝澳式足球會
上山文化	上山遗址
马维力卡拉	马韦利克卡拉
狄娜	狄娜
妙蛙花	妙蛙花
东山飘雨西关晴	東山飄雨西關晴
饭岛真理	飯島真理
无锡言话	无锡话
新挪威语维基百科	新挪威語維基百科
六阶魔方	六阶魔方
2009年年孟加拉国步枪队哗变	孟加拉国步枪队叛乱
东盟宪章	東盟憲章
砂岩大学	砂岩學府
唐宁街11号	唐寧街11號
堤岸 (越南)	堤岸
泰国华人	泰國華人
風雲：雄霸天下 (1998年電影)	風雲：雄霸天下 (1998年電影)
2008年丹麦驻巴基斯坦大使馆爆炸	丹麥駐巴基斯坦大使館爆炸案
紫砂壶	紫砂壺
常州天宁寺	天宁寺 (常州)
2005年安曼炸弹爆炸	2005年安曼爆炸案
谢安琪	謝安琪
玛格达·苏邦斯基	瑪格達·蘇班斯基
梧桐河	梧桐河
正一派	正一道
抗心绞痛药	抗心绞痛药
Comme si de rien n'était (专辑)	好像什么都没发生
文白异读	文白异读
无锡地铁	无锡地铁
非典型性肺炎	非典型肺炎
选美	選美活動
淀山湖	淀山湖
淑女，或是老虎 ?	淑女，還是老虎？
唐宁街12号	唐寧街12號
渐雷兽 (史前动物)	漸雷獸
2005年印度德里炸弹大爆炸	2005年新德里爆炸案
将军澳	將軍澳
柬埔寨商业银行	柬埔寨商業銀行
春晚	中国中央电视台春节联欢晚会
1998年印尼排华大骚乱	黑色五月暴动
奇摩镇	楷模镇
咸蛋	鹹鴨蛋
东涌	東涌 (香港)
大篷车	大篷车
分类:未完个文章	Category:小作品
分类:维基百科分类	Category:維基百科分類
分类:维基百科管理	Category:維基百科管理
分类:文化	Category:文化
分类:大洲	Category:大洲
分类:地质学	Category:地质学
张格尔	張格爾
小城之春	小城之春
泰国每日新闻	每日新聞 (泰國)
泰国民族舞蹈	泰国民族舞蹈
令伍特 (维克多利亚)	令伍特 (维多利亚)
马来西亚国际商业银行	联昌国际银行
大众银行 (马来西亚)	大眾銀行
方腊	方腊
濑户早妃	瀨戶早妃
搿连乃尔 (南澳大利亚)	格萊內爾格 (南澳大利亞州)
甜芦粟	糖高粱
Wikipedia:Selected anniversaries	Wikipedia:历史上的今天
Wikipedia:命名常规	Wikipedia:命名常规
剃刀	刮鬍刀
孔雀东南飞	孔雀東南飛
月光广场 (印度)	月光集市
太古城	太古城
苏菲娅·德慈	蘇菲婭·杜慈
香港湿地公园	香港濕地公園
闽南语维基百科	閩南語維基百科
海南鸡饭	海南雞飯
峇里岛九人帮	峇里九人組
伍斯华斯	Woolworths超級市場
关楚耀	關楚耀
淮海路	淮海路 (上海)
Portal:地理	Portal:地理学
九品芝麻官 (电影)	九品芝麻官
薛凱琪	薛凱琪
联合早报	联合早报
史可法	史可法
TAFE	技术与继续教育学院
胡温	胡温体制
三通	三通
春运	春运
屯门公路	屯門公路
祖逖	祖逖
可口可乐公司	可口可乐公司
吴越地区	江浙
谢婷婷	謝婷婷
壮语维基百科	Wikipedia:壮语维基百科
2008年夏天中国地区性发大水	2008年中国南方水灾
Wikipedia:Transclusion	Wikipedia:嵌入包含
Wikipedia:HotCat	Wikipedia:维基百科工具/HotCat
穹窿山	穹窿山
石浦镇	石浦镇
太平天国	太平天国
坚尼地城	堅尼地城
Nathan Wilmot	内森·威尔莫特
Malcolm Page	马尔科姆·佩奇
东南大学	东南大学
海上花列传	海上花列传
Alice Burdeu	艾麗絲·班迪奧
计算数学	计算数学
分类:维基百科机器人	Category:維基百科機器人
大陈	大陈岛
崇海大桥	崇海大橋
周美欣	周美欣
五菱汽车	五菱汽車
吴王夫差矛	吴王夫差矛
大阪	大阪 (消歧义)
评弹	评弹
Portal:艺术	Portal:艺术
分类:美国人	Category:美国人
分类:演员	Category:演员
分类:英国人	Category:英国人
分类:法国人	Category:法国人
模板:Tl	Template:Tl
模板:Userbox	Template:Userbox
南京理工大学	南京理工大学
台州方言	台州话
模板:Wikipedialang	Template:Wikipedialang
模板:Itn	Template:Itn
Wikipedia:问题	Wikipedia:互助客栈/求助
分类:自由软件	Category:自由软件
分类:国家	Category:国家
Wikipedia:Changing username	Wikipedia:更改用户名
Wikipedia:管理员	Wikipedia:管理员
模板:Sport-stub	Template:Sport-stub
分类:人物	Category:人物
分类:职业	Category:職業
分类:各行各业个人	Category:各職業人物
Wikipedia:机器人	Wikipedia:机器人
分类:货币	Category:货币
分类:工程學	Category:工程學
Wikipedia:100个核心页面	Wikipedia:基礎條目/第二級
Wikipedia:AutoWikiBrowser	Wikipedia:自动维基浏览器
分类:医学	Category:医学
分类:政治	Category:政治
分类:教育	Category:教育
分类:光学	Category:光學
分类:艺术	Category:艺术
通菜街	通菜街
埃及	埃及
Wikipedia:手傀儡	Wikipedia:傀儡
Wikipedia:Categorization	Wikipedia:頁面分類
模板:Bot	Template:Bot
加拿大	加拿大
分类:倍尔奇姆	Category:比利時
分类:捷克	Category:捷克
Wikipedia:版权	Wikipedia:版权信息
Wikipedia:关于	Wikipedia:关于
细川澄元	細川澄元
分类:电子游戏	Category:电子游戏
分类:游戏	Category:游戏
工业工程	工业工程学
帮助:編輯摘要	Wikipedia:編輯摘要
Portal:科学	Portal:科學
模板:Flagicon	Template:Flagicon
分类:欧洲国家	Category:欧洲国家
分类:欧洲	Category:欧洲
Wikipedia:Subpages	Wikipedia:子頁面
Wikipedia:近段辰光个事体	Portal:新聞動態
模板:Documentation	Template:Documentation
Wikipedia:User access levels	Wikipedia:用户权限级别
分类:已保护页面	Category:被保护的页面
Wikipedia:聊天频道	Wikipedia:IRC聊天频道
分类:维基人	Category:维基人
Wikipedia:社区门堂	Wikipedia:社群首页
分类:User by languages	Category:用户语言
帮助:用词指南	Wikipedia:避免使用的字詞
成在基	成在基
模板:Soft redirect	Template:軟重定向
模板:Delete	Template:Delete
分类:维基百科版权	Category:維基百科版權
松锦之战	松錦之戰
鎮海之戰	鎮海之戰
分类:技术	Category:技术
鸟篆	鳥蟲書
香港巴士	香港巴士
宝乍文	寶乍文·欽那瓦
分类:言话	Category:语言
分类:历法	Category:曆法
分类:维基百科	Category:维基百科
分类:各样言话个维基百科	Category:各種語言的維基百科
分类:朆索引个页	Category:不可索引页面
分类:有无用文件链接个页	Category:缺少文件的页面
Wikipedia:模板消息	Wikipedia:模板消息
分类:現在正發生個事體	Category:新闻动态
分类:欧洲城市	Category:歐洲城市
Wikipedia:維基休息	Wikipedia:维基假期
模板:-	Template:-
模板:Navbox	Template:Navbox
市辖区	市辖区
南京朝天宫	南京朝天宫
朝阳科技大学	朝陽科技大學
陈紫函	陈紫函
周骢	周驄
林敬刚	林敬剛
模板:Persondata	Template:Persondata
氧气	氧气
狄宝娜摩亚	狄寶娜摩亞
雪妮	雪妮
星岛日报	星島日報
慈幼英文学校	慈幼英文學校（中學部）
允常	允常
模板:Fact	Template:Fact
分类:重定向	Category:重定向
分类:維基百科維護	Category:维基百科维护
钱弘倧	錢弘倧
分类:泰国网球运动员	Category:泰国网球运动员
寺	佛寺
模板:Error	Template:Error
模板:((	Template:((
模板:))	Template:))
模板:!!	Template:!!
模板:=	Template:=
模板:Tnavbar	Template:Navbar
模板:Code	Template:Code
模板:0	Template:0
模板:Unicode	Template:Unicode
模板:Transclude	Template:Transclude
模板:Small	Template:Small
模板:Clear	Template:Clear
模板:Col-break	Template:Col-break
模板:Col-begin	Template:Col-begin
模板:Col-end	Template:Col-end
模板:Nowrap	Template:Nowrap
模板:Bots	Template:Bots
出埃及记 (香港电影)	出埃及記 (香港電影)
芳村	芳村
枫泾镇	枫泾镇
Wikipedia:必有个页面	Wikipedia:基礎條目
分类:非洲	Category:非洲
分类:數字	Category:数
分类:电子学	Category:電子學
分类:书	Category:書籍
模板:Wikisource	Template:Wikisource
模板:Babel	Template:Babel
模板:Commons	Template:Commons
模板:Link GA	Template:Link GA
模板:Reflist	Template:Reflist
模板:AFG	Template:AFG
高骈	高駢
Wikipedia:列明來源	Wikipedia:列明来源
模板:Stub	Template:Stub
模板:See also	Template:See also
模板:User de	Template:User de
模板:User de-1	Template:User de-1
模板:User es	Template:User es
模板:User de-3	Template:User de-3
模板:User en-3	Template:User en-3
模板:User en-1	Template:User en-1
模板:User en-2	Template:User en-2
模板:User en-4	Template:User en-4
模板:User en	Template:User en
模板:User de-2	Template:User de-2
模板:User es-1	Template:User es-1
模板:User fa	Template:User fa
模板:User fr-1	Template:User fr-1
分类:各国个文化	Category:各國文化
分类:物质	Category:物质
模板:User ja-4	Template:User ja-4
模板:User sk	Template:User sk
模板:User fr-2	Template:User fr-2
模板:User ja	Template:User ja
模板:User ja-1	Template:User ja-1
模板:User it-1	Template:User it-1
模板:User fr	Template:User fr
模板:Unsigned	Template:Unsigned
模板:HRV	Template:HRV
分类:亚洲	Category:亚洲
分类:智利	Category:智利
分类:21世紀	Category:21世纪
分类:User uk	Category:Uk 使用者
分类:南美洲	Category:南美洲
分类:User uk-N	Category:Uk 母語使用者
模板:Intricate template	Template:Esoteric
分类:马来西亚	Category:马来西亚
分类:食物	Category:食品
分类:足球	Category:足球
模板:Mod	Template:Mod
模板:User uk	Template:User uk
模板:User es-2	Template:User es-2
模板:WikipediaSister	Template:Wikipediasister
模板:USA	Template:USA
分类:年历	Category:年曆
分类:组织	Category:组织
分类:语言学	Category:语言学
模板:ITA	Template:ITA
模板:GEO	Template:GEO
模板:BOL	Template:BOL
分类:鏈接模板	Category:鏈接模板
模板:MEX	Template:MEX
分类:User fr-1	Category:Fr-1 使用者
模板:Wikiquote	Template:Wikiquote
模板:Image label	Template:Image label
模板:Category handler	Template:Category handler
模板:Category other	Template:Category other
归有光	归有光
模板:Translated page	Template:Translated page
模板:MAR	Template:MAR
模板:Ja icon	Template:Ja icon
模板:Korea-stub	Template:Korea-stub
模板:PSE	Template:PSE
模板:Sidebar	Template:Sidebar
模板:Es icon	Template:Es icon
模板:Ambox	Template:Ambox
Wikipedia:Accuracy dispute	Wikipedia:准确性争议
模板:Update	Template:更新
模板:SVK	Template:SVK
模板:TWN	Template:TWN
分类:还朆分类个页	Category:缺少頁面分類的頁面
模板:EGY	Template:EGY
模板:Quotation	Template:Quotation
模板:KGZ	Template:KGZ
模板:Infobox School	Template:Infobox School
模板:ISR	Template:ISR
模板:Nobel Prize in Physics	Template:诺贝尔物理学奖获得者
模板:Infobox Country	Template:國家基礎資訊
模板:Column-count	Template:Column-count
模板:VEN	Template:VEN
模板:Airline infobox	Template:Infobox Airline
模板:Wide image	Template:Wide image
模板:UKR	Template:UKR
模板:Px	Template:Px
模板:好哉	Template:完成
模板:Documentation/docname	Template:Documentation/docname
模板:Audio	Template:Audio
模板:Flatlist	Template:Flatlist
模板:PHL	Template:PHL
模板:ROU	Template:ROU
模板:BHR	Template:BHR
分类:欧洲国家足球队	Category:歐洲國家足球隊
模板:TUR	Template:TUR
模板:Expand section	Template:Expand section
模板:Tmbox	Template:Tmbox
模板:清理	Template:Cleanup
模板:DJI	Template:DJI
模板:Infobox university	Template:Infobox university
模板:BRN	Template:BRN
模板:Wikibooks	Template:Wikibooks
模板:Hatnote	Template:Dablink
模板:Redirect3	Template:Redirect3
模板:S-after	Template:S-after
分类:巴黎	Category:巴黎
分类:User en-4	Category:En-4 使用者
分类:User en	Category:En 使用者
分类:User zh	Category:Zh 使用者
分类:User zh-N	Category:Zh 母语使用者
分类:User en-2	Category:En-2 使用者
模板:Infobox	Template:Infobox
模板:Right TOC	Template:TOCright
模板:Main other	Template:Main other
模板:User zh	Template:User zh
模板:Template other	Template:Template other
模板:Legend	Template:Legend
模板:Cite web	Template:Cite web
模板:Youtube	Template:Youtube
模板:Current	Template:Current
分类:軍事裝備	Category:军事装备
模板:Infobox WS	Template:Infobox WS
模板:Ombox	Template:Ombox
分类:女模特	Category:女性模特兒
模板:IMDb title	Template:Imdb title
模板:国际足球	Template:國際足球
模板:User ru-4	Template:User ru-4
分类:饮食	Category:飲食
模板:Coor URL	Template:MapsServer
杭州话语	杭州话
模板:Wiktionary	Template:Wiktionary
模板:Mbox templates	Template:Mbox templates
模板:Multi-listen start	Template:Multi-listen start
模板:Languageicon	Template:Language icon
分类:英国个博物馆	Category:英國博物館
模板:大韩民国行政区划	Template:韩国一级行政区
Wikipedia:Selected anniversaries/October 3	Wikipedia:历史上的今天/10月3日
分类:总统	Category:总统
模板:User ru	Template:User ru
分类:20世紀	Category:20世纪
模板:IPA	Template:IPA
分类:美洲	Category:美洲
模板:Otheruses	Template:Otheruses
韩邦庆	韩邦庆
分类:各国个人	Category:各國人物
模板:User language-N	Template:User language-N
模板:Imbox	Template:Imbox
模板:Rellink	Template:Rellink
模板:Did you know	Template:Dyk
模板:MONTHNAME	Template:MONTHNAME
Wikipedia:GNU自由文档许可证文本	Wikipedia:GNU自由文档许可证文本
模板:CPV	Template:CPV
模板:Death date and age	Template:Death date and age
模板:Infobox Model	Template:Infobox Model
模板:MONTHNUMBER	Template:MONTHNUMBER
模板:(	Template:(
分类:人物小作品	Category:人物小作品
模板:Top icon	Template:Topicon
模板:Namespace detect	Template:Namespace detect
模板:)	Template:)
模板:Fmbox	Template:Fmbox
分类:作家	Category:作家
分类:軍事	Category:军事
分类:大学	Category:大学
模板:Hidden begin	Template:Hidden begin
模板:Talkback	Template:Talkback
模板:MYS	Template:MYS
模板:TJK	Template:TJK
模板:Infobox Website	Template:Infobox Website
模板:Image label end	Template:Image label end
模板:Documentation subpage	Template:Documentation subpage
模板:Winners	Template:Winners
模板:Ref label	Template:Ref label
模板:GHA	Template:GHA
模板:GMB	Template:GMB
模板:Uncategorized	Template:Uncategorized
模板:IDN	Template:IDN
模板:FRO	Template:FRO
模板:ZAF	Template:ZAF
模板:POL	Template:POL
模板:Oldid	Template:Oldid
模板:URY	Template:URY
模板:CUB	Template:CUB
模板:CMR	Template:CMR
模板:BIH	Template:BIH
模板:FIN	Template:FIN
模板:Tlx	Template:Tlx
模板:CAN	Template:CAN
模板:Purge	Template:Purge
模板:Cc-by-3.0	Template:CC-BY-3.0
模板:DNK	Template:DNK
模板:Empty category	Template:Empty category
模板:Infobox Cyrillic	Template:Infobox Cyrillic
模板:Dead link	Template:Dead link
分类:跨性别	Category:跨性別
模板:Provinces of China	Template:中华人民共和国省级行政区
模板:SAU	Template:KSA
模板:Userpage	Template:Userpage
模板:DEU	Template:DEU
模板:BEN	Template:BEN
模板:CIS	Template:独立国家联合体
模板:SWE	Template:SWE
模板:Note label	Template:Note label
模板:Food-stub	Template:Food-stub
分类:中国个建筑	Category:中国建筑
杨协成	楊協成
模板:User	Template:User
模板:YEM	Template:YEM
模板:Spoken Wikipedia	Template:Spoken Wikipedia
吴稚晖	吳敬恆
余祭	餘祭
诸樊	諸樊
寿梦	壽夢
模板:Lorem ipsum	Template:Lorem ipsum original
俚	俚人
沈嗣良	沈嗣良
甪直镇	甪直镇
模板:User language-4	Template:User language-4
分类:中学	Category:中学
模板:YearTOC	Template:YearTOC
分类:越南机场	Category:越南機場
模板:Note	Template:Note
分类:公司	Category:公司
模板:Footballbox	Template:Footballbox
模板:Renameuser	Template:Usurp
模板:CIA World Factbook link	Template:CIA World Factbook link
模板:Image label small	Template:Image label small
模板:Infobox Language/pronunciation	Template:Infobox Language/pronunciation
模板:Iaaf name	Template:IAAF name
模板:User language-0	Template:User language-0
模板:瑞士城市	Template:Infobox Swiss town
模板:Japanese	Template:Nihongo
模板:User fr-3	Template:User fr-3
模板:UEFA	Template:欧洲足球锦标赛
模板:Infobox Military Unit	Template:Infobox Military Unit
模板:IMDb name	Template:Imdb name
模板:Ar icon	Template:Ar icon
模板:ABW	Template:ABW
分类:突尼斯	Category:突尼西亞
模板:Th	Template:Th icon
模板:S-title	Template:S-title
模板:Infobox Language/map	Template:Infobox Language/map
分类:泰国个寺庙	Category:泰國佛寺
模板:JPN	Template:JPN
模板:Japan	Template:日本一级行政区
模板:China-stub	Template:PRChina-stub
模板:Korea-bio-stub	Template:Korea-bio-stub
模板:Cmbox	Template:Cmbox
模板:CSS IPA vowel chart	Template:CSS IPA vowel chart
模板:PAN	Template:PAN
模板:SOM	Template:SOM
模板:SWZ	Template:SWZ
模板:Infobox Spacecraft	Template:Infobox Spacecraft
模板:PAK	Template:PAK
模板:User nds-1	Template:User nds-1
模板:S-before	Template:S-before
分类:日本行政区划	Category:日本地方區分
模板:Mbox	Template:Mbox
模板:ISL	Template:ISL
模板:Oppose	Template:Oppose
模板:COL	Template:COL
模板:CCK	Template:CCK
模板:ERI	Template:ERI
模板:Pagetype	Template:Pagetype
模板:GAB	Template:GAB
模板:IRN	Template:IRN
模板:MLI	Template:MLI
模板:JOR	Template:JOR
模板:NPL	Template:NPL
模板:NAM	Template:NAM
模板:CAF	Template:CAF
模板:MKD	Template:MKD
模板:Exchange rate	Template:Exchange rate
模板:LKA	Template:LKA
模板:MWI	Template:MWI
模板:KAZ	Template:KAZ
模板:OMN	Template:OMN
模板:PER	Template:PER
模板:MOZ	Template:MOZ
模板:SUR	Template:SUR
模板:TRI	Template:TTO
模板:GUY	Template:GUY
模板:ETH	Template:ETH
模板:HKG	Template:HKG
模板:NGA	Template:NGA
模板:PRK	Template:PRK
模板:NIC	Template:NIC
模板:LBR	Template:LBR
模板:TKM	Template:TKM
模板:THA	Template:THA
模板:BFA	Template:BFA
模板:TCD	Template:TCD
模板:PRY	Template:PRY
模板:ECU	Template:ECU
模板:BTN	Template:BTN
模板:MDV	Template:MDV
模板:SLE	Template:SLE
模板:LTU	Template:LTU
模板:SGP	Template:SGP
模板:IND	Template:IND
模板:MAC	Template:MAC
模板:User ar-2	Template:User ar-2
模板:User fr-0	Template:User fr-0
北京中轴线	北京中轴线
高德	高德 (传教士)
苏州地铁4号线	苏州轨道交通4号线
妇好墓	妇好墓
内画	内画壶
沙地言话	沙地话
木渎镇	木渎镇
衢州话	衢州话
千灯镇	千灯镇
东海气油田问题	东海油气田问题
日本皇民党	日本皇民黨
柏拉图式性愛	柏拉圖式性愛
江郎山	江郎山
沙叶新	沙叶新
江山话	江山话
天一广场	天一广场
苏州地铁3号线	苏州轨道交通3号线
沙溪镇	沙溪镇 (太仓市)
康熙來了	康熙來了
黃泰来	黃泰來
蔡铭超	蔡銘超
客家语维基百科	Wikipedia:客家語維基百科
市民日报 (澳门)	市民日报
丑陋的中国人	醜陋的中國人
西门口	西门口 (广州)
MK人	MK文化
世界日报 (泰国)	泰國世界日報
陈兆龙	陳兆龍
十八楼C座	十八樓C座
倪震	倪震
科学馆道 (香港)	科學館道
德庆溪	德慶溪
香港商报	香港商報
本字	本字
分类:User ja-N	Category:Ja 母语使用者
分类:用戶名字空間模板	Category:用戶頁模板
余眛	馀眛
赣语维基百科	Wikipedia:贛語維基百科
九头鸟	九頭鳥
模板:CHE	Template:CHE
分类:社会阶层	Category:社会阶层
分类:印度电影	Category:印度電影
钱弘佐	錢弘佐
模板:URL	Template:URL
模板:Hidden end	Template:Hidden end
模板:Disambiguation	Template:Disambig
姑娘	姑娘
分类:公共交通	Category:公共交通
分类:中东	Category:中东
模板:Select skin	Template:Select skin
分类:报纸	Category:报纸
分类:运动场	Category:體育場
模板:Para	Template:Para
模板:Fb	Template:Fb
分类:維基百科元模板	Category:维基百科元模板
模板:LAO	Template:LAO
模板:User zh-min-nan-1	Template:User nan-1
模板:ARE	Template:ARE
模板:GRC	Template:GRC
模板:PRT	Template:PRT
模板:BGD	Template:BGD
模板:BAR	Template:BRB
模板:User ksh	Template:User ksh
模板:User zh-yue-3	Template:User zh-yue-3
模板:AUS	Template:AUS
模板:User zh-yue-1	Template:User zh-yue-1
模板:CZE	Template:CZE
模板:AZE	Template:AZE
模板:Infobox Film	Template:Infobox Film
模板:英文名	Template:Lang-en
分类:语言标示模板	Category:语言模板
分类:甜品	Category:甜品
分类:新加坡个机场	Category:新加坡機場
模板:Expand language	Template:Expand language
模板:WAD	Template:WAD
分类:內部鏈接模板	Category:内部链接模板
模板:KHM	Template:KHM
模板:NLD	Template:NLD
模板:KWT	Template:KWT
江南贡院	江南贡院
江南丝竹	江南丝竹
甲子镇 (海口市)	甲子镇 (海口市)
解放街道	解放街道 (舟山市)
模板:Resize	Template:Resize
模板:辅音	Template:輔音
模板:VNM	Template:VNM
模板:LIE	Template:LIE
模板:SEN	Template:SEN
模板:NZL	Template:NZL
分类:广州	Category:广州
模板:MMR	Template:MMR
分类:吴语	Category:吳語
模板:KOR	Template:KOR
分类:各类电影	Category:各類型電影
模板:!(	Template:!(
分类:中国外交官	Category:中国外交官
模板:NATO	Template:北大西洋公約組織
分类:生物	Category:生物
模板:De icon	Template:De icon
模板:SVN	Template:SVN
模板:LBN	Template:LBN
模板:GGY	Template:GGY
模板:FRA	Template:FRA
模板:Hang on	Template:Hangon
模板:Infobox Biography	Template:Infobox person
分类:蒙古	Category:蒙古國
模板:InterWiki	Template:InterWiki
模板:Main Page interwikis	Template:Mainpage-iw
分类:法国女模特	Category:法國女性模特兒
分类:泰国个大学	Category:泰國大學
分类:澳大利亚个报纸	Category:澳大利亚报纸
分类:历年个电影	Category:每年電影
分类:爱尔兰城市	Category:愛爾蘭城市
分类:美国黑人	Category:非洲裔美国人
模板:Dated maintenance category	Template:Dated maintenance category
模板:Chem-stub	Template:Chem-stub
模板:Thailand-stub	Template:Thailand-stub
模板:Britain-stub	Template:UK-stub
分类:1992年个歌曲	Category:1992年歌曲
分类:姊妹计划链接模板	Category:姊妹計劃鏈接模板
模板:User la-1	Template:User la-1
模板:APEC	Template:亚洲太平洋经济合作组织
模板:歐洲行政區劃	Template:Europe
分类:模板說明文檔	Category:模板說明文件
分类:泰语	Category:泰语
分类:User zh-yue	Category:Zh-yue 使用者
分类:User wuu	Category:Zh-wuu 使用者
分类:User sk	Category:Sk 使用者
分类:User fr	Category:Fr 使用者
分类:User ja	Category:Ja 使用者
分类:User la	Category:La 使用者
分类:User fr-3	Category:Fr-3 使用者
分类:User fr-2	Category:Fr-2 使用者
分类:User ja-2	Category:Ja-2 使用者
分类:User la-2	Category:La-2 使用者
分类:User wuu-N	Category:Zh-wuu 母語使用者
分类:User ko-N	Category:Ko 母語使用者
分类:User fr-N	Category:Fr 母語使用者
分类:User nl-N	Category:Nl 母語使用者
分类:User ru-N	Category:Ru 母語使用者
分类:泰国拳击运动员	Category:泰国拳击运动员
分类:政治经济学	Category:政治经济学
分类:曼谷	Category:曼谷的区
模板:User zh-yue	Template:User zh-yue
分类:文字	Category:文字
分类:维基百科清理	Category:需要清理的条目
分类:Template using ParserFunctions	Category:使用了分析程序的模板
分类:中国省级行政区	Category:中华人民共和国省份
分类:岛	Category:岛屿
分类:广平省	Category:廣平省
分类:User sk-N	Category:Sk 母語使用者
分类:User de	Category:De 使用者
分类:User de-2	Category:De-2 使用者
分类:User de-3	Category:De-3 使用者
分类:User de-4	Category:De-4 使用者
分类:User de-N	Category:De 母語使用者
分类:美国男演员	Category:美国男演员
分类:User en-3	Category:En-3 使用者
分类:User en-N	Category:En 母语使用者
分类:User es	Category:Es 使用者
分类:User es-1	Category:Es-1 使用者
分类:User es-2	Category:Es-2 使用者
分类:User es-N	Category:Es 母语使用者
分类:首尔	Category:首爾
分类:日本模板	Category:日本模板
无疆	無彊
模板:User la-3	Template:User la-3
鹿郢	鹿郢
何典	何典
分类:法国个公园	Category:法國公園
分类:各国个公园	Category:各國公園
分类:各国个政治	Category:各國政治
模板:Multiple image	Template:并列图像
三吴	三吳
吴语字	吴语字
模板:Colorsample	Template:Color sample
分类:User it	Category:It 使用者
分类:User it-1	Category:It-1 使用者
分类:User ja-1	Category:Ja-1 使用者
分类:User ko	Category:Ko 使用者
分类:美国州	Category:美国州份
分类:User ksh	Category:Ksh 使用者
分类:User ksh-N	Category:Ksh 母語使用者
分类:User la-1	Category:La-1 使用者
分类:User la-3	Category:La-3 使用者
分类:澳大利亚地理	Category:澳大利亞地理
分类:维基百科讨论	Category:維基百科討論
分类:火山	Category:火山
模板:NOR	Template:NOR
模板:Translation WIP	Template:Translating
模板:He icon	Template:He icon
分类:天气	Category:天氣
模板:Information	Template:Information
分类:日本个县	Category:日本都道府縣
分类:法国城市	Category:法國城市
模板:BRA	Template:BRA
分类:澳大利亚女演员	Category:澳大利亞女演員
分类:User ru-1	Category:Ru-1 使用者
Wikipedia:巴别	Wikipedia:巴別
模板:High-use	Template:High-use
水分子	水的性質
模板:Humor	Template:幽默
分类:残疾人	Category:残疾人
分类:北京人	Category:北京人
分类:化学小作品	Category:化学小作品
分类:各国个军事	Category:各國軍事
模板:TUN	Template:TUN
分类:日本地方	Category:日本地理區劃
分类:海	Category:海洋
地方政府	地方政府
分类:李氏朝鲜君主	Category:朝鮮王朝君主
分类:泰国模板	Category:泰国模板
分类:工具书	Category:工具书
分类:计算机科学	Category:计算机科学
分类:User nds	Category:Nds 使用者
分类:User nds-1	Category:Nds-1 使用者
模板:LUX	Template:LUX
模板:Red	Template:紅
分类:神奈川县	Category:神奈川縣
分类:福岛县	Category:福島縣
分类:广东省	Category:广东
分类:安徽	Category:安徽
分类:江西省	Category:江西
分类:江苏省	Category:江苏
分类:经济	Category:经济
模板:Title without disambig	Template:Title without disambig
分类:行政区划	Category:行政区划单位
分类:饮料	Category:饮料
何傲儿	何傲兒
分类:1980年代出生	Category:1980年代出生
分类:社会科学	Category:社会科学
分类:办拉路斯	Category:白俄羅斯
分类:苏州人	Category:苏州人
分类:苏州交通	Category:苏州交通
分类:中国电影	Category:中国电影
分类:澳大利亚教育	Category:澳大利亞教育
分类:非洲国家	Category:非洲国家
分类:各国教育	Category:各國教育
模板:(((	Template:(((
模板:)!	Template:)!
模板:)))	Template:)))
Wikipedia:AutoWikiBrowser/Typos	Wikipedia:AutoWikiBrowser/Typos
模板:User ru-2	Template:User ru-2
分类:科幻片	Category:科幻片
模板:Column-width	Template:Column-width
分类:User ru	Category:Ru 使用者
分类:User ru-2	Category:Ru-2 使用者
分类:User ru-4	Category:Ru-4 使用者
分类:用戶軟重定向	Category:用户软重定向
分类:User zh-yue-1	Category:Zh-yue-1 使用者
分类:User zh-yue-3	Category:Zh-yue-3 使用者
分类:User zh-yue-N	Category:Zh-yue 母语使用者
模板:En icon	Template:En icon
分类:浙江省	Category:浙江
分类:金球奖获得者	Category:金球奖获得者
模板:!((	Template:!((
模板:))!	Template:))!
分类:港铁车站	Category:港鐵車站
模板:Lang	Template:Lang
分类:泰国电影	Category:泰國電影作品
分类:社会学	Category:社会学
模板:IRL	Template:IRL
吴越春秋	吳越春秋
越绝书	越绝书
分类:美国女演员	Category:美國女演員
龙塘镇 (海口市)	龙塘镇 (海口市)
分类:1981年出生	Category:1981年出生
分类:1986年出生	Category:1986年出生
黄冈中学	黄冈中学
黄海 (作家)	黃海 (作家)
柳如是	柳如是
模板:ALB	Template:ALB
模板:AND	Template:AND
模板:ARG	Template:ARG
模板:ARM	Template:ARM
闻堰镇	闻堰街道
锡剧	锡剧
分类:美国女模特儿	Category:美國女性模特兒
金庭镇	金庭镇 (苏州市)
重庆解放碑	抗战胜利纪功碑暨人民解放纪念碑
邝美云	鄺美雲
模板:CopyrightByWikimedia	Template:Non-free Wikimedia logo
分类:美国慈善家	Category:美國慈善家
分类:各国个电影	Category:各國電影
Wikipedia:Template sandbox and test cases	Wikipedia:模板的沙盒和测试样例
分类:人类	Category:人类
分类:分類名字空間模板	Category:分類頁模板
模板:Australia-stub	Template:Australia-stub
西藏中路	西藏中路
模板:Car-stub	Template:Car-stub
模板:BDI	Template:BDI
模板:BAH	Template:BHS
模板:BLR	Template:BLR
虎窟寺 (甲米府)	虎窟寺
模板:When on basepage	Template:Basepage subpage
模板:Bhutan stub	Template:Bhutan-stub
菱湖镇	菱湖镇
圣约翰堂	苏州圣约翰堂
分类:棋类	Category:棋类
总兵	總兵
模板:CIV	Template:CIV
模板:CRI	Template:CRI
模板:CHY	Template:CYP
分类:泰国交通	Category:泰國交通
模板:Fr	Template:Fr icon
模板:Ko icon	Template:Ko icon
白相人	白相人
生祠镇	生祠镇
分类:法国铁路	Category:法國鐵路
分类:維基百科軟重定向	Category:維基百科軟重定向
分类:1951年个电影	Category:1951年電影
烂柯山	烂柯山
滩簧	滩簧
滑稽戏	滑稽戏
淳溪镇	淳溪镇
洋泾浜	洋泾浜
沈佳	沈佳
江北人	江北人
水晶棺	水晶棺
模板:物理学粒子	Template:粒子
分类:女演员	Category:女演員
杜根	杜根
分类:佛罗里达州	Category:佛罗里达州
新英湾区	新英湾区
新场镇	新场镇 (上海市)
戴埠镇	戴埠镇
慈城镇	慈城镇
徐霞客故居	徐霞客故居及晴山堂石刻
分类:上海个区	Category:上海市辖区
张海华	张海华
廿八都镇	廿八都镇
廊下镇	廊下镇
模板:EST	Template:EST
府尹	府尹
府城街道 (海口市)	府城街道 (海口市)
干窑镇	干窑镇
干冲区	干冲区
師爺	師爺
分类:泰国政党	Category:泰国政党
Wikipedia:Lua	Wikipedia:Lua
分类:大規模殺傷性武器	Category:大规模杀伤性武器
模板:QAT	Template:QAT
模板:RUS	Template:RUS
宽带山	宽带山
模板:AUT	Template:AUT
嫖客	嫖客
模板:History-stub	Template:Hist-stub
太平轮	太平輪沉沒事件
分类:2009年恐怖事件	Category:2009年恐怖活动
大豫	大豫镇
分类:动作片	Category:动作片
国兴街道	国兴街道
四川路	四川中路 (上海)
模板:CHL	Template:CHL
分类:英语电影	Category:英语电影
和孚镇	和孚镇
吴语文学	吳語文學
台湾当局	台灣政府
台巴子	台巴子
台州中学	台州中学
双林镇	双林镇 (湖州市)
南浔镇	南浔镇
南洋公学	南洋公学
南峰	南峰
南京银行	南京银行
光福镇	光福镇
光福塔	光福寺塔
佛堂镇	佛堂镇
东浦镇	东浦镇
三门坡镇	三门坡镇
分类:软件系统	Category:軟體系統
模板:Round8	Template:Round8
模板:SYR	Template:SYR
模板:CHN	Template:CHN
莫愁湖	莫愁湖
模板:Switzerland-stub	Template:Switzerland-stub
莫小棋	莫小棋
模板:Side box	Template:Side box
分类:世界人口	Category:各国人口
模板:IRQ	Template:IRQ
模板:字单3	Template:Chset-cell3
模板:字色阿	Template:Chset-color-alpha
模板:字色数	Template:Chset-color-digit
模板:字色标	Template:Chset-color-punct
模板:字色朆	Template:Chset-color-undef
模板:字左	Template:Chset-left
模板:Citation/core	Template:Citation/core
分类:法国交通	Category:法國交通
分类:澳大利亚个湖	Category:澳大利亚湖泊
分类:各国经济	Category:各國經濟
分类:各国个报纸	Category:各國報紙
分类:各国个银行	Category:各國銀行
分类:各国个地震	Category:各國地震
分类:韩国政治	Category:韓國政治
分类:澳大利亚个政治	Category:澳大利亞政治
分类:泰国政治	Category:泰國政治
分类:越南经济	Category:越南經濟
分类:柬埔寨经济	Category:柬埔寨經濟
分类:朝鲜民主主义人民共和国政治	Category:朝鲜民主主义人民共和国政治
分类:泰国经济	Category:泰国经济
模板:Infobox Language/family-color	Template:Infobox Language/family-color
分类:澳大利亚体育运动	Category:澳洲體育
分类:泰国体育	Category:泰國體育
分类:澳大利亚足球	Category:澳大利亞足球
分类:河	Category:河流
模板:User ko	Template:User ko
模板:User la-2	Template:User la-2
模板:User ru-1	Template:User ru-1
模板:User zh-1	Template:User zh-1
模板:User zh-2	Template:User zh-2
模板:User zh-3	Template:User zh-3
模板:User zh-4	Template:User zh-4
分类:韩国交通	Category:韓國交通
分类:中国交通	Category:中国交通
分类:世界各国个博物馆	Category:各國博物館
分类:马来西亚经济	Category:馬來西亞經濟
分类:泰国军事	Category:泰國軍事
分类:菲律宾模板	Category:菲律宾模板
模板:Multi-listen end	Template:Multi-listen end
分类:澳大利亚个交通	Category:澳洲交通
分类:蘇聯政治家	Category:蘇聯政治人物
分类:日本教育	Category:日本教育
分类:泰国教育	Category:泰國教育
分类:韩国人	Category:韓國人
分类:台湾人	Category:台灣人
Wikipedia:Picture of the day	Wikipedia:每日图片
分类:菲律宾	Category:菲律宾
分类:各行业澳大利亚人	Category:各职业澳大利亚人
分类:马来西亚歌手	Category:馬來西亞歌手
分类:泰国歌星	Category:泰國歌手
分类:User nl	Category:Nl 使用者
分类:User zh-1	Category:Zh-1 使用者
分类:User zh-4	Category:Zh-4 使用者
分类:User zh-3	Category:Zh-3 使用者
分类:User zh-2	Category:Zh-2 使用者
分类:泰国国王	Category:泰国国王
分类:力学	Category:力學
分类:香港个报纸	Category:香港報紙
分类:节气	Category:節氣
分类:中国计算机科学家	Category:中国计算机科学家
分类:不丹	Category:不丹
分类:澳大利亚跳水运动员	Category:澳大利亚跳水运动员
分类:印度模特	Category:印度模特兒
分类:印度科学技术	Category:印度科技
新年	新年
分类:中国演员	Category:中国演员
分类:泰国演员	Category:泰国演员
分类:澳大利亚游泳运动员	Category:澳大利亚游泳运动员
分类:电视	Category:电视
分类:中国诗人	Category:中国诗人
分类:凯撒奖获得者	Category:凱撒電影獎獲得者
分类:世紀	Category:世纪
分类:蘇聯外敎官	Category:苏联外交官
分类:印度演员	Category:印度演員
分类:中国田径运动员	Category:中国田径运动员
分类:澳大利亚脚踏车运动员	Category:澳大利亚自行车运动员
分类:泰国运动员	Category:泰国运动员
分类:中国运动员	Category:中国运动员
分类:泰国府	Category:泰國府級行政區
分类:海滩	Category:沙灘
分类:泰国个海滩	Category:泰國沙灘
分类:柬埔寨人	Category:柬埔寨人
分类:泰国政治人物	Category:泰國政治人物
分类:香港人	Category:香港人
分类:泰国人	Category:泰國人
分类:泰国华人	Category:泰國華人
粤语	粤语
分类:曼谷街道	Category:曼谷街道
分类:泰国个公路	Category:泰国公路
分类:东海	Category:东海
分类:泰国个湖泊	Category:泰國湖泊
分类:意大利个湖	Category:意大利湖泊
分类:光学仪器	Category:光学仪器
分类:机场	Category:機場
分类:泰国机场	Category:泰國機場
分类:日本个机场	Category:日本機場
分类:泰国个银行	Category:泰國銀行
分类:化学元素	Category:化学元素
分类:澳大利亚运动员	Category:澳大利亚运动员
分类:各国演员	Category:各國電影演員
分类:香港演员	Category:香港演員
分类:环球小姐	Category:环球小姐
分类:不丹总理	Category:不丹总理
分类:澳大利亚总理	Category:澳大利亚总理
分类:泰国总理	Category:泰国总理
分类:地理小作品	Category:地理小作品
分类:饮食小作品	Category:饮食小作品
分类:朝鲜	Category:朝鮮民主主義人民共和國
分类:柬埔寨	Category:柬埔寨
分类:澳大利亚人	Category:澳大利亞人
分类:中国人	Category:中国人
分类:台湾歌手	Category:台湾歌手
分类:韩国演员	Category:韩国演员
分类:蘇聯作家	Category:蘇聯作家
分类:中国历史	Category:中国历史
分类:不丹国王	Category:不丹国王
分类:老挝	Category:寮國
分类:缅甸	Category:緬甸
分类:台湾	Category:台灣
分类:法国演员	Category:法国演员
分类:電影模板	Category:電影模板
分类:爱尔兰模板	Category:愛爾蘭模板
分类:伊朗模板	Category:伊朗模板
分类:英国模板	Category:英國模板
分类:美国模板	Category:美国模板
分类:中国古代朝代	Category:中国朝代
分类:多語言支援模板	Category:多语言支援模板
分类:新加坡模板	Category:新加坡模板
分类:外交模板	Category:外交模板
分类:法国模板	Category:法國模板
分类:越南模板	Category:越南模板
分类:加拿大模板	Category:加拿大模板
分类:马来西亚模板	Category:馬來西亞模板
分类:精密模板	Category:精密模板
分类:維基百科工具模板	Category:维基百科工具模板
分类:模板名字空間模板	Category:模板页的模板
分类:香港模板	Category:香港模板
分类:泰国个公司	Category:泰國公司
分类:马来西亚公司	Category:馬來西亞公司
分类:常州人	Category:常州人
分类:陕西人	Category:陕西人
分类:安徽人	Category:安徽人
分类:云南人	Category:云南人
分类:江苏人	Category:江苏人
分类:浙江人	Category:浙江人
分类:上海人	Category:上海人
分类:出生	Category:出生年份
分类:朝鮮人	Category:朝鮮王朝人物
分类:法国总统	Category:法国总统
分类:亚洲历史	Category:亚洲历史
分类:约旦	Category:约旦
分类:大洋洲国家	Category:大洋洲国家
分类:鱼类	Category:鱼类
分类:北京	Category:北京
分类:国家足球队	Category:国家足球队
分类:泰国灾难	Category:泰国灾难
分类:日本关东地方	Category:關東地方
分类:柬埔寨电影	Category:柬埔寨电影作品
分类:剧情片	Category:剧情片
分类:1971年个电影	Category:1971年電影
分类:2003年个电影	Category:2003年电影
分类:1994年个电影	Category:1994年電影
分类:2004年个电影	Category:2004年電影
分类:2005年个电影	Category:2005年电影
分类:2007年个电影	Category:2007年电影
分类:2008年个电影	Category:2008年电影
分类:香港电影	Category:香港電影
分类:法国电影	Category:法国电影
分类:公用领域媒体	Category:公共领域图像
分类:印地语	Category:印地語
分类:阿拉伯语	Category:阿拉伯语
分类:印度言话	Category:印度語言
分类:東南亚言话	Category:東南亞語言
分类:人类学	Category:人类学
分类:世界小姐	Category:世界小姐
分类:抗生素	Category:抗生素
分类:五代十国	Category:五代十国
分类:操作系统	Category:操作系统
分类:昆士兰州	Category:昆士蘭州
分类:泰国政府	Category:泰国政府
分类:维克多利亚州	Category:維多利亞州
分类:电影奖	Category:电影奖项
分类:奥斯卡金像奖	Category:奥斯卡金像奖
分类:金球奖	Category:金球奖
分类:清朝	Category:清朝
分类:宋朝	Category:宋朝
分类:明朝	Category:明朝
分类:汉朝	Category:汉朝
分类:泰国王室	Category:泰国王室
分类:里昂	Category:里昂
模板:Incubator	Template:Incubator
分类:中国文化	Category:中国文化
分类:法国文化	Category:法國文化
分类:越南文化	Category:越南文化
分类:韩国文化	Category:韓國文化
分类:维基百科指南	Category:维基百科指南
分类:電子工程	Category:電子工程學
分类:网络语言	Category:网络语言
模板:ESP	Template:ESP
分类:动物	Category:动物
分类:泰国航空公司	Category:泰國航空公司
分类:製造品	Category:製造品
分类:歌唱比赛	Category:歌唱比賽
分类:国际象棋	Category:国际象棋
分类:武器	Category:武器
分类:核武器	Category:核武器
分类:马来西亚个银行	Category:馬來西亞銀行
瀑瑶兰	博若莱
分类:英国女演员	Category:英国女演员
分类:物理量	Category:物理量
Wikipedia:Soft redirect	Wikipedia:软重定向
赤壁	赤壁
分类:温标	Category:溫度單位
模板:元素色例	Template:Element color legend
老杭州城	老杭州城
羌活	羌活
罗炳辉	罗炳辉
分类:汉字	Category:汉字
分类:小吃	Category:小吃
分类:热力学	Category:热力学
分类:气象学	Category:气象学
分类:泰国个公园	Category:泰國公園
分类:航空事故	Category:航空事故
分类:香港	Category:香港
分类:菲律宾群岛	Category:菲律宾岛屿
分类:大西洋岛屿	Category:大西洋島嶼
分类:上海	Category:上海
分类:节日	Category:节日
分类:泰国歌曲	Category:泰國歌曲
分类:印度城市	Category:印度城市
分类:俄罗斯城市	Category:俄羅斯城市
分类:Web 2.0	Category:Web 2.0
分类:事体	Category:事件
分类:西亚	Category:西亚
分类:電信	Category:电信
分类:流感病毒	Category:流行性感冒
竹箦镇	竹箦镇
分类:交通	Category:交通
分类:选美	Category:選美活動
分类:性行为	Category:性行为
硬糕	硬糕
分类:电视剧	Category:电视剧
分类:北美洲	Category:北美洲
分类:歌手	Category:歌手
分类:亚洲个湖泊	Category:亚洲湖泊
分类:欧洲个湖泊	Category:欧洲湖泊
分类:湖泊	Category:湖泊
分类:大韩民国机场	Category:韩国机场
分类:围棋棋手	Category:围棋棋手
模板:Infobox Language	Template:Infobox Language
分类:大洋洲	Category:大洋洲
江东	江东
分类:中国城市	Category:中国城市
掘港	掘港镇
分类:瀑布	Category:瀑布
分类:自然灾害	Category:自然灾害
分类:日本九州	Category:九州地方
分类:1998年个电影	Category:1998年电影
分类:2006年个电影	Category:2006年電影
分类:恐怖片	Category:恐怖片
分类:美国电影	Category:美国电影
分类:汉语	Category:汉语
分类:泰国言话	Category:泰國語言
分类:新南威尔士州	Category:新南威爾士州
崇明	崇明
年三十夜	除夕
吴兴	吴兴
秦时明月	秦时明月
分类:澳大利亚文化	Category:澳大利亞文化
分类:泰国文化	Category:泰國文化
分类:越南城市	Category:越南城市
分类:澳大利亚城市	Category:澳大利亞城市
分类:泰国城市	Category:泰國城市
分类:泰国个岛	Category:泰國島嶼
分类:印度文化	Category:印度文化
分类:印度尼西亚个岛	Category:印尼岛屿
分类:中东国家	Category:中东国家
分类:澳大利亚旅游	Category:澳大利亞旅遊
模块:URL	模块:URL
分类:中国个公园	Category:中國公園
分类:无锡	Category:无锡
分类:银行	Category:銀行
Wikipedia:模板文檔	Wikipedia:模板文件頁模式
安藤沙耶香	安藤沙耶香
分类:中华人民共和国	Category:中华人民共和国
分类:維基百科文化	Category:維基百科文化
分类:版权模板	Category:版權申告模板
分类:维基百科媒体文件版权	Category:按版权状态分类的维基百科图像
分类:南欧	Category:南欧
分类:維基百科名字空間模板	Category:各名字空間模板
分类:澳大利亚运动场	Category:澳大利亞體育場地
模板:FULLROOTPAGENAME	Template:FULLROOTPAGENAME
东京	东京
模板:Incorrect namespace	Template:Incorrect namespace
模板:Single namespace	Template:Single namespace
分类:学堂	Category:学校
分类:越南航空	Category:越南航空公司
分类:中国地铁	Category:中國城市軌道交通
模板:Geo stub	Template:Geo-stub
绍兴文理学院	绍兴文理学院
模板:UGA	Template:UGA
模板:UZB	Template:UZB
模板:Comment	Template:Comment
模板:解剖学治疗学及化学分类系统	Template:解剖学治疗学及化学分类系统
太平府 (安徽省)	太平府 (安徽省)
分类:香港交通	Category:香港交通
中国	中國 (消歧義)
神話 (電視劇)	神话 (电视剧)
Portal:数学	Portal:数学
分类:纪元	Category:紀元
模板:Greece-stub	Template:Greece-stub
田令孜	田令孜
厕所	廁所
分类:吴越国	Category:吴越
分类:User wuu-3	Category:Zh-wuu-3 使用者
大唐雙龍傳 (電視劇)	大唐雙龍傳 (電視劇)
分类:新南威尔士州个地方	Category:新南威尔士州城镇
中国（上海）自由贸易试验区	中国（上海）自由贸易试验区
王海容	王海容
王坦之	王坦之
文种	文种
分类:朝鲜国家元首	Category:朝鲜国家元首
方腊起义	方腊起義
风云：雄霸天下 (2002年电视剧)	风云：雄霸天下 (2002年电视剧)
无锡市第一中学	无锡市第一中学
项怀诚	项怀诚
分类:亚洲国家	Category:亚洲国家
分类:美洲国家	Category:美洲国家
韻鏡	韻鏡
周立波 (演员)	周立波 (演员)
周庄镇	周庄镇
模板:Japan stub	Template:JP-stub
模板:Mexico-stub	Template:Mexico-stub
耕乐堂	耕乐堂
分类:WikEd用戶	Category:WikEd使用者
分类:苏州维基人	Category:苏州维基人
分类:上海維基人	Category:上海維基人
模板:SSU	Template:SSU
模板:Zh-hans icon	Template:Zh-hans
模板:User zh-yue-2	Template:User zh-yue-2
分类:含有內容嗰已軟重定向分類	Category:尚未清空的已重定向分類
分类:維基百科幽默	Category:維基百科幽默
模板:RWA	Template:RWA
模板:MLT	Template:MLT
模板:KEN	Template:KEN
模板:JAM	Template:JAM
分类:南美洲国家模板	Category:南美洲模板
分类:必有个页面	Category:基礎條目
模板:Sister project	Template:Sister
分类:清理模板	Category:清理模板
分类:事故	Category:事故
海南	海南 (消歧义)
分类:香港机场	Category:香港機場
分类:User wuu-2	Category:Zh-wuu-2 使用者
分类:User wuu-1	Category:Zh-wuu-1 使用者
分类:香港个地方	Category:香港地方
柳岩	柳岩
分类:亚洲国家模板	Category:亚洲国家模板
模板:No redirect	Template:Noredirect
分类:澳大利亚模板	Category:澳大利亚模板
分类:澳式足球	Category:澳大利亞澳式足球會
分类:澳大利亚华人	Category:澳大利亚华人
分类:AutoWikiBrowser	Category:自动维基浏览器
分类:柬埔寨个银行	Category:柬埔寨銀行
胡也頻	胡也频
分类:宝莱坞	Category:宝莱坞
分类:大桥	Category:橋樑
分类:布里司班	Category:布里斯班
错枝	錯枝
分类:香港巴士	Category:香港巴士
分类:粤语	Category:粵語
分类:中美洲国家	Category:中美洲國家
分类:戏曲	Category:戏曲
朱勾	朱勾
分类:日期	Category:日期
翳	翳 (越国)
分类:江苏城市	Category:江苏城市
分类:地震	Category:地震
分类:中国地震	Category:中国地震
分类:吴（三国）	Category:孫吳
分类:香港教育	Category:香港教育
分类:环境	Category:環境
分类:欧洲国家模板	Category:欧洲国家模板
分类:凯撒奖	Category:凱撒電影獎
分类:大洋洲国家模板	Category:大洋洲国家模板
模板:IAST	Template:IAST
分类:中国水灾	Category:中国水灾
模块:Sidebar	模块:Sidebar
分类:手册	Category:手册
分类:杭州	Category:杭州
分类:香港文化	Category:香港文化
分类:澳大利亚赛马	Category:澳洲賽馬
分类:新竹市	Category:新竹市
分类:印度小作品	Category:印度小作品
模板:India-stub	Template:India-stub
分类:昆山	Category:昆山市
分类:苏州	Category:苏州
帮助:Special characters	Help:特殊字母與符號
分类:中华民国	Category:中華民國
模板:Listen	Template:聽
分类:香港河流	Category:香港河流
分类:香港个街道	Category:香港道路
分类:泰国报纸	Category:泰國報紙
分类:北美洲国家模板	Category:北美洲国家模板
分类:香港个公园	Category:香港公園
分类:香港中学	Category:香港中學
分类:性学	Category:性學
模板:MNG	Template:MNG
分类:无锡人	Category:无锡人
分类:澳大利亚足球场	Category:澳洲足球場
分类:相态	Category:物质状态
分类:南澳大利亚州	Category:南澳大利亚州
模板:BEL	Template:BEL
分类:韩国模板	Category:韩国模板
分类:广东人	Category:广东人
分类:东南亚国家联盟	Category:亞細安
分类:墨尔本	Category:墨爾本
分类:勒翻译个文章	Category:正在翻譯的條目
分类:電話號碼	Category:電話號碼
分类:電話	Category:电话
分类:温度	Category:温度
分类:缺少使用说明个模板	Category:缺乏使用說明的模板
分类:印度个恐怖事体	Category:印度恐怖活动
分类:上海交通	Category:上海交通
斋月	賴買丹月
分类:海啸	Category:海啸
分类:悉尼	Category:悉尼
分类:朝鲜模板	Category:朝鲜模板
分类:热带气旋	Category:熱帶氣旋
分类:应用科学	Category:应用科学
分类:清迈	Category:清邁
阿朵	阿朵
分类:字典	Category:字典
分类:法国个报纸	Category:法国报纸
模板:Image label begin	Template:Image label begin
分类:澳大利亚大学	Category:澳大利亞大學
分类:中国个银行	Category:中國大陸地區銀行
分类:中国个报纸	Category:中国报纸
分类:高分子化学	Category:高分子化学
分类:主持人	Category:主持人
分类:日本大学	Category:日本的大學
杉原杏璃	杉原杏璃
分类:宁波	Category:宁波
分类:浙江城市	Category:浙江城市
许嵩	许嵩 (歌手)
甲型流感病毒H7N9亚型	甲型流感病毒H7N9亞型
模板:Babels	Template:Babels
分类:天津	Category:天津
分类:巴黎交通	Category:巴黎交通
分类:非洲国家模板	Category:非洲国家模板
模板:HUN	Template:HUN
模板:Ns has subpages	Template:Ns has subpages
分类:生活	Category:生活
Wikipedia:生成机器人	Wikipedia:製作機器人
模板:Infobox Language/statesregion	Template:Infobox Language/statesregion
分类:User zh-hu	Category:Zh-hu 使用者
分类:User zh-hu-1	Category:Zh-hu-1 使用者
分类:User zh-hu-3	Category:Zh-hu-3 使用者
分类:User zh-hz	Category:Zh-hz 使用者
分类:User zh-hz-N	Category:Zh-hz 母語使用者
分类:User zh-suzhou	Category:Zh-suzhou 使用者
分类:User zh-suzhou-N	Category:Zh-suzhou 母語使用者
模板:Aero-stub	Template:Aero-stub
分类:中国古代诗人	Category:中国各朝代诗人
分类:伊斯兰社会	Category:伊斯兰社会
分类:女性	Category:女性
分类:封面模板	Category:首頁模板
分类:柬埔寨文化	Category:柬埔寨文化
模板:Infobox Language/rank	Template:Infobox Language/rank
模板:Infobox Language/IPA notice	Template:Infobox Language/IPA notice
分类:台湾省	Category:台灣省
分类:台灣綜藝節目	Category:台灣綜藝節目
分类:包含電話號碼嗰文章	Category:含有电话号码的条目
分类:吴国	Category:吴国
吴国 （汉）	吳國 (漢朝)
分类:小作品模板	Category:小作品模板
分类:User en-1	Category:En-1 使用者
分类:User de-1	Category:De-1 使用者
分类:法国省份	Category:法国省份
分类:工具	Category:工具
分类:德国城市	Category:德國城市
分类:美国演员	Category:美国演员
分类:未做索引的页面	Category:未做索引的页面
分类:杭州維基人	Category:杭州維基人
分类:汉语族维基百科	Category:汉语维基百科
分类:江淮官话	Category:江淮官话
模板:France-stub	Template:France-stub
分类:泰国食品	Category:泰國食品
分类:清朝国歌	Category:清朝国歌
分类:温州人	Category:温州人
分类:爆炸事故	Category:爆炸事故
分类:琼山	Category:琼山区
分类:瑞典贵族	Category:瑞典貴族
分类:男演员	Category:男演员
分类:非洲模板	Category:非洲模板
分类:香港公路	Category:香港公路
分类:投票模板	Category:投票模板
分类:电影人	Category:電影人
分类:人物模板	Category:人物模板
模板:Infobox Language/official	Template:Infobox Language/official
孤山	孤山 (西湖)
模板:Asbox	Template:Asbox
分类:製造	Category:製造
崇安寺	崇安寺 (无锡)
左梦庚	左夢庚
幕府山	幕府山
杨国柱	杨国柱
模板:Lua	Template:Lua
楼外楼	楼外楼
不寿	不壽
江南水乡古镇	江南水乡古镇
滩浒乡	滩浒乡
王星记	王星记扇子
苏南	苏南
模板:勿是吳語	Template:NotMandarin
Wikipedia:弗要犯常见个错误	Wikipedia:避免常见错误
Wikipedia:How to read a taxobox	Help:如何閱讀生物分類框
Wikipedia:Media help	Wikipedia:媒體幫助
模块:Error	模块:Error
模板:Italy-stub	Template:Italy-stub
模板:OIC	Template:伊斯蘭會議組織
模板:Testcases notice	Template:Template testcases notice
模板:HK-bio-stub	Template:HK-bio-stub
刘宗周	劉宗周
宗人府	宗人府
模板:Start date	Template:Start date
姜義錫	姜義錫
蟹黄汤包	蟹黄汤包
三茅街道	三茅街道
洋泾中学	上海市洋泾中学
两浙路	两浙路
中国小说史略	中国小说史略
临城街道 (舟山市)	临城街道 (舟山市)
乔家栅	乔家栅食府
云龙镇 (海口市)	云龙镇 (海口市)
佘山镇	佘山镇
农夫山泉	农夫山泉
刘牢之	刘牢之
北京太庙	北京太庙
琉球群岛	琉球群岛
华士	华士镇
古剑奇谭 琴心剑魄今何在	古剑奇谭 琴心剑魄今何在
古剑奇谭系列	古剑奇谭系列
古剑奇谭貳 永夜初晗凝碧天	古劍奇譚 永夜初晗凝碧天
模板:Mbox templates see also	Template:Mbox templates see also
吴语区	吳語方言
吴越	吴越
呐喊	吶喊
和谐号	和谐号
喇叭	喇叭
大写	大写
大坡镇 (海口市)	大坡镇 (海口市)
大通学堂	大通学堂
光启社	天主教上海教区光启社
天星码头	天星碼頭
天水堂	天水堂 (杭州)
奎元馆	奎元馆
安昌镇 (绍兴县)	安昌镇 (绍兴市)
模板:Bio-stub	Template:Bio-stub
模板:User wuu	Template:User zh-wuu
模板:Indonesia stub	Template:Indonesia-stub
模板:港铁路线及服务	Template:港鐵路綫及服務
模板:蒙古文字	Template:蒙古文字
模板:Infobox Thailand province	Template:Infobox Thailand province
模板:Malaysia-stub	Template:Malaysia-stub
模板:Wayback	Template:Wayback
模板:Ireland stub	Template:Ireland-stub
模板:Larger	Template:Larger
帮助:编辑手册	Help:编辑手册
模板:Philippines-stub	Template:Philippines-stub
屯堡人	屯堡人
岳陽樓記	岳阳楼记
崇安寺街道	崇安寺街道
左光斗	左光斗
左良玉	左良玉
张煌言	张煌言
徐阶	徐階
新昌话	新昌話
旧州镇 (海口市)	旧州镇 (海口市)
模板:海南省行政区划	Template:海南行政区划
明州	明州
明末四公子	明末四公子
曹杨新村街道	曹杨新村街道
朱舜水	朱之瑜
杨振龙	杨振龙
杨芳 (清朝将领)	杨芳 (清朝将领)
松江府	松江府
桃浦鎮	桃浦镇
梅里	梅里
水 (消歧义)	水 (消歧義)
沈德潜	沈德潜
沛郡	沛郡
洪武赶散	洪武大移民
Wikipedia:VisualEditor	Wikipedia:可视化编辑器
鹅湖书院	鹅湖书院
黃巾军	黃巾軍
龙小菌	龍小菌
模板:Infobox Language/terminological	Template:Infobox Language/terminological
Wikipedia:AutoWikiBrowser/CheckPage	Wikipedia:AutoWikiBrowser/CheckPage
模板:SUBJECTSPACE formatted	Template:NS
胡雪岩	胡雪巖
陶成章	陶成章
分类:Audio templates	Category:音訊模板
模板:CJK-New-Char	Template:CJK-New-Char
於之莹	於之莹
模板:Element color/Actinides	Template:Element color/Actinides
模板:Element color/Alkaline earth metals	Template:Element color/Alkaline earth metals
模板:Tlg	Template:Tlg
模板:扩充	Template:Expand
模板:IPA notice	Template:IPA notice
模板:Contains special characters	Template:Special characters
模板:Spoken Wikipedia boilerplate	Template:Spoken Wikipedia boilerplate
Wikipedia:Spoken articles	Wikipedia:有聲條目
Wikipedia:CC-BY-SA-3.0协议文本	Wikipedia:CC BY-SA 3.0协议文本
模板:Multi-listen item	Template:Multi-listen item
模板:Documentation/template page	Template:Documentation/template page
模板:Element color/Alkali metals	Template:Element color/Alkali metals
模板:Element color/Lanthanides	Template:Element color/Lanthanides
模板:Element color/Nonmetals	Template:Element color/Nonmetals
模板:Thailand geo stub	Template:Thailand-geo-stub
曼谷枪手 2	無聲火 (美國電影)
Portal:浙江	Portal:浙江
模板:User zh-yue-0	Template:User zh-yue-0
模块:StringReplace	模块:StringReplace
模板:Vtext	Template:Vtext
元宵	元宵节
模板:Documentation/preload	Template:Documentation/preload
模板:Markup	Template:Markup
模板:Unihan	Template:Unihan
模板:Infobox Language/genetic2	Template:Infobox language/genetic
模板:Multiple image/numImgs	Template:并列图像/图像数目
长江口	长江口
长风新村街道	长风新村街道
真如镇	真如镇街道
长征镇 (上海市)	长征镇 (上海市)
马桥文化	馬橋文化
模板:Sinaweibo	Template:Sinaweibo
环南街道	环南街道
金塘	金塘镇 (舟山市)
模板:Vietnam stub	Template:Vietnam-stub
模块:Documentation	模块:Documentation
模板:No documentation	Template:缺乏使用說明
模板:User wuu-1	Template:User zh-wuu-1
模板:HKG stub	Template:HK-stub
白坦群岛 (菲律宾)	巴丹群島
模板:Alphabet fr	Template:Alphabet fr
模板:Element color/X	Template:Element color/X
模板:Tel	Template:Tel
模板:User Shanghai	Template:User Shanghai
模板:User 苏州	Template:User Suzhou
模板:老杭州城门	Template:老杭州城门
模板:Element color/Poor metals	Template:Element color/Poor metals
模板:Element color/Noble gases	Template:Element color/Noble gases
模板:Element color/Halogens	Template:Element color/Halogens
模板:Element color/Metalloids	Template:Element color/Metalloids
模板:Element color/Transition metals	Template:Element color/Transition metals
Wikipedia:必有个页面/歷史與地理	Wikipedia:基礎條目/歷史與地理
模板:TemplateDataHeader	Template:TemplateDataHeader
Wikipedia:必有个页面/人物	Wikipedia:基礎條目/人物
Wikipedia:必有个页面/社會、語文與藝術	Wikipedia:基礎條目/社會、語文與藝術
Wikipedia:必有个页面/科學、數學與技術	Wikipedia:基礎條目/科學、數學與技術
红旗镇 (海口市)	红旗镇 (海口市)
模板:Module rating	Template:Module rating
Wikipedia:Unicode擴展漢字	Wikipedia:Unicode扩展汉字
模板:Reply to	Template:Reply to
台州话罗马字	台州話羅馬字
长风公园	长风公园
裘甫	裘甫
模块:Yesno	模块:Yesno
模块:Message box	模块:Message box
模块:Category handler	模块:Category handler
模块:Message box/configuration	模块:Message box/configuration
尹賢碩	六友堂
剃发易服	剃髮易服
挖花	挖花
惡病質	惡病體質
模块:Unsubst	模块:Unsubst
模板:Infobox China County	Template:Infobox China County
雷 (消歧义)	雷 (消歧義)
东吴	東吳
虎牌啤酒 (新加坡)	虎牌啤酒
模块:Arguments	模块:Arguments
特殊:最近更改	Special:最近更改
模块:TableTools	模块:TableTools
通扬运河	通扬运河
管惟炎	管惟炎
衣冠南渡	衣冠南渡
葱包烩	葱包桧儿
清河坊	清河坊
甬江小片	甬江小片
模块:Documentation/config	模块:Documentation/config
模块:List	模块:List
模块:Namespace detect	模块:Namespace detect
模块:Bananas	模块:Test
模块:HtmlBuilder	模块:HtmlBuilder
模块:String	模块:String
模块:InfoboxImage	模块:InfoboxImage
模块:Navbar	模块:Navbar
模块:Navbox	模块:Navbox
模块:Infobox	模块:Infobox
模板:Personal announcement	Template:Personal announcement
模块:Pagetype	模块:Pagetype
寶山區	宝山区
李岱春	李岱春
Wikipedia:VisualEditor/TemplateData	Wikipedia:可视化编辑器/模板数据
長征鎮	长征镇
分类:江南古镇	Category:江南古镇
马士英	馬士英
应天府 (明朝)	应天府 (明朝)
陈新甲	陈新甲
常州地铁	常州地铁
青藤书屋	青藤书屋
苏州专区	苏州专区
钱王祠	钱王祠
模块:Namespace detect/data	模块:Namespace detect/data
模块:Namespace detect/config	模块:Namespace detect/config
模块:Pagetype/config	模块:Pagetype/config
长兴	长兴
锡山市	锡山市
模板:Aligned table	Template:整齊列表
模块:Aligned table	模块:Aligned table
模块:No globals	模块:No globals
模块:Hatnote	模块:Hatnote
广州火车站砍人事件	广州火车站暴力袭击事件
模块:Listen	模块:Listen
模块:Side box	模块:Side box
模块:File link	模块:File link
模块:Lua banner	模块:Lua banner
妓女	娼妓
模板:Braces	Template:Braces
模板:Thinsp	Template:Thinsp
浙江大學跨學科社會科學研究中心	浙江大学跨学科社会科学研究中心
馬來西亞航空17號班機空难	马来西亚航空17号班机空难
模板:上海市行政區劃圖	Template:上海市行政区划图
西山話	西山话
模板:上海地铁线路代表颜色	Template:上海地铁线路名
黃大仙祠 (廣州)	黄大仙祠 (广州)
黃大仙祠	黃大仙祠
模板:User wikEd	Template:User wikEd
模板:User 上海	Template:User 上海
模板:Wuu icon	Template:Wuu icon
分类:通信設備	Category:通讯设备
崇明方言大詞典	崇明方言大词典
雨傘運動	雨傘革命
模板:IPA fonts	Template:IPA fonts
模块:Langname	模块:Langname
模板:Zh-hant icon	Template:Zh-hant
模板:Feature	Template:Feature
模板:Str replace	Template:Str replace
模板:明朝皇帝信息框	Template:明朝皇帝信息框
分类:湖南省	Category:湖南省
模板:必有个页面	Template:基礎條目
Wikipedia:必有个页面/歷史與地理/va2	Wikipedia:基礎條目/歷史與地理/va2
Wikipedia:必有个页面/科學、數學與技術/va2	Wikipedia:基礎條目/科學、數學與技術/va2
Wikipedia:必有个页面/社會、語文與藝術/va2	Wikipedia:基礎條目/社會、語文與藝術/va2
Wikipedia:必有个页面/人物/va2	Wikipedia:基礎條目/人物/va2
Wikipedia:必有个页面/va2	Wikipedia:基礎條目/va2
飞行员	飛行員
